,method,T,num_crossings0,num_crossings1,edge_cross_reduction,edge_cross_angle_reduction,aspect_ratio_reduction,num_nodes,num_edges
0,relax_and_recompute,0.0,1,0,1,84.24676767628485,-0.1942447709379661,17,18
1,relax_and_recompute,0.0,14,6,8,-8.428120518837503,0.1155098375036129,43,48
2,relax_and_recompute,0.0,17,6,11,-9.2591280296487,0.1258330477197231,38,45
3,relax_and_recompute,0.0,1,0,1,84.39967826050768,-0.10270186326966,12,12
4,relax_and_recompute,0.0,17,7,10,-7.93252317535827,0.3722778581014653,23,38
5,relax_and_recompute,0.0,1,0,1,67.4232358556018,-0.1152321833160708,19,22
6,relax_and_recompute,0.0,728,809,-81,-0.029939048284497,0.0366234743333024,35,143
7,relax_and_recompute,0.0,2,1,1,-4.981815549008658,0.3093719435378426,92,91
8,relax_and_recompute,0.0,8,8,0,4.654495999284535,-0.184704546039311,43,51
9,relax_and_recompute,0.0,1,0,1,87.72576177935123,0.3627292855329071,35,36
10,relax_and_recompute,0.0,0,0,0,0.0,0.6496288779590241,11,13
11,relax_and_recompute,0.0,28,20,8,1.5990508849363891,0.1838573808064747,10,25
12,relax_and_recompute,0.0,17,28,-11,7.672232929300847,0.0798079685691882,86,136
13,relax_and_recompute,0.0,0,0,0,0.0,0.4061363457444384,10,12
14,relax_and_recompute,0.0,0,0,0,0.0,0.1158922758365483,32,31
15,relax_and_recompute,0.0,4,2,2,-1.887924809988462,0.2774473144752014,20,26
16,relax_and_recompute,0.0,0,0,0,0.0,-0.1858742013520343,11,11
17,relax_and_recompute,0.0,3,6,-3,8.570467415729595,-0.0317733804602171,34,42
18,relax_and_recompute,0.0,11,14,-3,5.587223408952411,-0.2088593404158898,14,25
19,relax_and_recompute,0.0,8,7,1,4.189093305124828,0.0404900134776696,31,46
20,relax_and_recompute,0.0,6,0,6,61.90602699737707,0.0997214286772043,42,45
21,relax_and_recompute,0.0,1194,1107,87,1.0813719829100847,-0.0478707687465694,39,173
22,relax_and_recompute,0.0,11,14,-3,-2.918366510242393,0.4260325933472807,14,24
23,relax_and_recompute,0.0,0,1,-1,-64.12894690733098,-0.0862028725236528,24,25
24,relax_and_recompute,0.0,1,1,0,-15.174290695138843,0.3220568869451577,12,19
25,relax_and_recompute,0.0,65,60,5,0.2353569284483967,-0.3486386912319235,41,72
26,relax_and_recompute,0.0,198,190,8,1.7939156643606538,-0.0177406420464488,59,115
27,relax_and_recompute,0.0,12,3,9,2.557318837968936,-0.1955541457470998,32,37
28,relax_and_recompute,0.0,1,0,1,89.91841473291127,-0.0379741643933481,20,20
29,relax_and_recompute,0.0,25,22,3,-2.1161608699158307,-0.0907693398211216,12,31
30,relax_and_recompute,0.0,0,0,0,0.0,-0.108469701346471,10,10
31,relax_and_recompute,0.0,2,0,2,80.938308279821,-0.1605787100772531,20,21
32,relax_and_recompute,0.0,30,17,13,-2.048384575300197,0.1814621683388447,39,52
33,relax_and_recompute,0.0,359,320,39,-0.3790387055853088,-0.1666053996300474,42,109
34,relax_and_recompute,0.0,3,0,3,64.70203737563865,0.2575953050950585,25,28
35,relax_and_recompute,0.0,225,200,25,0.2218276929202289,0.083037800040111,56,106
36,relax_and_recompute,0.0,424,412,12,0.6291598491088948,0.1305436335619105,87,189
37,relax_and_recompute,0.0,90,26,64,-2.6268674692059406,0.1333228334999863,56,82
38,relax_and_recompute,0.0,2,1,1,-5.55777870677305,0.3924697593836495,13,15
39,relax_and_recompute,0.0,93,85,8,1.1342724574439274,0.022173312213944,36,63
40,relax_and_recompute,0.0,0,0,0,0.0,0.3599797270951682,16,15
41,relax_and_recompute,0.0,0,0,0,0.0,0.2518974155397183,67,66
42,relax_and_recompute,0.0,15,18,-3,-3.506702967408131,-0.2705928984517483,42,60
43,relax_and_recompute,0.0,0,0,0,0.0,-0.0316804583619789,39,38
44,relax_and_recompute,0.0,11,8,3,-20.958548363677835,-0.3978873225167162,20,36
45,relax_and_recompute,0.0,0,0,0,0.0,-0.0691552736526083,10,9
46,relax_and_recompute,0.0,2,0,2,83.7579499556103,0.167023976942915,13,15
47,relax_and_recompute,0.0,5,14,-9,6.556836668012693,0.1059242156978026,34,41
48,relax_and_recompute,0.0,6,4,2,2.905816948357213,-0.3346377898778693,37,42
49,relax_and_recompute,0.0,15,14,1,4.069327699963139,0.2135576735301343,18,29
50,relax_and_recompute,0.0,0,0,0,0.0,0.2711789987537493,23,22
51,relax_and_recompute,0.0,0,0,0,0.0,-0.0440585797351609,13,12
52,relax_and_recompute,0.0,1,0,1,85.58496976351456,0.0009864212308863,15,14
53,relax_and_recompute,0.0,0,0,0,0.0,-0.0313036848382162,69,68
54,relax_and_recompute,0.0,1,0,1,56.66660691714202,0.0967168413375831,40,39
55,relax_and_recompute,0.0,8,5,3,1.1293300033484286,0.2134403179600585,89,93
56,relax_and_recompute,0.0,14,12,2,-19.032853924437745,0.026359680173795,20,32
57,relax_and_recompute,0.0,8,4,4,-0.3456534447008579,0.3409840082644634,69,83
58,relax_and_recompute,0.0,1,2,-1,-21.06752406487704,-0.3861781347620647,12,15
59,relax_and_recompute,0.0,1,0,1,81.461740501715,0.2255128923519623,15,14
60,relax_and_recompute,0.0,1,5,-4,20.086923284687487,0.3434356032645084,23,26
61,relax_and_recompute,0.0,2,5,-3,8.48434905271369,-0.0921305136907919,12,20
62,relax_and_recompute,0.0,309,169,140,-1.4585890584030563,-0.1449705998686804,64,122
63,relax_and_recompute,0.0,5,26,-21,-5.84528034571921,-0.2646062196380091,58,71
64,relax_and_recompute,0.0,0,0,0,0.0,0.1623187570650831,20,19
65,relax_and_recompute,0.0,279,320,-41,4.03770626668598,0.0310463809311278,100,191
66,relax_and_recompute,0.0,34,44,-10,5.911842714149969,0.0707459319435589,41,61
67,relax_and_recompute,0.0,16,29,-13,2.033873624815186,-0.0394995378406719,13,31
68,relax_and_recompute,0.0,3,4,-1,4.726903424412498,0.0987325540067655,10,15
69,relax_and_recompute,0.0,11,9,2,-2.739233020323084,0.291514719846922,37,47
70,relax_and_recompute,0.0,1,1,0,-10.351506052407174,-0.0516754372514461,21,21
71,relax_and_recompute,0.0,2,0,2,78.85625011322387,-0.0073059735853356,11,10
72,relax_and_recompute,0.0,53,67,-14,5.66753037209412,-0.0487361211944196,44,80
73,relax_and_recompute,0.0,2,3,-1,4.456451917953075,-0.2315166881511338,12,21
74,relax_and_recompute,0.0,6,0,6,76.13268626237935,0.2609704518345153,37,43
75,relax_and_recompute,0.0,23,20,3,-6.107603923555246,-0.0303684104356295,41,52
76,relax_and_recompute,0.0,0,1,-1,-69.58458762580017,-0.0971160478184203,90,89
77,relax_and_recompute,0.0,0,0,0,0.0,-0.038888114438131,22,21
78,relax_and_recompute,0.0,0,0,0,0.0,-0.2096913341520437,37,43
79,relax_and_recompute,0.0,7,1,6,-7.789558640950574,0.1041000328000119,47,47
80,relax_and_recompute,0.0,4,4,0,-1.605869467930006,0.4230741416504882,12,20
81,relax_and_recompute,0.0,112,122,-10,-1.258960093306868,0.0745933318458067,84,124
82,relax_and_recompute,0.0,7,2,5,1.465842670501047,0.0804961214422749,88,92
83,relax_and_recompute,0.0,380,279,101,-1.160225108140338,-0.1440938693809352,59,122
84,relax_and_recompute,0.0,2,4,-2,13.905608728765458,0.2436033327755631,26,31
85,relax_and_recompute,0.0,0,0,0,0.0,-0.0056972632594776,28,27
86,relax_and_recompute,0.0,2,4,-2,-1.2490507799427275,0.194493057863031,18,26
87,relax_and_recompute,0.0,3,7,-4,2.2377913215160845,0.3299713595349843,23,26
88,relax_and_recompute,0.0,0,0,0,0.0,0.0231315596808966,43,43
89,relax_and_recompute,0.0,0,1,-1,-49.073481183994254,-0.1568940614149829,22,26
90,relax_and_recompute,0.0,0,0,0,0.0,0.192888577476446,15,14
91,relax_and_recompute,0.0,7,7,0,-4.833094264004799,-0.1984402455468497,36,48
92,relax_and_recompute,0.0,16,3,13,-3.413799619803086,0.3857080459112718,30,37
93,relax_and_recompute,0.0,2,1,1,-4.62044112848686,-0.1655295322623203,10,13
94,relax_and_recompute,0.0,0,0,0,0.0,0.0448609130102647,12,11
95,relax_and_recompute,0.0,203,174,29,5.04615135639353,0.0283040497806396,55,105
96,relax_and_recompute,0.0,3,4,-1,4.073148177237911,0.4897911133810112,13,17
97,relax_and_recompute,0.0,0,0,0,0.0,-0.0377575249905289,30,29
98,relax_and_recompute,0.0,1,1,0,0.690293374761481,-0.2177842542561925,36,43
99,relax_and_recompute,0.0,45,11,34,6.043325529918043,0.229879068576723,40,60
100,relax_and_recompute,0.0,1,0,1,55.90864206468268,0.5192830197097293,13,17
101,relax_and_recompute,0.0,12,6,6,-3.186219253573036,-0.2272284839258952,23,30
102,relax_and_recompute,0.0,0,1,-1,-24.88718926818052,0.1533825035530367,12,16
103,relax_and_recompute,0.0,0,0,0,0.0,-0.4088012497010896,26,26
104,relax_and_recompute,0.0,2,2,0,-2.904441291214404,-0.0048405694047097,22,31
105,relax_and_recompute,0.0,1,0,1,71.702803248023,0.3015116040568411,68,68
106,relax_and_recompute,0.0,0,0,0,0.0,0.0208858679486494,23,22
107,relax_and_recompute,0.0,0,0,0,0.0,-0.044757884000249,43,42
108,relax_and_recompute,0.0,0,0,0,0.0,-0.0804467856897719,18,17
109,relax_and_recompute,0.0,8,2,6,-1.2089788809909408,-0.0656107641650912,28,42
110,relax_and_recompute,0.0,44,50,-6,-1.4943521664356112,0.4681009629251639,21,44
111,relax_and_recompute,0.0,2,1,1,-2.560803569495405,0.3314501863457897,36,37
112,relax_and_recompute,0.0,0,0,0,0.0,-0.2516839556551739,15,14
113,relax_and_recompute,0.0,1,1,0,0.6212955161478888,-0.1733774371565779,14,16
114,relax_and_recompute,0.0,233,187,46,-1.4385389766796737,0.0937572804420392,61,119
115,relax_and_recompute,0.0,2,0,2,85.36242795199655,0.1933288108403213,19,20
116,relax_and_recompute,0.0,1,0,1,69.24332590460803,0.2077367764069631,22,22
117,relax_and_recompute,0.0,7,2,5,6.792084758487839,-0.2181264327462619,54,58
118,relax_and_recompute,0.0,500,413,87,-1.1976448064807172,-0.390857061591478,65,135
119,relax_and_recompute,0.0,1,1,0,-15.910094373774667,-0.0530804861230044,16,18
120,relax_and_recompute,0.0,15,6,9,9.799473960759435,0.1106513142939739,17,27
121,relax_and_recompute,0.0,18,9,9,-7.589670571062655,0.3274583233400612,54,71
122,relax_and_recompute,0.0,3,0,3,60.550415047793024,0.0845098749356659,23,22
123,relax_and_recompute,0.0,0,0,0,0.0,0.0665383544124033,13,16
124,relax_and_recompute,0.0,196,152,44,3.937166231561655,0.1842670783831727,85,131
125,relax_and_recompute,0.0,30,32,-2,0.6889240588587455,0.2689787482234411,28,55
126,relax_and_recompute,0.0,10,3,7,17.94284038432827,-0.2318543662861694,18,24
127,relax_and_recompute,0.0,2,1,1,-3.5038738444065416,-0.3693585678551664,19,22
128,relax_and_recompute,0.0,1,0,1,58.91551914897276,0.2054909142173197,47,46
129,relax_and_recompute,0.0,61,30,31,-8.84364711268205,-0.3378063048958265,39,64
130,relax_and_recompute,0.0,0,1,-1,-61.46124997794762,-0.1482640235418457,17,18
131,relax_and_recompute,0.0,4,1,3,-21.21604536510172,-0.0753193545040595,23,24
132,relax_and_recompute,0.0,1,4,-3,5.027162211528221,0.0025652519833183,13,16
133,relax_and_recompute,0.0,22,9,13,5.231456617518106,0.1455025710409048,40,56
134,relax_and_recompute,0.0,0,1,-1,-79.12909489873455,0.4712899794083907,10,15
135,relax_and_recompute,0.0,0,0,0,0.0,-0.3289295402213936,21,20
136,relax_and_recompute,0.0,3,5,-2,-2.2381860006310745,-0.0796770307593897,30,35
137,relax_and_recompute,0.0,0,3,-3,-35.00162150567243,-0.1424868404346007,71,77
138,relax_one,0.0,0,2,-2,-75.63440330719251,-0.4170542674415093,17,18
139,relax_one,0.0,7,4,3,0.3112761091720415,-0.03256790462388,43,48
140,relax_one,0.0,3,18,-15,-0.6041652130779198,-0.0499381879522591,38,45
141,relax_one,0.0,1,0,1,77.48172724377295,0.0732402928436416,12,12
142,relax_one,0.0,25,19,6,3.981444410672261,-0.1351770382818751,23,38
143,relax_one,0.0,1,1,0,-9.591464024731051,-0.2596286073116122,19,22
144,relax_one,0.0,819,863,-44,0.2516774341235077,-0.3159590997851448,35,143
145,relax_one,0.0,3,5,-2,5.684701334073694,-0.0310711624130478,92,91
146,relax_one,0.0,2,9,-7,-2.2367930323270784,0.1709684114483801,43,51
147,relax_one,0.0,2,0,2,81.4418591656598,-0.3193414791088326,35,36
148,relax_one,0.0,0,0,0,0.0,0.0378885961165388,11,13
149,relax_one,0.0,21,18,3,-4.318445951266966,-0.1470386431235298,10,25
150,relax_one,0.0,25,51,-26,2.8148737372917765,0.1043060277641518,86,136
151,relax_one,0.0,0,0,0,0.0,-0.0112701770107875,10,12
152,relax_one,0.0,0,0,0,0.0,0.0603427441819732,32,31
153,relax_one,0.0,7,3,4,-0.735726768240113,0.0354765491908489,20,26
154,relax_one,0.0,0,0,0,0.0,0.1217208180653347,11,11
155,relax_one,0.0,3,1,2,7.065346978991613,0.0783849186033804,34,42
156,relax_one,0.0,9,10,-1,5.1286389924432285,0.4172717291502232,14,25
157,relax_one,0.0,6,9,-3,-5.278184317641532,-0.0933412364985163,31,46
158,relax_one,0.0,2,1,1,-22.938812137367,0.1904184075856217,42,45
159,relax_one,0.0,1127,1115,12,0.5384361468025034,0.2202565050336504,39,173
160,relax_one,0.0,9,8,1,-2.105623444467512,-0.0567528657725746,14,24
161,relax_one,0.0,0,0,0,0.0,0.220501551871324,24,25
162,relax_one,0.0,1,3,-2,0.4695051570779753,-0.0729419608953438,12,19
163,relax_one,0.0,72,63,9,4.179671286768915,-0.1020417498610855,41,72
164,relax_one,0.0,220,180,40,0.0089620796146334,0.1079372583067165,59,115
165,relax_one,0.0,9,8,1,-4.4904649820817255,0.4030212102974317,32,37
166,relax_one,0.0,5,0,5,61.86218896239533,0.13979709584162,20,20
167,relax_one,0.0,27,26,1,-4.389347273841551,0.157321824934973,12,31
168,relax_one,0.0,0,0,0,0.0,-0.5381712048626972,10,10
169,relax_one,0.0,1,1,0,44.55532167507883,-0.1610640023902659,20,21
170,relax_one,0.0,28,27,1,-2.9011065951567403,-0.0241532447070864,39,52
171,relax_one,0.0,400,332,68,-0.6143449031350912,0.2678386653769925,42,109
172,relax_one,0.0,2,1,1,-2.046772929226861,0.0478968000960972,25,28
173,relax_one,0.0,239,170,69,0.3729416959709866,0.1059346144637756,56,106
174,relax_one,0.0,504,465,39,2.7744418829567863,-0.0179315286615163,87,189
175,relax_one,0.0,26,31,-5,5.558152146230725,0.0056088128353088,56,82
176,relax_one,0.0,2,3,-1,-10.28951634711636,0.1012928561686115,13,15
177,relax_one,0.0,99,89,10,1.861292659524878,-0.1046356742095622,36,63
178,relax_one,0.0,0,0,0,0.0,0.1394181625311501,16,15
179,relax_one,0.0,0,0,0,0.0,0.2538891457657204,67,66
180,relax_one,0.0,15,22,-7,3.890415333553584,-0.1573054426636616,42,60
181,relax_one,0.0,0,0,0,0.0,-0.0511490357607121,39,38
182,relax_one,0.0,25,9,16,-8.283155555492932,-0.1627332460150146,20,36
183,relax_one,0.0,1,2,-1,35.33246981937913,-0.0426869028058418,10,9
184,relax_one,0.0,1,0,1,82.51761363743094,0.006270926956064,13,15
185,relax_one,0.0,9,12,-3,-5.88226851514392,0.2428973068191119,34,41
186,relax_one,0.0,4,7,-3,8.055087095079685,0.3971627658773118,37,42
187,relax_one,0.0,38,20,18,0.9177751651422028,0.4168660130641847,18,29
188,relax_one,0.0,0,0,0,0.0,-0.1838644918440253,23,22
189,relax_one,0.0,0,0,0,0.0,0.1369393413299433,13,12
190,relax_one,0.0,0,0,0,0.0,-0.131922736761411,15,14
191,relax_one,0.0,0,0,0,0.0,-0.2578441719592256,69,68
192,relax_one,0.0,14,0,14,71.49665162449783,-0.2032976161009653,40,39
193,relax_one,0.0,14,7,7,-4.040237282858882,-0.279945464616563,89,93
194,relax_one,0.0,9,12,-3,-5.070224328941961,-0.1839680829587783,20,32
195,relax_one,0.0,3,5,-2,-7.783339984138273,-0.1776999008382809,69,83
196,relax_one,0.0,2,2,0,-15.60681148278087,-0.1232540471732009,12,15
197,relax_one,0.0,0,0,0,0.0,0.1012810040964969,15,14
198,relax_one,0.0,5,1,4,-26.094540118317205,-0.1985692711245972,23,26
199,relax_one,0.0,2,9,-7,5.539361746513407,0.0819678490936448,12,20
200,relax_one,0.0,197,164,33,-3.2757595112444093,0.1360715914782797,64,122
201,relax_one,0.0,8,8,0,1.5335849799231625,0.1962674807530264,58,71
202,relax_one,0.0,0,0,0,0.0,0.2921208216111063,20,19
203,relax_one,0.0,323,279,44,-1.652548924256827,-0.0344592164617999,100,191
204,relax_one,0.0,30,21,9,0.2705440890490109,-0.076752920831265,41,61
205,relax_one,0.0,16,33,-17,3.1673562162190194,0.0209374937703252,13,31
206,relax_one,0.0,3,4,-1,17.146303345316653,0.1609295633008275,10,15
207,relax_one,0.0,15,11,4,1.7387900255710775,-0.087052098759833,37,47
208,relax_one,0.0,0,0,0,0.0,0.1119890472323191,21,21
209,relax_one,0.0,0,0,0,0.0,0.1260744694824417,11,10
210,relax_one,0.0,83,29,54,-6.071355594649489,-0.1464308209034075,44,80
211,relax_one,0.0,2,3,-1,-9.118372760345096,-0.1780198494487579,12,21
212,relax_one,0.0,8,3,5,-4.305702330298473,-0.1782801555174069,37,43
213,relax_one,0.0,4,9,-5,-37.20728142889161,0.0005552465747961,41,52
214,relax_one,0.0,1,2,-1,5.924460708582629,0.1688855611040964,90,89
215,relax_one,0.0,0,0,0,0.0,0.3443771260171646,22,21
216,relax_one,0.0,17,1,16,-18.665502064946025,0.366158770455704,37,43
217,relax_one,0.0,2,0,2,71.97021476880047,-0.2207487004650179,47,47
218,relax_one,0.0,5,7,-2,11.66958497032568,-0.2487044694236857,12,20
219,relax_one,0.0,117,104,13,-1.3885462584236876,0.0302201365736296,84,124
220,relax_one,0.0,3,1,2,-19.96567582202831,0.0783428158957529,88,92
221,relax_one,0.0,315,420,-105,-2.551540363670398,0.1141665340031935,59,122
222,relax_one,0.0,3,2,1,-9.412212009098925,-0.1110277808751269,26,31
223,relax_one,0.0,0,0,0,0.0,0.0539859251957124,28,27
224,relax_one,0.0,3,2,1,40.496149685999214,0.3050040619971944,18,26
225,relax_one,0.0,1,4,-3,-19.38623787185938,-0.0332630568744747,23,26
226,relax_one,0.0,4,1,3,-18.800948092465845,-0.1651102643421147,43,43
227,relax_one,0.0,1,2,-1,12.452856840660871,-0.077193703700492,22,26
228,relax_one,0.0,0,0,0,0.0,-0.2772817389361243,15,14
229,relax_one,0.0,17,11,6,-14.363357866628988,-0.0707556850372614,36,48
230,relax_one,0.0,20,18,2,-2.6336380551435,0.1489037753670863,30,37
231,relax_one,0.0,4,1,3,-7.396359246621159,-0.21064629408846,10,13
232,relax_one,0.0,0,0,0,0.0,-0.1951734790902387,12,11
233,relax_one,0.0,172,183,-11,0.4209746505023659,0.0587629446731227,55,105
234,relax_one,0.0,0,1,-1,-67.24932588869704,-0.2744920755084453,13,17
235,relax_one,0.0,0,1,-1,-71.03508467151214,-0.1729831476865645,30,29
236,relax_one,0.0,8,4,4,5.653945475000299,-0.0793107651791173,36,43
237,relax_one,0.0,26,12,14,1.90026416213172,0.3056215730460224,40,60
238,relax_one,0.0,1,0,1,54.99650547002754,-0.0777794183085873,13,17
239,relax_one,0.0,14,5,9,-6.682958613455504,0.3195690914097345,23,30
240,relax_one,0.0,1,5,-4,-12.286699332985748,0.3693381295837573,12,16
241,relax_one,0.0,0,0,0,0.0,-0.316263012027503,26,26
242,relax_one,0.0,0,0,0,0.0,0.1658091826554306,22,31
243,relax_one,0.0,6,1,5,-24.4630769366662,0.0650953400982143,68,68
244,relax_one,0.0,0,0,0,0.0,0.0093018162092227,23,22
245,relax_one,0.0,0,0,0,0.0,-0.0681930962369693,43,42
246,relax_one,0.0,0,0,0,0.0,-0.1336143176719378,18,17
247,relax_one,0.0,7,1,6,-17.59882342491779,-0.2242127895500332,28,42
248,relax_one,0.0,49,41,8,-2.414045915840134,-0.2107894998676309,21,44
249,relax_one,0.0,0,0,0,0.0,-0.3608408923673795,36,37
250,relax_one,0.0,0,0,0,0.0,-0.1962282553291376,15,14
251,relax_one,0.0,2,0,2,79.75635498758669,0.0479028720337471,14,16
252,relax_one,0.0,252,219,33,3.0182985322291174,-0.1850181602352174,61,119
253,relax_one,0.0,1,0,1,79.31297270171127,0.2680639641165451,19,20
254,relax_one,0.0,0,2,-2,-49.586259867254185,-0.233811991626426,22,22
255,relax_one,0.0,4,3,1,-3.3506749055395275,-0.0338043301407176,54,58
256,relax_one,0.0,408,414,-6,-1.1133833644795672,-0.2853323636282916,65,135
257,relax_one,0.0,1,1,0,-1.9768645532054308,0.1403648912502353,16,18
258,relax_one,0.0,8,12,-4,3.164804829487452,0.2723260831902961,17,27
259,relax_one,0.0,10,6,4,-7.794566166425341,-0.1669442298352734,54,71
260,relax_one,0.0,0,0,0,0.0,0.0555226255767445,23,22
261,relax_one,0.0,1,1,0,16.411715746914382,0.2420880266667404,13,16
262,relax_one,0.0,192,163,29,-2.065214329457831,-0.1265544723486573,85,131
263,relax_one,0.0,76,50,26,1.4628186192811086,-0.3002525850416825,28,55
264,relax_one,0.0,3,2,1,-13.87599961126623,0.0989075444829624,18,24
265,relax_one,0.0,0,3,-3,-54.519492682695606,-0.0657510194516521,19,22
266,relax_one,0.0,2,0,2,67.86617201240178,0.157517234991433,47,46
267,relax_one,0.0,23,27,-4,-5.401921150477804,-0.2326627304534355,39,64
268,relax_one,0.0,0,0,0,0.0,-0.129350446141376,17,18
269,relax_one,0.0,5,2,3,-36.1874698346111,0.3675605389369997,23,24
270,relax_one,0.0,1,1,0,8.317788700525341,-0.1605442219784317,13,16
271,relax_one,0.0,23,25,-2,7.220824850446661,-0.2658104873342991,40,56
272,relax_one,0.0,2,2,0,-11.580828447859671,-0.2465114369836197,10,15
273,relax_one,0.0,0,0,0,0.0,-0.326469558784811,21,20
274,relax_one,0.0,2,2,0,16.04492072973442,0.1888792448042292,30,35
275,relax_one,0.0,2,5,-3,4.217135838537715,-0.1601895400198019,71,77
276,just_relax,0.0,0,1,-1,-38.96556421923995,-0.3831407476813027,17,18
277,just_relax,0.0,4,6,-2,26.25352076247043,-0.2393425974618902,43,48
278,just_relax,0.0,5,27,-22,20.333333717784235,-0.0355495062098654,38,45
279,just_relax,0.0,0,0,0,0.0,0.1654492134061822,12,12
280,just_relax,0.0,17,26,-9,2.338096455323651,-0.3277883275147039,23,38
281,just_relax,0.0,1,1,0,-14.345079532691614,-0.2542886129328253,19,22
282,just_relax,0.0,804,869,-65,-0.6213964698106054,-0.0654356817237123,35,143
283,just_relax,0.0,3,13,-10,-3.371461821782816,0.0642856010010958,92,91
284,just_relax,0.0,7,13,-6,18.092566572102008,-0.2665605257856098,43,51
285,just_relax,0.0,2,1,1,-19.640034030277164,0.1407637777230975,35,36
286,just_relax,0.0,1,0,1,83.4828004885341,0.2295796030902291,11,13
287,just_relax,0.0,17,23,-6,8.83497616262391,0.0981846475635284,10,25
288,just_relax,0.0,16,50,-34,17.153491819272013,0.0699508025626013,86,136
289,just_relax,0.0,0,0,0,0.0,-0.1941885864119094,10,12
290,just_relax,0.0,0,0,0,0.0,0.0704277807646436,32,31
291,just_relax,0.0,2,7,-5,7.946509430502715,-0.207938421792291,20,26
292,just_relax,0.0,2,0,2,83.79014106653447,0.1019562954972117,11,11
293,just_relax,0.0,25,14,11,-16.035870333933396,-0.0812041196915095,34,42
294,just_relax,0.0,15,11,4,26.38360511558762,-0.0291765101301826,14,25
295,just_relax,0.0,11,14,-3,12.060026522373173,-0.1237481715752905,31,46
296,just_relax,0.0,3,4,-1,2.253703906836634,-0.0315573825799742,42,45
297,just_relax,0.0,1124,1141,-17,-0.1921442935015278,0.1120312093703196,39,173
298,just_relax,0.0,10,8,2,-7.918602894067504,0.295397982838697,14,24
299,just_relax,0.0,2,0,2,51.51758121923953,-0.0070130738256626,24,25
300,just_relax,0.0,2,1,1,2.176090181227579,-0.4053719340825536,12,19
301,just_relax,0.0,83,62,21,0.0463257670804395,0.0978081487671335,41,72
302,just_relax,0.0,224,211,13,2.118877802260272,0.3501150534536213,59,115
303,just_relax,0.0,10,11,-1,7.263885734922937,0.0159865803835295,32,37
304,just_relax,0.0,2,1,1,-18.09498835141006,0.0385428808497243,20,20
305,just_relax,0.0,24,18,6,-3.924077991018706,-0.2585920051645453,12,31
306,just_relax,0.0,0,0,0,0.0,0.2012579336083151,10,10
307,just_relax,0.0,0,3,-3,-49.22962065915245,-0.1378611328512362,20,21
308,just_relax,0.0,23,43,-20,1.1017296870397502,0.0336676100062558,39,52
309,just_relax,0.0,327,383,-56,3.217924673320951,-0.1600336506129385,42,109
310,just_relax,0.0,1,2,-1,5.192572907755576,-2.199579733930257e-05,25,28
311,just_relax,0.0,214,251,-37,4.556271872001119,-0.0724448229069102,56,106
312,just_relax,0.0,491,690,-199,10.324509138051065,-0.1924332022445395,87,189
313,just_relax,0.0,36,41,-5,-3.905350481654409,0.0651354072929994,56,82
314,just_relax,0.0,2,1,1,-4.131270133015661,0.3260798115206416,13,15
315,just_relax,0.0,134,81,53,-3.16252622581019,-0.2682164070530787,36,63
316,just_relax,0.0,0,0,0,0.0,-0.4587114210295647,16,15
317,just_relax,0.0,0,0,0,0.0,-0.0008892563571947,67,66
318,just_relax,0.0,16,16,0,5.497353341492811,0.0272417858860114,42,60
319,just_relax,0.0,1,3,-2,15.090798585859332,0.1854282180215027,39,38
320,just_relax,0.0,10,8,2,-19.57558021956268,0.4153599233368453,20,36
321,just_relax,0.0,0,0,0,0.0,-0.1740413673951768,10,9
322,just_relax,0.0,0,0,0,0.0,0.2488763801922792,13,15
323,just_relax,0.0,13,11,2,12.917350735281085,-0.0492670445850684,34,41
324,just_relax,0.0,5,3,2,20.231088485298173,0.1578080616464463,37,42
325,just_relax,0.0,13,20,-7,-8.033925750520496,-0.0281662790837985,18,29
326,just_relax,0.0,0,1,-1,-64.19099205308962,0.3555381113644569,23,22
327,just_relax,0.0,0,0,0,0.0,0.6102942552169408,13,12
328,just_relax,0.0,0,0,0,0.0,-0.1515827379329533,15,14
329,just_relax,0.0,0,0,0,0.0,-0.0706946308851173,69,68
330,just_relax,0.0,0,0,0,0.0,0.155382922715164,40,39
331,just_relax,0.0,0,11,-11,-70.22117865993843,-0.024947439935567,89,93
332,just_relax,0.0,14,15,-1,17.500582232566963,-0.0528069752238629,20,32
333,just_relax,0.0,15,2,13,-12.927645608108556,0.231931000235493,69,83
334,just_relax,0.0,4,6,-2,-11.796443439045165,-0.5700614495614724,12,15
335,just_relax,0.0,0,0,0,0.0,-0.3138860219326599,15,14
336,just_relax,0.0,1,0,1,77.24462235201851,0.1051323197128362,23,26
337,just_relax,0.0,2,3,-1,-1.1845048611982207,-0.0079337509109814,12,20
338,just_relax,0.0,241,205,36,1.9795524824545647,0.1457813996873086,64,122
339,just_relax,0.0,24,7,17,0.3262420208130621,-0.1985856027859006,58,71
340,just_relax,0.0,0,0,0,0.0,-0.2144670443279217,20,19
341,just_relax,0.0,295,372,-77,1.993573227856345,-0.1378039811638932,100,191
342,just_relax,0.0,33,33,0,9.239875709830514,-0.1116195728796227,41,61
343,just_relax,0.0,15,46,-31,11.95011059447851,0.1132198541675552,13,31
344,just_relax,0.0,2,4,-2,37.17318665170764,0.1794739134650276,10,15
345,just_relax,0.0,6,10,-4,-1.7159599310125344,-0.0474338808193776,37,47
346,just_relax,0.0,2,2,0,-15.144928269595098,0.0675872821455817,21,21
347,just_relax,0.0,0,0,0,0.0,-0.3055356259070647,11,10
348,just_relax,0.0,42,46,-4,3.6123234774912376,-0.2570342601689397,44,80
349,just_relax,0.0,3,4,-1,-1.0405876486220649,0.0906318398001225,12,21
350,just_relax,0.0,7,3,4,-1.8955858008709183,0.0642549116859474,37,43
351,just_relax,0.0,6,15,-9,6.738860159407125,0.230951694380581,41,52
352,just_relax,0.0,0,7,-7,-69.07485694842346,-0.2369565691182752,90,89
353,just_relax,0.0,0,0,0,0.0,-0.0124673962805913,22,21
354,just_relax,0.0,1,2,-1,1.0029503370738837,-0.0879096911457234,37,43
355,just_relax,0.0,1,3,-2,31.77596599057812,-0.0233757781370039,47,47
356,just_relax,0.0,4,5,-1,12.605772667316144,-0.2179870584448776,12,20
357,just_relax,0.0,165,124,41,0.4286769814647968,0.0181281323925331,84,124
358,just_relax,0.0,2,5,-3,3.609798729500156,-0.0068817524795335,88,92
359,just_relax,0.0,324,417,-93,2.369804020915211,0.0065956909541188,59,122
360,just_relax,0.0,15,2,13,-8.034345708815316,0.184695062825276,26,31
361,just_relax,0.0,0,0,0,0.0,0.2489594493899795,28,27
362,just_relax,0.0,6,4,2,11.786353432585884,-0.0167714343396539,18,26
363,just_relax,0.0,1,1,0,4.725023108944697,-0.1108243488763076,23,26
364,just_relax,0.0,1,3,-2,11.527227820609037,0.1580484595109361,43,43
365,just_relax,0.0,1,5,-4,3.597687442757106,0.0392897521290402,22,26
366,just_relax,0.0,0,0,0,0.0,0.0529345605152458,15,14
367,just_relax,0.0,16,9,7,1.0526178918667597,0.3407252145055067,36,48
368,just_relax,0.0,10,5,5,-15.172411427667086,0.3420780287038242,30,37
369,just_relax,0.0,1,6,-5,7.997672774200183,0.223851739678567,10,13
370,just_relax,0.0,0,0,0,0.0,0.3911604269177515,12,11
371,just_relax,0.0,195,171,24,1.8846819319525487,-0.156364856599542,55,105
372,just_relax,0.0,1,1,0,-30.358253449215816,0.2889006637631048,13,17
373,just_relax,0.0,0,1,-1,-24.361341939117963,-0.1237991910349206,30,29
374,just_relax,0.0,2,10,-8,13.352189791686328,-0.0913311679182318,36,43
375,just_relax,0.0,15,24,-9,-4.960614797165668,-0.3297226417735465,40,60
376,just_relax,0.0,1,1,0,26.51317967282425,0.3450742341604564,13,17
377,just_relax,0.0,6,7,-1,4.724215758527386,0.3164892361284073,23,30
378,just_relax,0.0,4,0,4,72.45620486988341,-0.2994767313725888,12,16
379,just_relax,0.0,0,0,0,0.0,0.10539257676792,26,26
380,just_relax,0.0,2,2,0,13.261177533754577,-0.3755283820468674,22,31
381,just_relax,0.0,5,11,-6,-9.829696988771218,-0.1796186514960839,68,68
382,just_relax,0.0,0,0,0,0.0,-0.1504979370582519,23,22
383,just_relax,0.0,0,6,-6,-51.54126817437598,-0.0096157232320469,43,42
384,just_relax,0.0,0,0,0,0.0,0.2336891863228194,18,17
385,just_relax,0.0,0,6,-6,-36.57689020306172,-0.2574790765001926,28,42
386,just_relax,0.0,43,45,-2,5.699806704982628,0.0344470760228817,21,44
387,just_relax,0.0,1,0,1,76.66128450976613,0.1578623060117704,36,37
388,just_relax,0.0,0,0,0,0.0,-0.0918873916467616,15,14
389,just_relax,0.0,0,1,-1,-54.5372291047633,-0.1741733706767071,14,16
390,just_relax,0.0,218,250,-32,-1.1382200486081189,-0.0620928261660663,61,119
391,just_relax,0.0,0,1,-1,-87.17585757195883,-0.2607078050470948,19,20
392,just_relax,0.0,0,2,-2,-33.03789008254508,-0.0058512944683646,22,22
393,just_relax,0.0,0,2,-2,-72.2410059477042,0.1923579119894111,54,58
394,just_relax,0.0,510,928,-418,8.742384000205668,-0.0990276133854543,65,135
395,just_relax,0.0,0,1,-1,-85.86839981312565,-0.0068576298466138,16,18
396,just_relax,0.0,7,6,1,-8.625919408226125,0.3500682852268845,17,27
397,just_relax,0.0,16,14,2,-0.509427819403534,0.0938427339465011,54,71
398,just_relax,0.0,2,3,-1,2.2374858491904206,-0.0525802976928935,23,22
399,just_relax,0.0,1,0,1,70.50964056839688,-0.3933640568082153,13,16
400,just_relax,0.0,144,320,-176,6.516066261275014,0.0393998860490246,85,131
401,just_relax,0.0,44,53,-9,-7.845037302383631,0.0740811329391886,28,55
402,just_relax,0.0,7,3,4,2.745834725636925,0.0605851358593324,18,24
403,just_relax,0.0,7,2,5,-25.846226585251337,0.3219746719228795,19,22
404,just_relax,0.0,2,1,1,46.672720520461866,-0.1369599144111266,47,46
405,just_relax,0.0,33,57,-24,15.72965407964113,0.0193597637510396,39,64
406,just_relax,0.0,1,0,1,48.9932142242404,0.4721755051600219,17,18
407,just_relax,0.0,1,2,-1,-1.8208982433863667,-0.0062216477014334,23,24
408,just_relax,0.0,7,1,6,-11.848523728545246,-0.0692679119801487,13,16
409,just_relax,0.0,15,15,0,-3.25735364438195,0.0832964581383212,40,56
410,just_relax,0.0,3,0,3,57.696620890771605,0.1182746181402206,10,15
411,just_relax,0.0,0,0,0,0.0,-0.3731645355435216,21,20
412,just_relax,0.0,2,3,-1,1.0363113671920132,0.1105005602250267,30,35
413,just_relax,0.0,2,2,0,-14.22003616942584,0.2743801021968042,71,77
414,relax_and_recompute,0.05,5,1,4,34.51633161163782,0.0045768806115087,17,18
415,relax_and_recompute,0.05,5,3,2,-19.45076625285273,0.1883327223765486,43,48
416,relax_and_recompute,0.05,2,5,-3,-11.905237955972751,-0.0124878838390225,38,45
417,relax_and_recompute,0.05,3,0,3,60.0,-0.2277512580491683,12,12
418,relax_and_recompute,0.05,18,8,10,-13.91499972384429,0.2046288424490917,23,38
419,relax_and_recompute,0.05,1,0,1,64.67086385650956,-0.0217194314688544,19,22
420,relax_and_recompute,0.05,751,750,1,-0.2183796751370366,-0.1408143165490376,35,143
421,relax_and_recompute,0.05,6,1,5,10.503954153599388,0.0593971164765823,92,91
422,relax_and_recompute,0.05,4,9,-5,-7.726694090486831,-0.1470274116609419,43,51
423,relax_and_recompute,0.05,2,0,2,77.92754578360757,-0.1014912856480964,35,36
424,relax_and_recompute,0.05,0,0,0,0.0,0.3587759145469963,11,13
425,relax_and_recompute,0.05,17,17,0,4.299190096058823,0.014069303289406,10,25
426,relax_and_recompute,0.05,23,25,-2,-0.2254047965807402,0.0722228180249577,86,136
427,relax_and_recompute,0.05,0,0,0,0.0,0.2944315127930693,10,12
428,relax_and_recompute,0.05,0,0,0,0.0,0.0282665112512258,32,31
429,relax_and_recompute,0.05,3,5,-2,1.0883918893174922,0.3847014163197619,20,26
430,relax_and_recompute,0.05,1,0,1,63.912595320549045,-0.3606531762180482,11,11
431,relax_and_recompute,0.05,4,5,-1,-26.004453287099977,0.0669015398354172,34,42
432,relax_and_recompute,0.05,16,11,5,-0.5373238449065809,0.2071280739233628,14,25
433,relax_and_recompute,0.05,16,4,12,-3.696182289571908,0.0236984729752087,31,46
434,relax_and_recompute,0.05,2,0,2,75.27217304547267,0.0100181086883035,42,45
435,relax_and_recompute,0.05,1098,1065,33,-0.2481932840477938,0.0314752238018427,39,173
436,relax_and_recompute,0.05,10,11,-1,10.656527181276148,0.1596621329942763,14,24
437,relax_and_recompute,0.05,3,3,0,48.2839399213396,0.2610198684664302,24,25
438,relax_and_recompute,0.05,2,1,1,-10.062856523241436,-0.2634783990364784,12,19
439,relax_and_recompute,0.05,68,65,3,0.5196673221706121,-0.0178023240327835,41,72
440,relax_and_recompute,0.05,185,154,31,-0.167719564027287,-0.0043556689069551,59,115
441,relax_and_recompute,0.05,7,4,3,-9.409179689632658,0.058808454652336,32,37
442,relax_and_recompute,0.05,0,0,0,0.0,0.6009620550664301,20,20
443,relax_and_recompute,0.05,20,23,-3,-3.764446409724414,0.016983194937811,12,31
444,relax_and_recompute,0.05,1,0,1,77.6665215845005,0.1828918410123894,10,10
445,relax_and_recompute,0.05,2,0,2,76.52842810061807,0.0283336488569123,20,21
446,relax_and_recompute,0.05,27,13,14,0.4574328900529423,0.1697780475468764,39,52
447,relax_and_recompute,0.05,364,312,52,0.4674867331808201,-0.3520465001835333,42,109
448,relax_and_recompute,0.05,2,2,0,-6.329856566512774,-0.0404734981270429,25,28
449,relax_and_recompute,0.05,177,200,-23,-2.3520523751670765,-0.1020482517411061,56,106
450,relax_and_recompute,0.05,459,428,31,-0.6556245493535187,0.0304287405341943,87,189
451,relax_and_recompute,0.05,54,33,21,-2.55786940692952,-0.1105618610957352,56,82
452,relax_and_recompute,0.05,1,1,0,5.146431086430795,-0.0055386994166257,13,15
453,relax_and_recompute,0.05,100,76,24,-2.080435206452904,0.2094027512013243,36,63
454,relax_and_recompute,0.05,0,0,0,0.0,0.0601783197143391,16,15
455,relax_and_recompute,0.05,0,0,0,0.0,0.2202860095101155,67,66
456,relax_and_recompute,0.05,27,10,17,-0.5942155062256944,-0.1084361787431735,42,60
457,relax_and_recompute,0.05,0,4,-4,-67.89867208564335,0.0305767523026193,39,38
458,relax_and_recompute,0.05,9,10,-1,-0.8196109333938608,0.2585332276650855,20,36
459,relax_and_recompute,0.05,0,0,0,0.0,-0.0773888977965916,10,9
460,relax_and_recompute,0.05,0,2,-2,-70.21294435619623,0.0192880968294136,13,15
461,relax_and_recompute,0.05,7,10,-3,-4.331586934313371,0.0835748767464784,34,41
462,relax_and_recompute,0.05,2,1,1,17.62113947558926,0.3861867268969422,37,42
463,relax_and_recompute,0.05,20,17,3,12.297384055453309,-0.2908396140889572,18,29
464,relax_and_recompute,0.05,3,0,3,63.03148287202481,-0.0959550721043769,23,22
465,relax_and_recompute,0.05,0,0,0,0.0,0.1678366469991489,13,12
466,relax_and_recompute,0.05,0,0,0,0.0,0.1745973534453405,15,14
467,relax_and_recompute,0.05,0,0,0,0.0,0.048112463767044,69,68
468,relax_and_recompute,0.05,0,0,0,0.0,-0.2272281451795164,40,39
469,relax_and_recompute,0.05,0,0,0,0.0,0.0854804785925167,89,93
470,relax_and_recompute,0.05,13,15,-2,1.2131287266631716,0.2080773500108792,20,32
471,relax_and_recompute,0.05,4,4,0,-7.855635126970455,-0.0504355675782126,69,83
472,relax_and_recompute,0.05,0,1,-1,-72.57226757372447,-0.2023433714974115,12,15
473,relax_and_recompute,0.05,0,1,-1,-89.31870760981424,0.2848946458173811,15,14
474,relax_and_recompute,0.05,1,0,1,83.18755929230147,0.0315731106554749,23,26
475,relax_and_recompute,0.05,5,5,0,-8.908060530001897,-0.1117991857888216,12,20
476,relax_and_recompute,0.05,205,155,50,2.9999798817440464,-0.1205954149432657,64,122
477,relax_and_recompute,0.05,8,8,0,-3.534806722776352,0.4597810582288383,58,71
478,relax_and_recompute,0.05,0,0,0,0.0,-0.0950802120711722,20,19
479,relax_and_recompute,0.05,402,302,100,0.8712720425083234,-0.0548925812027967,100,191
480,relax_and_recompute,0.05,49,35,14,3.641312629948324,-0.0119491591326449,41,61
481,relax_and_recompute,0.05,27,22,5,-2.829659439193435,0.1028624695330426,13,31
482,relax_and_recompute,0.05,1,3,-2,4.596534978344067,0.1245924792805732,10,15
483,relax_and_recompute,0.05,9,14,-5,1.3203567192336294,0.3646874475640915,37,47
484,relax_and_recompute,0.05,1,1,0,-12.625876774558122,-0.1792425829474775,21,21
485,relax_and_recompute,0.05,0,1,-1,-79.97420601091925,0.1266335233539666,11,10
486,relax_and_recompute,0.05,38,40,-2,-0.2348629232296488,-0.0397781354300662,44,80
487,relax_and_recompute,0.05,2,3,-1,6.827380568742257,0.4529663969345819,12,21
488,relax_and_recompute,0.05,8,1,7,-9.144225080265798,-0.0455057696432652,37,43
489,relax_and_recompute,0.05,14,11,3,4.798957551481841,0.2879293908227601,41,52
490,relax_and_recompute,0.05,1,7,-6,18.29839525960417,0.0769163404373654,90,89
491,relax_and_recompute,0.05,1,0,1,74.98195216449275,-0.2894989818190122,22,21
492,relax_and_recompute,0.05,4,1,3,22.756068504103965,-0.140959726216672,37,43
493,relax_and_recompute,0.05,3,0,3,56.299341830103934,-0.0606240121178611,47,47
494,relax_and_recompute,0.05,4,6,-2,8.84053593948073,0.4747449840726729,12,20
495,relax_and_recompute,0.05,126,112,14,0.2792199638563986,0.1400392123606246,84,124
496,relax_and_recompute,0.05,1,0,1,80.39689318533068,-0.1439796175080535,88,92
497,relax_and_recompute,0.05,338,338,0,1.5428071590120354,0.0910913529523527,59,122
498,relax_and_recompute,0.05,8,2,6,25.767318021523494,-0.3426184636680391,26,31
499,relax_and_recompute,0.05,2,0,2,73.18787454824358,0.1384397091960683,28,27
500,relax_and_recompute,0.05,5,5,0,-0.5601608559311444,0.1381233425766698,18,26
501,relax_and_recompute,0.05,3,1,2,2.7349201270319554,0.1112716734205712,23,26
502,relax_and_recompute,0.05,3,1,2,-5.17142899617302,0.1583479147857389,43,43
503,relax_and_recompute,0.05,0,1,-1,-39.12157493047187,0.1316400379452056,22,26
504,relax_and_recompute,0.05,0,0,0,0.0,-0.1650042874237867,15,14
505,relax_and_recompute,0.05,9,9,0,2.272218979057598,0.1268974189325489,36,48
506,relax_and_recompute,0.05,9,5,4,-0.4359865445220663,-0.1843556466122097,30,37
507,relax_and_recompute,0.05,1,1,0,-9.265358282590968,-0.1581906387335891,10,13
508,relax_and_recompute,0.05,1,0,1,84.19342535514309,-0.0014380312356602,12,11
509,relax_and_recompute,0.05,193,190,3,0.9205370966867292,-0.0906208881710869,55,105
510,relax_and_recompute,0.05,4,1,3,23.61324683321751,0.0551113588362216,13,17
511,relax_and_recompute,0.05,0,0,0,0.0,-0.3438969242372882,30,29
512,relax_and_recompute,0.05,9,1,8,12.245621680347211,0.0539765900056009,36,43
513,relax_and_recompute,0.05,35,10,25,2.815691442733268,-0.0588200934107788,40,60
514,relax_and_recompute,0.05,2,1,1,12.676685256162145,0.2699170236150919,13,17
515,relax_and_recompute,0.05,6,6,0,-16.938608452270486,-0.2942472630852923,23,30
516,relax_and_recompute,0.05,3,4,-1,35.3377975842212,0.2399097651577497,12,16
517,relax_and_recompute,0.05,1,1,0,2.0980224588329435,-0.4346582998902917,26,26
518,relax_and_recompute,0.05,3,3,0,30.84258082171889,-0.2429127093590761,22,31
519,relax_and_recompute,0.05,0,0,0,0.0,0.0587663202735667,68,68
520,relax_and_recompute,0.05,0,0,0,0.0,-0.0406347734187215,23,22
521,relax_and_recompute,0.05,0,0,0,0.0,-0.0327618568260342,43,42
522,relax_and_recompute,0.05,2,0,2,88.21428541811275,0.1721792136693893,18,17
523,relax_and_recompute,0.05,11,3,8,-9.873187458390198,-0.162668029569285,28,42
524,relax_and_recompute,0.05,37,54,-17,5.892769795433488,-0.0243376777391184,21,44
525,relax_and_recompute,0.05,0,0,0,0.0,0.0087033724720265,36,37
526,relax_and_recompute,0.05,0,0,0,0.0,-0.1823407225861089,15,14
527,relax_and_recompute,0.05,0,2,-2,-68.49765564950621,0.1557436676090567,14,16
528,relax_and_recompute,0.05,325,196,129,-0.186113509306665,0.026531382158262,61,119
529,relax_and_recompute,0.05,0,0,0,0.0,0.1461119986584536,19,20
530,relax_and_recompute,0.05,0,0,0,0.0,0.2179878728967059,22,22
531,relax_and_recompute,0.05,4,4,0,10.572128221479588,0.2216366516832331,54,58
532,relax_and_recompute,0.05,418,455,-37,1.0561117103134023,-0.066623429462541,65,135
533,relax_and_recompute,0.05,5,0,5,67.225834341662,0.2007925268334572,16,18
534,relax_and_recompute,0.05,13,8,5,4.52728761897761,-0.0781284679965146,17,27
535,relax_and_recompute,0.05,14,10,4,3.4327669992583907,0.0017255524790485,54,71
536,relax_and_recompute,0.05,0,2,-2,-57.09663443481336,-0.0897408929227959,23,22
537,relax_and_recompute,0.05,1,0,1,29.988980488720728,-0.0587289580362676,13,16
538,relax_and_recompute,0.05,177,130,47,2.095402593694942,-0.2182450086143014,85,131
539,relax_and_recompute,0.05,33,41,-8,-4.1578098129958505,0.2238894918989642,28,55
540,relax_and_recompute,0.05,1,2,-1,19.58525202634325,0.0987404244061046,18,24
541,relax_and_recompute,0.05,1,2,-1,0.1400319031711063,-0.3092352068359308,19,22
542,relax_and_recompute,0.05,1,0,1,89.94610232166602,0.089934855939592,47,46
543,relax_and_recompute,0.05,38,17,21,-8.026158476826666,0.170781634039598,39,64
544,relax_and_recompute,0.05,1,0,1,77.92665336851229,-0.3772122238169296,17,18
545,relax_and_recompute,0.05,4,1,3,-12.180241365516196,0.0758713334421076,23,24
546,relax_and_recompute,0.05,1,1,0,-3.254147762830499,0.2650117778309805,13,16
547,relax_and_recompute,0.05,19,12,7,3.346828438896964,-0.1034855577993643,40,56
548,relax_and_recompute,0.05,3,1,2,-27.46381691010452,0.4022166168158572,10,15
549,relax_and_recompute,0.05,0,0,0,0.0,-0.2368110743444799,21,20
550,relax_and_recompute,0.05,5,1,4,-3.7595916793114696,-0.3078563261076684,30,35
551,relax_and_recompute,0.05,4,3,1,31.23365761684817,0.4544866469787923,71,77
552,relax_one,0.05,1,0,1,83.85873066135562,-0.0288207696279177,17,18
553,relax_one,0.05,11,8,3,9.021385396235225,0.0802695456843455,43,48
554,relax_one,0.05,1,3,-2,11.437745366761618,0.1133342236916526,38,45
555,relax_one,0.05,0,0,0,0.0,-0.1269391201880667,12,12
556,relax_one,0.05,8,10,-2,-0.3933622397533298,-0.3860052307009229,23,38
557,relax_one,0.05,0,1,-1,-67.02031095969845,0.2668114538770477,19,22
558,relax_one,0.05,846,795,51,0.032884639917377,0.0848259052312884,35,143
559,relax_one,0.05,0,3,-3,-57.08906523411952,0.0756764165006452,92,91
560,relax_one,0.05,11,2,9,16.787918375564878,-0.0948654231500719,43,51
561,relax_one,0.05,3,0,3,78.0836598496836,-0.3057915769040106,35,36
562,relax_one,0.05,0,0,0,0.0,0.3384100477848551,11,13
563,relax_one,0.05,24,19,5,2.938966658262565,-0.1952808625084254,10,25
564,relax_one,0.05,50,14,36,-4.104651941353652,0.3442183046568556,86,136
565,relax_one,0.05,0,0,0,0.0,0.0509133750690821,10,12
566,relax_one,0.05,0,0,0,0.0,-0.0514545071728042,32,31
567,relax_one,0.05,9,8,1,0.9859360770813196,0.151015669479917,20,26
568,relax_one,0.05,1,1,0,-4.081604202981794,-0.4764484296479691,11,11
569,relax_one,0.05,11,12,-1,-8.341747930904475,0.0358633792983571,34,42
570,relax_one,0.05,11,15,-4,3.997147746285792,0.0073145193613859,14,25
571,relax_one,0.05,4,4,0,-0.7335849868747104,-0.0964586812002545,31,46
572,relax_one,0.05,0,1,-1,-60.97140284953851,-0.0065677810440473,42,45
573,relax_one,0.05,1128,1079,49,0.098061399067646,0.0876382287029329,39,173
574,relax_one,0.05,11,14,-3,2.718547240663568,-0.0518595932253734,14,24
575,relax_one,0.05,1,1,0,0.6201318249706702,0.329270768165986,24,25
576,relax_one,0.05,1,1,0,4.237519131902943,-0.3440110020452085,12,19
577,relax_one,0.05,65,69,-4,8.335417954956334,0.0460265814524156,41,72
578,relax_one,0.05,170,211,-41,1.7136237035843394,0.0744357808312542,59,115
579,relax_one,0.05,5,10,-5,19.84688782618197,0.0392220478480964,32,37
580,relax_one,0.05,1,0,1,75.16154395287091,0.1556893006437051,20,20
581,relax_one,0.05,21,22,-1,1.1570907294116353,-0.0198838580225408,12,31
582,relax_one,0.05,0,0,0,0.0,0.0639799689938896,10,10
583,relax_one,0.05,2,1,1,-28.93671207393524,-0.3067329070420641,20,21
584,relax_one,0.05,21,17,4,1.0840491945861217,-0.0722634664246435,39,52
585,relax_one,0.05,352,356,-4,0.3413743038465995,-0.1164835832026136,42,109
586,relax_one,0.05,2,0,2,66.25373648324924,0.1752453123883555,25,28
587,relax_one,0.05,172,175,-3,-2.107527064558603,0.1801386495213794,56,106
588,relax_one,0.05,603,465,138,1.326771887252221,-0.0122043120113153,87,189
589,relax_one,0.05,45,47,-2,0.299727702169001,-0.2052712177806905,56,82
590,relax_one,0.05,1,1,0,2.0021685902112267,0.0159246886544355,13,15
591,relax_one,0.05,77,69,8,-1.956168470384739,-0.0133573563279629,36,63
592,relax_one,0.05,1,0,1,84.88735436353407,-0.0928029427793195,16,15
593,relax_one,0.05,0,0,0,0.0,-0.4725959246629443,67,66
594,relax_one,0.05,13,13,0,-3.3822722517005133,0.0089513430804862,42,60
595,relax_one,0.05,0,0,0,0.0,-0.1590831720894227,39,38
596,relax_one,0.05,11,13,-2,-8.948324031603264,0.143900470027303,20,36
597,relax_one,0.05,1,0,1,81.49058559585059,-0.0303481069417056,10,9
598,relax_one,0.05,0,0,0,0.0,-0.4103985405327678,13,15
599,relax_one,0.05,7,10,-3,18.91533781879842,-0.0992099211849656,34,41
600,relax_one,0.05,5,3,2,-19.408179222703204,-0.0258794431205968,37,42
601,relax_one,0.05,22,15,7,0.3398584282066821,-0.254578143258516,18,29
602,relax_one,0.05,1,2,-1,20.507187788958504,0.1371110289176178,23,22
603,relax_one,0.05,0,0,0,0.0,0.332369607074983,13,12
604,relax_one,0.05,0,1,-1,-83.31800418846103,0.0451151659740157,15,14
605,relax_one,0.05,0,0,0,0.0,0.3457027464185312,69,68
606,relax_one,0.05,0,0,0,0.0,0.4215715358034586,40,39
607,relax_one,0.05,3,2,1,-19.85633248998968,-0.1250614014358561,89,93
608,relax_one,0.05,7,12,-5,-6.185633587306384,0.1284092799147306,20,32
609,relax_one,0.05,4,2,2,-13.455693528552118,0.0387987429896323,69,83
610,relax_one,0.05,2,1,1,-3.8823567060236712,-0.2344757834737808,12,15
611,relax_one,0.05,0,0,0,0.0,0.2915033409370291,15,14
612,relax_one,0.05,0,0,0,0.0,-0.070746263736008,23,26
613,relax_one,0.05,3,2,1,-26.072282835406625,0.0469686033613149,12,20
614,relax_one,0.05,232,186,46,-0.9887761269212234,-0.2155919542363319,64,122
615,relax_one,0.05,5,15,-10,-0.9575204372457762,0.2205855020106351,58,71
616,relax_one,0.05,0,1,-1,-75.4235309588474,0.0547755599747316,20,19
617,relax_one,0.05,363,269,94,-5.427460720131393,0.0830899038032543,100,191
618,relax_one,0.05,39,23,16,-9.504486083618112,0.0130578897547517,41,61
619,relax_one,0.05,24,32,-8,-2.928987793682168,0.3164788611491796,13,31
620,relax_one,0.05,6,1,5,8.364755287560925,-0.1209547865687956,10,15
621,relax_one,0.05,12,11,1,14.845336022863007,0.1314560348382253,37,47
622,relax_one,0.05,1,0,1,68.33173470575656,-0.0273192535588491,21,21
623,relax_one,0.05,1,0,1,84.39342000599049,-0.0374006211288486,11,10
624,relax_one,0.05,57,50,7,0.953436595662609,-0.1517883806106538,44,80
625,relax_one,0.05,3,6,-3,1.3533260552985809,-0.1482639269394688,12,21
626,relax_one,0.05,6,1,5,8.190366488518592,0.0822567584494256,37,43
627,relax_one,0.05,8,18,-10,8.915584106500155,0.2605733743247307,41,52
628,relax_one,0.05,0,1,-1,-88.30995623643358,0.035169423184321,90,89
629,relax_one,0.05,0,0,0,0.0,-0.3166551847467213,22,21
630,relax_one,0.05,4,1,3,-10.840963480630194,-0.1606645393178656,37,43
631,relax_one,0.05,0,1,-1,-70.47419190542479,0.0703684572637393,47,47
632,relax_one,0.05,6,4,2,-7.869482331037872,-0.2012118099563437,12,20
633,relax_one,0.05,113,101,12,-2.7095551262849966,-0.0191871759361547,84,124
634,relax_one,0.05,7,0,7,70.30908898114933,-0.0457837586594406,88,92
635,relax_one,0.05,394,344,50,-3.198921023114252,0.1219365890441659,59,122
636,relax_one,0.05,4,4,0,0.3558194585375105,-0.0943123331977391,26,31
637,relax_one,0.05,0,0,0,0.0,0.1424947729502829,28,27
638,relax_one,0.05,6,2,4,34.23215831359647,0.1715617407361711,18,26
639,relax_one,0.05,6,4,2,-17.968595838784083,-0.034684649514736,23,26
640,relax_one,0.05,4,0,4,57.29038409208989,-0.2084705828240828,43,43
641,relax_one,0.05,2,5,-3,11.867908314845394,-0.0002655026839283,22,26
642,relax_one,0.05,0,0,0,0.0,0.1099828871765111,15,14
643,relax_one,0.05,12,11,1,-16.366018311547002,0.0533952324772548,36,48
644,relax_one,0.05,4,10,-6,-13.357266388360364,0.3895797507959271,30,37
645,relax_one,0.05,3,3,0,-18.15228308081624,0.3559650229888019,10,13
646,relax_one,0.05,0,0,0,0.0,0.2413949634094144,12,11
647,relax_one,0.05,206,150,56,2.0260226464511817,0.111705498275642,55,105
648,relax_one,0.05,0,3,-3,-69.69392118302939,0.0381089944937784,13,17
649,relax_one,0.05,0,0,0,0.0,0.3620839108437086,30,29
650,relax_one,0.05,1,1,0,21.075000799684915,-0.0011529018639389,36,43
651,relax_one,0.05,25,20,5,-6.0611754035315215,-0.4005226923229252,40,60
652,relax_one,0.05,2,0,2,52.55790281681608,-0.183953299427191,13,17
653,relax_one,0.05,3,7,-4,0.9366055561739728,0.1879173623441137,23,30
654,relax_one,0.05,0,1,-1,-53.00721173635584,-0.0063131816231351,12,16
655,relax_one,0.05,0,0,0,0.0,0.0869648240332947,26,26
656,relax_one,0.05,1,1,0,21.336621724634742,0.0521759793523458,22,31
657,relax_one,0.05,0,0,0,0.0,-0.2263632623466517,68,68
658,relax_one,0.05,0,0,0,0.0,0.0065174801343509,23,22
659,relax_one,0.05,0,0,0,0.0,0.0948347927435426,43,42
660,relax_one,0.05,1,0,1,62.36159523375012,0.2918350794157159,18,17
661,relax_one,0.05,15,1,14,-14.857723699114215,-0.0208001742658768,28,42
662,relax_one,0.05,54,39,15,-0.6051495970557426,0.0912855125159399,21,44
663,relax_one,0.05,0,1,-1,-86.38665012354868,0.0977122912106051,36,37
664,relax_one,0.05,0,0,0,0.0,0.0025574231811209,15,14
665,relax_one,0.05,2,1,1,-43.14070237840022,0.1344859503071769,14,16
666,relax_one,0.05,199,231,-32,3.156528997191785,-0.0574639834578113,61,119
667,relax_one,0.05,2,0,2,80.71546529102477,0.2050094339505268,19,20
668,relax_one,0.05,3,0,3,71.58588361867864,0.3042676364954039,22,22
669,relax_one,0.05,1,0,1,70.30838451466921,0.0229185911677363,54,58
670,relax_one,0.05,475,465,10,0.2676128856457396,0.1455309809630436,65,135
671,relax_one,0.05,2,1,1,-11.089735191756446,0.0882692980518942,16,18
672,relax_one,0.05,7,8,-1,-2.3510596358601887,-0.250101802393939,17,27
673,relax_one,0.05,6,24,-18,15.261111663501282,0.190346545365413,54,71
674,relax_one,0.05,1,0,1,80.29349486199017,0.0619583693708837,23,22
675,relax_one,0.05,2,0,2,57.56354316315049,0.1276910147853677,13,16
676,relax_one,0.05,126,120,6,0.1998846935894533,-0.1745832939005577,85,131
677,relax_one,0.05,59,35,24,1.2902866264540478,0.2674299567050968,28,55
678,relax_one,0.05,4,3,1,22.471767330325378,-0.0558007832714402,18,24
679,relax_one,0.05,1,1,0,5.380182042245011,-0.0621186424886356,19,22
680,relax_one,0.05,0,0,0,0.0,0.1491458362395583,47,46
681,relax_one,0.05,48,34,14,-4.140652118080439,-0.0373390320033319,39,64
682,relax_one,0.05,0,1,-1,-58.25794546538848,0.272158405414362,17,18
683,relax_one,0.05,1,3,-2,-20.00382106098366,-0.2178157902119591,23,24
684,relax_one,0.05,2,3,-1,-5.262979862591976,0.3575045912300104,13,16
685,relax_one,0.05,15,18,-3,7.781431800621675,0.2280784891338982,40,56
686,relax_one,0.05,2,1,1,-36.19159950483846,0.141316859862267,10,15
687,relax_one,0.05,0,0,0,0.0,-0.0994654623511489,21,20
688,relax_one,0.05,8,1,7,4.907312639378276,0.018131678936302,30,35
689,relax_one,0.05,4,2,2,4.405773786117635,0.1104778838336046,71,77
690,just_relax,0.05,0,1,-1,-83.75070315362655,0.0090599893863878,17,18
691,just_relax,0.05,10,26,-16,11.8143458812699,-0.0173634397300558,43,48
692,just_relax,0.05,9,13,-4,2.401253445032978,0.458025487808594,38,45
693,just_relax,0.05,2,0,2,59.99716244049033,-0.1791957778770266,12,12
694,just_relax,0.05,12,16,-4,6.585027703909731,-0.3268266082620384,23,38
695,just_relax,0.05,1,1,0,-5.036731876438822,0.3207114805753207,19,22
696,just_relax,0.05,770,903,-133,-0.7010360388206465,0.0716979189935107,35,143
697,just_relax,0.05,3,9,-6,17.23819440829846,-0.1101487996990256,92,91
698,just_relax,0.05,3,49,-46,-9.930299522441338,-0.1079166263146015,43,51
699,just_relax,0.05,2,18,-16,12.272652546802654,0.0419084218102362,35,36
700,just_relax,0.05,3,0,3,83.59576022840065,0.2072929888491996,11,13
701,just_relax,0.05,25,22,3,14.155486326538911,-0.2297282250104493,10,25
702,just_relax,0.05,35,43,-8,11.11386323251913,-0.1641665780892669,86,136
703,just_relax,0.05,0,0,0,0.0,0.0140836336566123,10,12
704,just_relax,0.05,0,0,0,0.0,0.0066251209952237,32,31
705,just_relax,0.05,7,3,4,5.829156450371464,-0.0684653038288037,20,26
706,just_relax,0.05,0,0,0,0.0,0.1729255134906204,11,11
707,just_relax,0.05,6,12,-6,-0.6826737581539817,-0.140447984293881,34,42
708,just_relax,0.05,15,17,-2,28.950070367907927,-0.080277241351747,14,25
709,just_relax,0.05,12,15,-3,-5.153100404211237,-0.0679683653981604,31,46
710,just_relax,0.05,3,3,0,39.35327569257501,-0.0559316174325723,42,45
711,just_relax,0.05,1078,1181,-103,1.0609610703962389,-0.1200057315828991,39,173
712,just_relax,0.05,11,9,2,1.7641243517791168,0.2653811198637658,14,24
713,just_relax,0.05,0,0,0,0.0,0.1647906835417333,24,25
714,just_relax,0.05,0,2,-2,-57.88829299140237,0.0987395053470365,12,19
715,just_relax,0.05,69,68,1,2.5988085493425004,0.0399411414824387,41,72
716,just_relax,0.05,266,178,88,2.2532421990581497,-0.1792511998756818,59,115
717,just_relax,0.05,4,7,-3,11.303030367297644,-3.54377721155652e-05,32,37
718,just_relax,0.05,3,1,2,-13.848591355808423,0.2635068871369865,20,20
719,just_relax,0.05,24,22,2,-0.637794263044043,-0.0109904056677893,12,31
720,just_relax,0.05,0,0,0,0.0,0.4102329540916533,10,10
721,just_relax,0.05,1,0,1,67.53041700936264,-0.0488861994513429,20,21
722,just_relax,0.05,28,33,-5,10.603515865709705,-0.1702942914854286,39,52
723,just_relax,0.05,422,396,26,-0.3298801342404971,0.1316660499138289,42,109
724,just_relax,0.05,2,2,0,-3.265691438065005,0.1616352722411025,25,28
725,just_relax,0.05,152,244,-92,7.489483859335294,0.0365887074809576,56,106
726,just_relax,0.05,532,817,-285,11.158295874019151,-0.1201831579373201,87,189
727,just_relax,0.05,35,34,1,-3.5117459657754466,0.2066362667214529,56,82
728,just_relax,0.05,1,1,0,14.772477980701836,-0.1980855997182145,13,15
729,just_relax,0.05,91,136,-45,8.013468482956867,-0.2819691300451867,36,63
730,just_relax,0.05,0,0,0,0.0,-0.2485683363323099,16,15
731,just_relax,0.05,0,0,0,0.0,0.0399676661829039,67,66
732,just_relax,0.05,13,27,-14,11.510287973605422,0.1383841676210895,42,60
733,just_relax,0.05,1,2,-1,12.039517781109993,-0.2647593679454535,39,38
734,just_relax,0.05,11,8,3,-25.085844980233084,0.1428602747252102,20,36
735,just_relax,0.05,0,0,0,0.0,0.2979764519441308,10,9
736,just_relax,0.05,4,0,4,74.49974776209051,0.0406929248137326,13,15
737,just_relax,0.05,9,12,-3,3.6747897718580873,-0.164008461099313,34,41
738,just_relax,0.05,5,3,2,-21.49190733875028,0.1030629810421803,37,42
739,just_relax,0.05,22,33,-11,0.2208998967378903,0.0399145897869405,18,29
740,just_relax,0.05,5,4,1,17.67463094434568,-0.0111623156938215,23,22
741,just_relax,0.05,0,0,0,0.0,0.265285235541144,13,12
742,just_relax,0.05,1,0,1,87.9818631050406,-0.42141503658035,15,14
743,just_relax,0.05,0,0,0,0.0,-0.0758237383824185,69,68
744,just_relax,0.05,0,0,0,0.0,0.4484636231400239,40,39
745,just_relax,0.05,4,5,-1,-5.924735196153264,-0.0945749972568652,89,93
746,just_relax,0.05,10,22,-12,7.05090767373261,-0.092185130803419,20,32
747,just_relax,0.05,4,3,1,-28.687586154255875,0.1776940851418431,69,83
748,just_relax,0.05,1,2,-1,-10.004040032413409,0.3402028305405651,12,15
749,just_relax,0.05,1,0,1,83.5847359103608,-0.1626158663179077,15,14
750,just_relax,0.05,1,0,1,88.85738209861546,-0.1779488226585225,23,26
751,just_relax,0.05,3,2,1,-26.141475719892284,0.0640690775643734,12,20
752,just_relax,0.05,192,225,-33,1.540349006647773,0.3017016509210493,64,122
753,just_relax,0.05,5,16,-11,5.9413072889244205,-0.0351190955147049,58,71
754,just_relax,0.05,0,1,-1,-50.84396266913589,-0.2621540874521264,20,19
755,just_relax,0.05,275,265,10,6.292149263235338,-0.2750659714092319,100,191
756,just_relax,0.05,32,61,-29,15.989973031152267,0.0905903891149285,41,61
757,just_relax,0.05,35,40,-5,4.893190945576592,0.0910225983807198,13,31
758,just_relax,0.05,4,7,-3,1.6189669625188827,-0.0060552923564265,10,15
759,just_relax,0.05,8,10,-2,6.572464647749712,0.2616781232987385,37,47
760,just_relax,0.05,1,5,-4,19.03500837970285,-0.2671633977334645,21,21
761,just_relax,0.05,0,0,0,0.0,0.1629122875762646,11,10
762,just_relax,0.05,55,63,-8,-1.1298251328286213,-0.0372835772380868,44,80
763,just_relax,0.05,6,2,4,0.3137525279838371,0.2588602934998347,12,21
764,just_relax,0.05,0,2,-2,-40.215269790131615,-0.1370467740463206,37,43
765,just_relax,0.05,45,13,32,-12.674206292224191,0.0575445949552893,41,52
766,just_relax,0.05,3,9,-6,-6.532970159104899,-0.0644691364716405,90,89
767,just_relax,0.05,0,11,-11,-50.483884649607965,0.0269234377574786,22,21
768,just_relax,0.05,4,10,-6,11.776289479702257,0.0293045824129313,37,43
769,just_relax,0.05,4,5,-1,13.49664962434658,0.1566664972794493,47,47
770,just_relax,0.05,5,4,1,-3.547194623132043,0.1531837678576725,12,20
771,just_relax,0.05,128,130,-2,1.198058545538565,0.0022569745283586,84,124
772,just_relax,0.05,1,1,0,52.885275281402286,-0.0256135392832601,88,92
773,just_relax,0.05,343,422,-79,0.9604984553924184,-0.0408296551368382,59,122
774,just_relax,0.05,7,2,5,-0.3451172880382174,0.0466735967917386,26,31
775,just_relax,0.05,0,4,-4,-64.04728610221535,0.0023442972942024,28,27
776,just_relax,0.05,9,4,5,10.19643225735662,0.0452705926341215,18,26
777,just_relax,0.05,2,6,-4,13.789207969532768,-0.1282187828327686,23,26
778,just_relax,0.05,4,2,2,-11.506914530803911,-0.0803044978567326,43,43
779,just_relax,0.05,3,5,-2,0.8963518415369691,0.1114861859873196,22,26
780,just_relax,0.05,0,0,0,0.0,-0.2649287963307436,15,14
781,just_relax,0.05,13,21,-8,9.160764792149775,0.2710879887350879,36,48
782,just_relax,0.05,4,3,1,25.08236631366446,-0.1785933195524865,30,37
783,just_relax,0.05,3,3,0,20.651681944957843,0.0411005674556897,10,13
784,just_relax,0.05,1,0,1,88.55485459268837,-0.0111270663793008,12,11
785,just_relax,0.05,171,200,-29,6.589305695131522,-0.2119767986387418,55,105
786,just_relax,0.05,0,1,-1,-78.62801567562803,0.6373391062062405,13,17
787,just_relax,0.05,5,0,5,57.56318645282408,-0.0462190350752181,30,29
788,just_relax,0.05,19,16,3,0.7621081691231666,-0.1494552650250139,36,43
789,just_relax,0.05,20,24,-4,-1.4637616857314413,0.2170016318044059,40,60
790,just_relax,0.05,0,2,-2,-36.3663045861273,0.5508314127628602,13,17
791,just_relax,0.05,7,5,2,-8.454944504027495,0.3309781896886976,23,30
792,just_relax,0.05,0,1,-1,-51.52360210185864,0.1638796162971837,12,16
793,just_relax,0.05,2,1,1,26.78007293517841,-0.0644810279539278,26,26
794,just_relax,0.05,3,0,3,73.04652968217965,0.0264580874132212,22,31
795,just_relax,0.05,6,1,5,-1.0390567741186558,-0.0508819216515463,68,68
796,just_relax,0.05,0,0,0,0.0,0.0804784316422918,23,22
797,just_relax,0.05,0,0,0,0.0,-0.1410697563399107,43,42
798,just_relax,0.05,0,0,0,0.0,-0.2627463163612364,18,17
799,just_relax,0.05,15,21,-6,1.0672379015115467,0.329921202080808,28,42
800,just_relax,0.05,51,35,16,-1.4629929156538424,0.1521279250800007,21,44
801,just_relax,0.05,0,0,0,0.0,-0.4271025698066343,36,37
802,just_relax,0.05,0,0,0,0.0,0.1075479281789496,15,14
803,just_relax,0.05,3,0,3,82.01196821602316,0.167037240651641,14,16
804,just_relax,0.05,202,328,-126,1.815237993838508,0.0150734969885483,61,119
805,just_relax,0.05,0,1,-1,-87.92248622606334,0.0884653069546811,19,20
806,just_relax,0.05,1,1,0,-1.1537564354502194,-0.141082166700225,22,22
807,just_relax,0.05,0,19,-19,-63.7761531777765,0.0720690912116641,54,58
808,just_relax,0.05,474,936,-462,3.968507775141447,-0.2424103167498015,65,135
809,just_relax,0.05,1,1,0,-0.3453182407671704,0.036944419132717,16,18
810,just_relax,0.05,6,9,-3,3.7296342443595663,0.0854456227745835,17,27
811,just_relax,0.05,15,5,10,0.7774409748693856,-0.1355993821243833,54,71
812,just_relax,0.05,0,1,-1,-69.8313649251691,0.2641258911490901,23,22
813,just_relax,0.05,3,5,-2,-4.083685207814497,-0.2941758017669678,13,16
814,just_relax,0.05,175,234,-59,0.7253796356826712,-0.11574051176262,85,131
815,just_relax,0.05,45,37,8,-3.457608706462473,-0.1091524004828786,28,55
816,just_relax,0.05,1,2,-1,21.401892280340093,0.2995504383625252,18,24
817,just_relax,0.05,2,1,1,16.161951615599477,-0.022949887744334,19,22
818,just_relax,0.05,2,1,1,30.73794665876345,-0.178801520520392,47,46
819,just_relax,0.05,46,74,-28,15.416328720686522,-0.218673959561919,39,64
820,just_relax,0.05,2,0,2,83.64611309066451,0.0400640308990407,17,18
821,just_relax,0.05,1,5,-4,15.303205550217385,0.1721810716709723,23,24
822,just_relax,0.05,1,3,-2,5.865823873141963,0.2171755255301881,13,16
823,just_relax,0.05,20,48,-28,7.8368752020423,0.0074388911814949,40,56
824,just_relax,0.05,1,0,1,86.59356896320885,0.0376651387949489,10,15
825,just_relax,0.05,0,0,0,0.0,0.0816448958960954,21,20
826,just_relax,0.05,6,4,2,-10.257802795994095,0.4818724132921935,30,35
827,just_relax,0.05,3,2,1,-15.811194894030358,0.0327428656255558,71,77
828,relax_and_recompute,0.1,0,0,0,0.0,-0.1044250140733287,17,18
829,relax_and_recompute,0.1,10,8,2,-5.224215117862791,0.0152152239549415,43,48
830,relax_and_recompute,0.1,7,2,5,-3.272384826481684,0.0409574004915856,38,45
831,relax_and_recompute,0.1,0,0,0,0.0,0.4558380253651886,12,12
832,relax_and_recompute,0.1,18,3,15,-21.33954620170342,-0.0513558985224744,23,38
833,relax_and_recompute,0.1,0,2,-2,-87.53795290923259,0.0553207451183804,19,22
834,relax_and_recompute,0.1,752,994,-242,0.3493373252402563,-0.0464738018535614,35,143
835,relax_and_recompute,0.1,11,5,6,11.68722021319659,-0.1689168486423085,92,91
836,relax_and_recompute,0.1,3,2,1,39.58527957196,0.0320802390423555,43,51
837,relax_and_recompute,0.1,0,3,-3,-79.51885324735444,-0.0638625763786989,35,36
838,relax_and_recompute,0.1,0,0,0,0.0,-0.0953789119341838,11,13
839,relax_and_recompute,0.1,26,12,14,-3.9620747293064937,-0.2685803876555311,10,25
840,relax_and_recompute,0.1,15,15,0,-7.78089956509433,-0.3030179510157118,86,136
841,relax_and_recompute,0.1,2,0,2,57.977398830093904,-0.0153996398346966,10,12
842,relax_and_recompute,0.1,0,0,0,0.0,0.0276712417707197,32,31
843,relax_and_recompute,0.1,4,3,1,1.4977974509007057,-0.2123008068603862,20,26
844,relax_and_recompute,0.1,0,0,0,0.0,0.4641779563419346,11,11
845,relax_and_recompute,0.1,3,5,-2,12.240491172557086,0.1543085445986716,34,42
846,relax_and_recompute,0.1,13,11,2,14.10065015935738,0.0279355607283016,14,25
847,relax_and_recompute,0.1,13,4,9,1.1189700881947149,-0.0410621520835373,31,46
848,relax_and_recompute,0.1,1,1,0,-4.3003368788911445,-0.0041922364237615,42,45
849,relax_and_recompute,0.1,1059,1181,-122,-0.4343455066527184,0.0340247554810858,39,173
850,relax_and_recompute,0.1,8,12,-4,0.6026089934084524,0.2289643594209417,14,24
851,relax_and_recompute,0.1,1,0,1,82.65695165066481,-0.0264841195470676,24,25
852,relax_and_recompute,0.1,1,1,0,0.1308453016629869,-0.057662313498528,12,19
853,relax_and_recompute,0.1,60,80,-20,-3.745298924936094,-0.0333219777115912,41,72
854,relax_and_recompute,0.1,200,203,-3,-0.8868510237361349,0.072595957061234,59,115
855,relax_and_recompute,0.1,11,3,8,9.021018607364873,0.2444352906321308,32,37
856,relax_and_recompute,0.1,3,0,3,72.28241092700448,0.2340090126202596,20,20
857,relax_and_recompute,0.1,22,25,-3,1.9462228883488704,-0.0636374175854229,12,31
858,relax_and_recompute,0.1,1,0,1,72.70411208187816,-0.3764965699470678,10,10
859,relax_and_recompute,0.1,0,3,-3,-63.7176840012425,-0.4153976477719975,20,21
860,relax_and_recompute,0.1,17,16,1,8.293537170255561,-0.0743442568579004,39,52
861,relax_and_recompute,0.1,440,333,107,-1.6385790611083024,-0.2907016876047991,42,109
862,relax_and_recompute,0.1,1,2,-1,24.782861369208177,0.5402119834303245,25,28
863,relax_and_recompute,0.1,184,184,0,-0.7200268288094449,-0.0392672751593947,56,106
864,relax_and_recompute,0.1,467,448,19,-1.1017829715078662,-0.0783935092384735,87,189
865,relax_and_recompute,0.1,43,34,9,-0.9563003645031928,0.311130042023391,56,82
866,relax_and_recompute,0.1,1,1,0,12.947951254680063,-0.2051798068070759,13,15
867,relax_and_recompute,0.1,87,81,6,4.086735078411756,-0.2280680651831939,36,63
868,relax_and_recompute,0.1,0,0,0,0.0,0.068557236678543,16,15
869,relax_and_recompute,0.1,0,0,0,0.0,0.1569866081105939,67,66
870,relax_and_recompute,0.1,14,16,-2,7.191187062498386,0.4004878807342101,42,60
871,relax_and_recompute,0.1,4,2,2,28.938984382944668,0.0984079375541873,39,38
872,relax_and_recompute,0.1,11,8,3,-15.045448092893906,0.2269647020805404,20,36
873,relax_and_recompute,0.1,0,0,0,0.0,0.1191759295347405,10,9
874,relax_and_recompute,0.1,0,1,-1,-69.98054166658376,0.214959580625019,13,15
875,relax_and_recompute,0.1,6,11,-5,-5.328939137956652,-0.1667389543816171,34,41
876,relax_and_recompute,0.1,5,4,1,-1.3248637991664085,-0.0408528968062593,37,42
877,relax_and_recompute,0.1,18,26,-8,-6.113042514256605,0.2501219283953824,18,29
878,relax_and_recompute,0.1,0,0,0,0.0,-0.2189354690487972,23,22
879,relax_and_recompute,0.1,0,0,0,0.0,-0.0012026260984507,13,12
880,relax_and_recompute,0.1,0,0,0,0.0,0.1669123291378369,15,14
881,relax_and_recompute,0.1,0,0,0,0.0,-0.0517614124097671,69,68
882,relax_and_recompute,0.1,0,0,0,0.0,0.3569848349220257,40,39
883,relax_and_recompute,0.1,0,0,0,0.0,-0.0552713298666671,89,93
884,relax_and_recompute,0.1,14,10,4,1.0558751417124768,-0.2322391089725375,20,32
885,relax_and_recompute,0.1,4,3,1,-2.937121440924642,0.1318788994213504,69,83
886,relax_and_recompute,0.1,0,1,-1,-75.789863516428,-0.0240252310792816,12,15
887,relax_and_recompute,0.1,0,0,0,0.0,0.1137226649131174,15,14
888,relax_and_recompute,0.1,3,0,3,63.54493136121653,-0.176417172375687,23,26
889,relax_and_recompute,0.1,7,5,2,7.38528999272846,-0.1811156047103158,12,20
890,relax_and_recompute,0.1,330,193,137,-0.6158017682765902,-0.0282951404344561,64,122
891,relax_and_recompute,0.1,24,14,10,-0.9115300631300444,0.1207600962437794,58,71
892,relax_and_recompute,0.1,0,0,0,0.0,0.1034277243126554,20,19
893,relax_and_recompute,0.1,295,341,-46,3.569292556753993,0.3832994087683585,100,191
894,relax_and_recompute,0.1,29,44,-15,6.357265000624402,0.3116361604270775,41,61
895,relax_and_recompute,0.1,23,16,7,5.159902163459037,-0.0863401967431209,13,31
896,relax_and_recompute,0.1,6,3,3,-5.4135165554288704,0.0226445071985971,10,15
897,relax_and_recompute,0.1,11,9,2,-7.004929974974687,-0.0327247595865771,37,47
898,relax_and_recompute,0.1,4,1,3,-30.09782221461765,-0.0390605683749137,21,21
899,relax_and_recompute,0.1,0,0,0,0.0,-0.2146403377583192,11,10
900,relax_and_recompute,0.1,66,40,26,-2.170974973001698,0.1715718229891608,44,80
901,relax_and_recompute,0.1,3,2,1,7.525530122475857,0.2048685453110598,12,21
902,relax_and_recompute,0.1,1,4,-3,-5.63277432757566,-0.3481088715043071,37,43
903,relax_and_recompute,0.1,17,4,13,-10.890299900849485,0.09003628466892,41,52
904,relax_and_recompute,0.1,0,3,-3,-75.64285734859304,0.116528386543486,90,89
905,relax_and_recompute,0.1,0,0,0,0.0,-0.019469371051731,22,21
906,relax_and_recompute,0.1,3,0,3,51.98062753457352,0.0837200542033079,37,43
907,relax_and_recompute,0.1,3,0,3,73.89131292405209,0.0641901307812726,47,47
908,relax_and_recompute,0.1,10,4,6,-11.030589944929616,0.0732967833306891,12,20
909,relax_and_recompute,0.1,165,103,62,-1.6357465449089403,0.1077013867984113,84,124
910,relax_and_recompute,0.1,1,0,1,59.097183810233055,0.245619181249808,88,92
911,relax_and_recompute,0.1,440,276,164,-2.897617264101264,0.035705995837062,59,122
912,relax_and_recompute,0.1,3,2,1,-3.898257116861629,-0.0669067632574664,26,31
913,relax_and_recompute,0.1,0,0,0,0.0,-0.1281022966870754,28,27
914,relax_and_recompute,0.1,8,3,5,13.471517755196524,0.2882109531194179,18,26
915,relax_and_recompute,0.1,2,8,-6,13.48183999053407,-0.256801058493148,23,26
916,relax_and_recompute,0.1,1,0,1,83.17268974114887,0.2810771930726934,43,43
917,relax_and_recompute,0.1,5,1,4,35.83642009300677,-0.0563268630227701,22,26
918,relax_and_recompute,0.1,0,0,0,0.0,-0.0236263089309899,15,14
919,relax_and_recompute,0.1,20,8,12,-3.786150731284245,-0.0684712640945717,36,48
920,relax_and_recompute,0.1,7,9,-2,12.484331482350704,0.1564659440003486,30,37
921,relax_and_recompute,0.1,1,3,-2,-18.53052965864036,0.1868567170214099,10,13
922,relax_and_recompute,0.1,1,0,1,82.56923974375421,0.1086691301883994,12,11
923,relax_and_recompute,0.1,199,215,-16,-0.2020688867382958,-0.0084941573203747,55,105
924,relax_and_recompute,0.1,1,0,1,74.23200856265855,-0.2512899927021044,13,17
925,relax_and_recompute,0.1,0,0,0,0.0,0.2098617191096249,30,29
926,relax_and_recompute,0.1,4,7,-3,0.7188821447692888,0.1212498614861179,36,43
927,relax_and_recompute,0.1,17,18,-1,-0.783983304084046,0.1561720789823775,40,60
928,relax_and_recompute,0.1,1,2,-1,32.542801862788075,-0.2513228288940963,13,17
929,relax_and_recompute,0.1,6,11,-5,5.6158823226923005,-0.2202120888175291,23,30
930,relax_and_recompute,0.1,3,1,2,32.91646357526581,-0.0670857875509832,12,16
931,relax_and_recompute,0.1,1,0,1,86.46590274964198,0.4143919180926508,26,26
932,relax_and_recompute,0.1,0,1,-1,-88.67612164843109,-0.0762426678887808,22,31
933,relax_and_recompute,0.1,0,0,0,0.0,-0.0910603191581861,68,68
934,relax_and_recompute,0.1,0,0,0,0.0,-0.1167601463787835,23,22
935,relax_and_recompute,0.1,0,0,0,0.0,-0.2829264643863777,43,42
936,relax_and_recompute,0.1,0,0,0,0.0,-0.3716543407955019,18,17
937,relax_and_recompute,0.1,16,0,16,60.43299863182915,0.0789536759315123,28,42
938,relax_and_recompute,0.1,40,39,1,0.6136150290397921,0.1324688993604296,21,44
939,relax_and_recompute,0.1,0,2,-2,-85.69045473678477,-0.0524603120300836,36,37
940,relax_and_recompute,0.1,0,0,0,0.0,-0.0475782852949315,15,14
941,relax_and_recompute,0.1,0,0,0,0.0,-0.2462746378467821,14,16
942,relax_and_recompute,0.1,221,203,18,-1.609362195291034,-0.1098920061264128,61,119
943,relax_and_recompute,0.1,1,0,1,87.44756645716099,0.1436019200573088,19,20
944,relax_and_recompute,0.1,0,0,0,0.0,0.4018633882562272,22,22
945,relax_and_recompute,0.1,0,3,-3,-62.46989576116968,-0.0321643110807281,54,58
946,relax_and_recompute,0.1,470,429,41,-0.978228672929866,-0.1063971228486053,65,135
947,relax_and_recompute,0.1,0,1,-1,-74.26189346337111,0.200910700297229,16,18
948,relax_and_recompute,0.1,7,8,-1,-2.390392654556095,0.2199239283947883,17,27
949,relax_and_recompute,0.1,22,10,12,-4.63520799453142,0.1153663088059228,54,71
950,relax_and_recompute,0.1,2,0,2,81.21278460240785,0.2229220564225363,23,22
951,relax_and_recompute,0.1,1,1,0,-20.1632501150032,-0.3820552986265879,13,16
952,relax_and_recompute,0.1,125,146,-21,0.0879000013370827,0.1592013398385894,85,131
953,relax_and_recompute,0.1,36,31,5,-5.377566084453306,-0.0239407059109908,28,55
954,relax_and_recompute,0.1,1,6,-5,14.797927237895586,-0.0698452271945686,18,24
955,relax_and_recompute,0.1,4,0,4,78.36536606730934,0.0273619460634517,19,22
956,relax_and_recompute,0.1,0,0,0,0.0,0.1483454430942234,47,46
957,relax_and_recompute,0.1,45,32,13,-2.046590713398224,-0.2174585572050429,39,64
958,relax_and_recompute,0.1,1,0,1,72.12954182246419,0.0784589261368845,17,18
959,relax_and_recompute,0.1,1,1,0,-12.251573850445702,-0.0886216499637132,23,24
960,relax_and_recompute,0.1,1,1,0,-4.367372173593751,-0.1356198257593135,13,16
961,relax_and_recompute,0.1,15,16,-1,-3.403760365100389,-0.0382939510090896,40,56
962,relax_and_recompute,0.1,0,1,-1,-78.56112807071084,0.4326302142116213,10,15
963,relax_and_recompute,0.1,0,0,0,0.0,0.0430415567908201,21,20
964,relax_and_recompute,0.1,1,4,-3,-25.02467956076009,-0.2778746452379065,30,35
965,relax_and_recompute,0.1,4,6,-2,-5.894307747174672,0.1249177719572428,71,77
966,relax_one,0.1,0,0,0,0.0,0.2054813405140663,17,18
967,relax_one,0.1,6,7,-1,1.2706799167195155,0.2616520273152386,43,48
968,relax_one,0.1,10,4,6,-1.1497462829377838,0.0136811089562364,38,45
969,relax_one,0.1,1,0,1,56.85277851874744,-0.1983766100443005,12,12
970,relax_one,0.1,3,22,-19,1.467768307348578,-0.2617835642321859,23,38
971,relax_one,0.1,3,1,2,-0.5396704316484175,-0.1518774186791658,19,22
972,relax_one,0.1,805,795,10,-0.2393523545870906,0.2666566171916671,35,143
973,relax_one,0.1,6,2,4,-3.92009566774341,0.2104635072464185,92,91
974,relax_one,0.1,10,6,4,-12.631651075681605,-0.1252622528932492,43,51
975,relax_one,0.1,0,0,0,0.0,-0.0569362104976698,35,36
976,relax_one,0.1,1,0,1,88.02294762707568,-0.1580583474437675,11,13
977,relax_one,0.1,22,15,7,-1.711728558783932,-0.0252720484999612,10,25
978,relax_one,0.1,33,12,21,-2.8042682893888724,0.2468255242174512,86,136
979,relax_one,0.1,0,0,0,0.0,0.1770500130434565,10,12
980,relax_one,0.1,0,0,0,0.0,-0.003478387563653,32,31
981,relax_one,0.1,8,3,5,-10.79619735021204,0.0145291695984109,20,26
982,relax_one,0.1,0,0,0,0.0,0.4497794948479229,11,11
983,relax_one,0.1,16,5,11,-8.97549707693291,0.4327409916778754,34,42
984,relax_one,0.1,10,11,-1,3.094598608933268,0.2919613395867599,14,25
985,relax_one,0.1,8,7,1,13.41808835162746,-0.1076117512877278,31,46
986,relax_one,0.1,2,2,0,-17.963469967766216,-0.0377688028426987,42,45
987,relax_one,0.1,1053,1131,-78,-0.1384109878457309,-0.0126963716459672,39,173
988,relax_one,0.1,10,11,-1,-1.145998299545326,-0.2060985054431046,14,24
989,relax_one,0.1,0,3,-3,-72.34111632740684,0.2790651591028728,24,25
990,relax_one,0.1,1,1,0,58.88356029581961,-0.1749275364061753,12,19
991,relax_one,0.1,86,91,-5,4.291631375342575,-0.0648579610661308,41,72
992,relax_one,0.1,246,210,36,0.6742034877462473,0.065849330368604,59,115
993,relax_one,0.1,11,5,6,2.511084862667701,0.1391981820546362,32,37
994,relax_one,0.1,3,2,1,-1.5955945735195345,0.4419818472383058,20,20
995,relax_one,0.1,35,26,9,-10.816073558758411,-0.0412833773902485,12,31
996,relax_one,0.1,0,0,0,0.0,0.3220659433742033,10,10
997,relax_one,0.1,1,1,0,17.673043804801964,-0.2004013776020986,20,21
998,relax_one,0.1,33,13,20,-3.86507614990856,-0.1921949071221005,39,52
999,relax_one,0.1,366,312,54,-1.661255529044162,0.1662289925568502,42,109
1000,relax_one,0.1,2,4,-2,-2.7377833169010657,-0.0006811446085739,25,28
1001,relax_one,0.1,221,173,48,-1.596500127128934,0.0221334390294013,56,106
1002,relax_one,0.1,512,418,94,-0.119147283971678,-0.1965284217725087,87,189
1003,relax_one,0.1,30,43,-13,1.862550918389644,0.2360773203979478,56,82
1004,relax_one,0.1,1,0,1,88.11066381497666,0.1522005618577488,13,15
1005,relax_one,0.1,97,68,29,-0.3336878226620996,0.3206306548365681,36,63
1006,relax_one,0.1,0,0,0,0.0,-0.009670024125877,16,15
1007,relax_one,0.1,0,0,0,0.0,-0.5342779222453524,67,66
1008,relax_one,0.1,15,26,-11,-5.686812883085864,0.0572066393528689,42,60
1009,relax_one,0.1,0,0,0,0.0,0.0614203176312233,39,38
1010,relax_one,0.1,17,10,7,-12.129290550644605,-0.0989406283361674,20,36
1011,relax_one,0.1,0,0,0,0.0,0.0719577539353027,10,9
1012,relax_one,0.1,1,1,0,3.921835005005363,0.0520242273707911,13,15
1013,relax_one,0.1,17,10,7,3.8092228639221446,0.0516841038119587,34,41
1014,relax_one,0.1,4,4,0,8.631599128415345,0.1471561399032269,37,42
1015,relax_one,0.1,26,18,8,-1.3349796788487822,0.2625035798598765,18,29
1016,relax_one,0.1,0,0,0,0.0,0.3813438533932108,23,22
1017,relax_one,0.1,0,0,0,0.0,-0.0197125573155313,13,12
1018,relax_one,0.1,0,0,0,0.0,-0.3102376664364226,15,14
1019,relax_one,0.1,0,0,0,0.0,-0.1902883846763049,69,68
1020,relax_one,0.1,0,0,0,0.0,-0.2552274157705375,40,39
1021,relax_one,0.1,1,1,0,64.47920158097706,0.0667115424758666,89,93
1022,relax_one,0.1,12,12,0,-10.415056064500511,0.0213295104552736,20,32
1023,relax_one,0.1,2,2,0,7.319881618457764,-0.0066089796720514,69,83
1024,relax_one,0.1,1,0,1,70.0107710555098,0.0760347815931304,12,15
1025,relax_one,0.1,0,0,0,0.0,-0.231777876140695,15,14
1026,relax_one,0.1,2,0,2,72.66666045026179,-0.1730460201060187,23,26
1027,relax_one,0.1,2,5,-3,17.87823531637151,-0.2425823125429692,12,20
1028,relax_one,0.1,214,172,42,0.613711673133416,0.0250418297831226,64,122
1029,relax_one,0.1,28,4,24,-3.771871160379483,0.0468462849647617,58,71
1030,relax_one,0.1,0,0,0,0.0,0.182495698233109,20,19
1031,relax_one,0.1,368,277,91,-0.2578673491350898,0.1194941195876223,100,191
1032,relax_one,0.1,48,34,14,-8.658245432177075,-0.2855345210516996,41,61
1033,relax_one,0.1,19,15,4,-3.0903048069721706,-0.0736784962026991,13,31
1034,relax_one,0.1,3,2,1,9.453238162465157,0.3861260117918585,10,15
1035,relax_one,0.1,21,8,13,1.4453152120214554,-0.1749187679757354,37,47
1036,relax_one,0.1,0,1,-1,-79.7893342043663,-0.0433418688942832,21,21
1037,relax_one,0.1,0,0,0,0.0,-0.1520597298316552,11,10
1038,relax_one,0.1,61,57,4,1.1824989507440191,0.0450940507493744,44,80
1039,relax_one,0.1,2,7,-5,3.296128122767797,0.0957997642320014,12,21
1040,relax_one,0.1,4,1,3,-24.45907053436111,-0.4405961211311964,37,43
1041,relax_one,0.1,25,13,12,-9.82047868387965,-0.3648735420706867,41,52
1042,relax_one,0.1,1,0,1,77.69711569108718,0.1175886405109731,90,89
1043,relax_one,0.1,0,0,0,0.0,0.3223874571954844,22,21
1044,relax_one,0.1,2,0,2,82.92614033258252,0.3148023439567008,37,43
1045,relax_one,0.1,2,0,2,60.273848166140574,0.0870801660369207,47,47
1046,relax_one,0.1,4,5,-1,12.80857477731078,-0.130209207979373,12,20
1047,relax_one,0.1,130,109,21,2.973634546826446,0.012434089248589,84,124
1048,relax_one,0.1,9,1,8,51.816116819392754,0.2183804803709146,88,92
1049,relax_one,0.1,380,282,98,-1.810122811195768,0.273728460642457,59,122
1050,relax_one,0.1,7,6,1,23.648559969112817,0.3293402083558335,26,31
1051,relax_one,0.1,0,0,0,0.0,0.165303717515815,28,27
1052,relax_one,0.1,9,4,5,-6.544103304097881,0.3228480277718256,18,26
1053,relax_one,0.1,2,2,0,-5.771909156375983,-0.3586117771868305,23,26
1054,relax_one,0.1,2,1,1,-7.403130739020952,0.1209171055227738,43,43
1055,relax_one,0.1,1,2,-1,-21.722462593517434,-0.0715578598534416,22,26
1056,relax_one,0.1,0,0,0,0.0,-0.0169183905757056,15,14
1057,relax_one,0.1,17,15,2,-3.7864781909111898,-0.0169037410625791,36,48
1058,relax_one,0.1,6,7,-1,-5.333240969041981,0.1644240232581943,30,37
1059,relax_one,0.1,1,2,-1,-2.443339912604003,0.0856747387082765,10,13
1060,relax_one,0.1,0,1,-1,-79.37352880824972,0.3421397408765378,12,11
1061,relax_one,0.1,202,163,39,-1.203294875204563,-0.1834929286595074,55,105
1062,relax_one,0.1,4,3,1,21.08208758002545,0.2000076655107935,13,17
1063,relax_one,0.1,0,0,0,0.0,-0.095314789410302,30,29
1064,relax_one,0.1,10,1,9,-10.901858433883206,-0.0666336245926204,36,43
1065,relax_one,0.1,19,20,-1,9.98782792656334,0.1051256249360914,40,60
1066,relax_one,0.1,2,0,2,80.5719812213276,0.1916364743955864,13,17
1067,relax_one,0.1,7,5,2,2.60280114638428,0.1551499307375972,23,30
1068,relax_one,0.1,1,2,-1,13.13654299593452,-0.2728576730108936,12,16
1069,relax_one,0.1,1,0,1,81.1652504842246,-0.3158238344475494,26,26
1070,relax_one,0.1,2,2,0,17.052026951247896,0.4263062186606263,22,31
1071,relax_one,0.1,1,0,1,70.9764543382903,-0.0635482724661824,68,68
1072,relax_one,0.1,0,0,0,0.0,-0.0333817855733645,23,22
1073,relax_one,0.1,0,0,0,0.0,0.0038902510581187,43,42
1074,relax_one,0.1,1,0,1,83.19169521613627,-0.0261251872940777,18,17
1075,relax_one,0.1,17,3,14,-4.915806926146189,0.3148242844994757,28,42
1076,relax_one,0.1,40,41,-1,0.6042328422245618,0.191227060499298,21,44
1077,relax_one,0.1,0,2,-2,-84.24232629584708,0.0097293502133956,36,37
1078,relax_one,0.1,0,0,0,0.0,-0.2258747363015334,15,14
1079,relax_one,0.1,0,1,-1,-79.89717566722562,0.2102031689713556,14,16
1080,relax_one,0.1,256,237,19,1.0071580164555345,-0.0586655961272851,61,119
1081,relax_one,0.1,0,0,0,0.0,-0.0505828376596898,19,20
1082,relax_one,0.1,3,0,3,75.30990525661879,0.3832078472254074,22,22
1083,relax_one,0.1,3,1,2,16.723536973360908,-0.0177210920055508,54,58
1084,relax_one,0.1,458,456,2,-0.3101176066904827,-0.1135984423567416,65,135
1085,relax_one,0.1,1,3,-2,-34.5600083659846,0.0320084379430664,16,18
1086,relax_one,0.1,10,7,3,-1.936412831049374,0.0499912581508383,17,27
1087,relax_one,0.1,13,13,0,-3.550785029374808,0.1140860940505769,54,71
1088,relax_one,0.1,0,2,-2,-59.32592845099168,-0.208771418922628,23,22
1089,relax_one,0.1,1,0,1,85.58387390733266,-0.0985043820714118,13,16
1090,relax_one,0.1,115,145,-30,-0.1727864030732036,0.0672379369405835,85,131
1091,relax_one,0.1,36,32,4,0.7724334707120022,0.3726975737851837,28,55
1092,relax_one,0.1,2,2,0,18.14714997335215,-0.0337139612211552,18,24
1093,relax_one,0.1,2,1,1,-8.883125634240642,0.1356811458218647,19,22
1094,relax_one,0.1,4,1,3,-0.8269591814941322,-0.3415229447363842,47,46
1095,relax_one,0.1,49,23,26,0.8371707485146374,0.0104493397628151,39,64
1096,relax_one,0.1,1,1,0,24.555201043584688,0.3830544527691339,17,18
1097,relax_one,0.1,1,3,-2,4.146642012161152,-0.082483785589459,23,24
1098,relax_one,0.1,1,1,0,9.455802772667212,0.1331641283609929,13,16
1099,relax_one,0.1,46,12,34,12.575510030963729,-0.1845709802986221,40,56
1100,relax_one,0.1,2,1,1,20.78447126694715,-0.3792825723374731,10,15
1101,relax_one,0.1,0,0,0,0.0,-0.0350504765271082,21,20
1102,relax_one,0.1,5,3,2,3.517421966932446,0.0080754173812204,30,35
1103,relax_one,0.1,1,1,0,42.77290778934172,0.3100652725088121,71,77
1104,just_relax,0.1,1,2,-1,-12.45051620219786,-0.0846794200351399,17,18
1105,just_relax,0.1,10,10,0,7.105851366928015,0.0185123964910172,43,48
1106,just_relax,0.1,18,7,11,1.2838183845621105,0.2508235963918199,38,45
1107,just_relax,0.1,1,0,1,54.89261258087421,0.3113518096126495,12,12
1108,just_relax,0.1,10,13,-3,-3.8270776970122,-0.0448400514894345,23,38
1109,just_relax,0.1,0,0,0,0.0,0.0495497642324181,19,22
1110,just_relax,0.1,787,855,-68,-0.1449803035399242,-0.1680296452256874,35,143
1111,just_relax,0.1,2,7,-5,16.366446952876316,0.1797777267232144,92,91
1112,just_relax,0.1,10,31,-21,17.155888320747287,0.0468561967996445,43,51
1113,just_relax,0.1,1,0,1,80.05695386935673,0.1433373913770426,35,36
1114,just_relax,0.1,1,0,1,87.49272386061996,0.2687024857172481,11,13
1115,just_relax,0.1,22,19,3,-0.6417680741897414,0.2744118893418811,10,25
1116,just_relax,0.1,42,34,8,5.420874006217275,-0.3256377377435532,86,136
1117,just_relax,0.1,1,0,1,70.82548987747788,0.0591523058319602,10,12
1118,just_relax,0.1,0,0,0,0.0,-0.0853248783573696,32,31
1119,just_relax,0.1,3,5,-2,0.3175773027003856,0.0250070286701648,20,26
1120,just_relax,0.1,0,3,-3,-86.76698663685532,-0.3463113120243436,11,11
1121,just_relax,0.1,2,11,-9,4.556763718479765,0.0754010642012955,34,42
1122,just_relax,0.1,16,14,2,20.70318769846439,-0.1684328298043059,14,25
1123,just_relax,0.1,5,19,-14,9.408934120335305,-0.0519835036277577,31,46
1124,just_relax,0.1,0,9,-9,-65.98956313897378,-0.3198134758817018,42,45
1125,just_relax,0.1,1086,1149,-63,-0.4322019350325163,-0.1393586454815816,39,173
1126,just_relax,0.1,11,10,1,9.209195090796072,-0.0009656853900693,14,24
1127,just_relax,0.1,0,2,-2,-75.13643169238102,-0.243067316847013,24,25
1128,just_relax,0.1,1,1,0,17.30383270914531,0.0508678383474153,12,19
1129,just_relax,0.1,94,69,25,1.1697394179152738,-0.0023521458143301,41,72
1130,just_relax,0.1,274,200,74,2.8914042470712573,0.4519078960643545,59,115
1131,just_relax,0.1,5,12,-7,0.3249692821832894,0.0032446428801397,32,37
1132,just_relax,0.1,0,0,0,0.0,0.0466262203740622,20,20
1133,just_relax,0.1,27,25,2,-9.499776574151142,-0.1241887200462814,12,31
1134,just_relax,0.1,1,1,0,14.113200045707927,-0.1395504314535869,10,10
1135,just_relax,0.1,3,0,3,69.77468873275718,-0.0326490527672743,20,21
1136,just_relax,0.1,17,34,-17,15.542052647061098,0.1425238641004135,39,52
1137,just_relax,0.1,349,355,-6,4.672500862049013,-0.1012823503818317,42,109
1138,just_relax,0.1,3,1,2,-19.257023984400504,0.1050300684214855,25,28
1139,just_relax,0.1,261,260,1,1.5502815841615387,-0.0266881436744643,56,106
1140,just_relax,0.1,473,730,-257,11.49863287567974,-0.3355350948628396,87,189
1141,just_relax,0.1,57,41,16,6.240340693416378,-0.229247671170606,56,82
1142,just_relax,0.1,1,1,0,-11.907214505033451,-0.2835026335326778,13,15
1143,just_relax,0.1,99,127,-28,2.9391882668993574,0.0390794995631945,36,63
1144,just_relax,0.1,0,0,0,0.0,0.0969342939353793,16,15
1145,just_relax,0.1,0,0,0,0.0,-0.3494818357921551,67,66
1146,just_relax,0.1,12,14,-2,6.703246680819696,-0.104885284971091,42,60
1147,just_relax,0.1,1,5,-4,13.9491896254206,-0.2283331535772537,39,38
1148,just_relax,0.1,18,10,8,-4.703094481093274,0.0084282749850053,20,36
1149,just_relax,0.1,0,0,0,0.0,-0.3758296927887351,10,9
1150,just_relax,0.1,1,1,0,27.470054542821515,0.0823282500354238,13,15
1151,just_relax,0.1,14,7,7,3.7212511829243056,-0.0010031400012523,34,41
1152,just_relax,0.1,2,5,-3,4.457771095686439,0.2247896521721375,37,42
1153,just_relax,0.1,33,19,14,2.5305618586096728,-0.4548136806776495,18,29
1154,just_relax,0.1,0,0,0,0.0,-0.1883185376634166,23,22
1155,just_relax,0.1,0,0,0,0.0,0.0332571801104344,13,12
1156,just_relax,0.1,0,0,0,0.0,-0.0301269388012034,15,14
1157,just_relax,0.1,0,3,-3,-63.75353760341792,0.0395061009179869,69,68
1158,just_relax,0.1,1,0,1,63.85950093859702,0.2457786551501621,40,39
1159,just_relax,0.1,2,1,1,-10.529944181317646,-0.1310571700004512,89,93
1160,just_relax,0.1,9,17,-8,0.2443043941593714,-0.1356580419074873,20,32
1161,just_relax,0.1,4,4,0,-5.573015809626085,0.3141059096677309,69,83
1162,just_relax,0.1,1,0,1,78.82323282898327,0.424671123681071,12,15
1163,just_relax,0.1,0,0,0,0.0,0.1881060793518904,15,14
1164,just_relax,0.1,0,0,0,0.0,-0.0671527803651905,23,26
1165,just_relax,0.1,3,3,0,-2.42074531056808,-0.2125722482624001,12,20
1166,just_relax,0.1,191,244,-53,0.2563514642841795,0.1265328751935066,64,122
1167,just_relax,0.1,16,7,9,17.505198258006892,-0.031037490482039,58,71
1168,just_relax,0.1,0,0,0,0.0,-0.2579272010407345,20,19
1169,just_relax,0.1,512,387,125,0.2896117069016668,-0.0809177777611939,100,191
1170,just_relax,0.1,50,48,2,4.934341483914814,0.1834133802325397,41,61
1171,just_relax,0.1,25,46,-21,7.553023852553125,0.0259523190238558,13,31
1172,just_relax,0.1,5,3,2,-5.342131569935717,0.1058402130330331,10,15
1173,just_relax,0.1,12,5,7,-1.838031587536648,-0.0190145121721105,37,47
1174,just_relax,0.1,1,0,1,81.52463838951455,-0.2265430091351733,21,21
1175,just_relax,0.1,0,0,0,0.0,0.1276398434767073,11,10
1176,just_relax,0.1,69,33,36,-4.590376312645262,0.4285664519426121,44,80
1177,just_relax,0.1,7,2,5,-5.822886165195868,-0.2969365726001272,12,21
1178,just_relax,0.1,11,0,11,60.691411911845,0.2069982482830601,37,43
1179,just_relax,0.1,21,10,11,5.951714074747848,0.0337662974545796,41,52
1180,just_relax,0.1,2,3,-1,3.519814448608188,-0.1660840767744299,90,89
1181,just_relax,0.1,0,0,0,0.0,-0.1669414038527827,22,21
1182,just_relax,0.1,2,4,-2,4.925373406731488,0.1409374013468675,37,43
1183,just_relax,0.1,6,2,4,38.29750676594681,-0.051003245796671,47,47
1184,just_relax,0.1,4,4,0,-3.9202410358265496,-0.1551627041975345,12,20
1185,just_relax,0.1,135,167,-32,3.1444362485478337,-0.2162640103586059,84,124
1186,just_relax,0.1,1,1,0,-30.55691462149648,-0.2287886661611172,88,92
1187,just_relax,0.1,390,337,53,-0.3167640091654178,-0.0006927719590397,59,122
1188,just_relax,0.1,2,5,-3,-3.738180969812007,0.3398308252660138,26,31
1189,just_relax,0.1,0,0,0,0.0,-0.111598718132906,28,27
1190,just_relax,0.1,3,3,0,1.9694683917417424,-0.1530769646231047,18,26
1191,just_relax,0.1,1,1,0,1.8545249541217004,-0.1242803409940821,23,26
1192,just_relax,0.1,3,0,3,85.4022927346569,0.046081935960515,43,43
1193,just_relax,0.1,6,1,5,-4.756191617942761,-0.2507031767052162,22,26
1194,just_relax,0.1,0,0,0,0.0,0.1716713400273165,15,14
1195,just_relax,0.1,18,19,-1,-2.8327245537475534,-0.0547969100972772,36,48
1196,just_relax,0.1,9,8,1,5.541543354233099,-0.0177730230195317,30,37
1197,just_relax,0.1,7,1,6,-14.915710982502006,-0.1466137723750687,10,13
1198,just_relax,0.1,0,1,-1,-89.99820012020999,0.2766268105725454,12,11
1199,just_relax,0.1,227,177,50,4.534797421363898,0.2510247437279602,55,105
1200,just_relax,0.1,4,5,-1,19.78089271113969,-0.1433514597346977,13,17
1201,just_relax,0.1,0,11,-11,-69.75224330743644,0.0449709170045387,30,29
1202,just_relax,0.1,3,4,-1,31.69244177571893,0.0247154498782641,36,43
1203,just_relax,0.1,12,26,-14,11.911339103503671,0.3232691997206031,40,60
1204,just_relax,0.1,1,0,1,80.0886581203098,-0.2675162180511141,13,17
1205,just_relax,0.1,14,8,6,-14.391836263353134,0.2625764841558877,23,30
1206,just_relax,0.1,1,6,-5,-22.48533672058298,0.1344125069182988,12,16
1207,just_relax,0.1,4,4,0,-3.494331431383891,-0.1488684812150997,26,26
1208,just_relax,0.1,0,1,-1,-55.98036114430504,0.0024650623563132,22,31
1209,just_relax,0.1,3,0,3,72.19124670171202,-0.069595544206451,68,68
1210,just_relax,0.1,0,0,0,0.0,0.141810022895504,23,22
1211,just_relax,0.1,0,3,-3,-63.37328848071854,0.1166126944597033,43,42
1212,just_relax,0.1,3,0,3,61.78174663202154,0.2588599329146307,18,17
1213,just_relax,0.1,9,28,-19,3.692459921606997,-0.0348101629626314,28,42
1214,just_relax,0.1,55,48,7,1.4791719349367582,0.1670435482398961,21,44
1215,just_relax,0.1,0,6,-6,-56.892608172378665,-0.2263942670554941,36,37
1216,just_relax,0.1,0,0,0,0.0,-0.0843270509853101,15,14
1217,just_relax,0.1,1,0,1,23.43531405379761,0.394163682397685,14,16
1218,just_relax,0.1,298,294,4,3.4195882378341693,0.0736812027395545,61,119
1219,just_relax,0.1,4,0,4,75.06059859799257,-0.322158158834404,19,20
1220,just_relax,0.1,0,0,0,0.0,-0.2268910679070569,22,22
1221,just_relax,0.1,0,19,-19,-53.01736167382433,-0.0953613306804175,54,58
1222,just_relax,0.1,456,763,-307,4.558483566400547,-0.0417560815172755,65,135
1223,just_relax,0.1,1,0,1,48.14405778960048,-0.0886428541227429,16,18
1224,just_relax,0.1,6,5,1,8.678616457259238,0.2903832445627241,17,27
1225,just_relax,0.1,6,28,-22,7.835573360870036,0.1882449619294899,54,71
1226,just_relax,0.1,3,0,3,53.11988147332169,0.1185284064618603,23,22
1227,just_relax,0.1,2,2,0,29.48438544769388,0.3278784057913479,13,16
1228,just_relax,0.1,149,236,-87,-1.5383229676911867,-0.0551276268139734,85,131
1229,just_relax,0.1,59,34,25,-3.5780274611439395,-0.1369459342966373,28,55
1230,just_relax,0.1,11,10,1,-7.307686722064155,-0.1333565414681241,18,24
1231,just_relax,0.1,1,1,0,1.4084878781825552,0.21622611200128,19,22
1232,just_relax,0.1,0,2,-2,-82.11785516778662,0.2082563618673841,47,46
1233,just_relax,0.1,41,38,3,4.233742716115309,-0.1913369315511394,39,64
1234,just_relax,0.1,0,0,0,0.0,0.0251847147553253,17,18
1235,just_relax,0.1,2,2,0,1.3148901198075436,-0.213286368132174,23,24
1236,just_relax,0.1,2,1,1,-7.482049510695894,-0.0852285858683755,13,16
1237,just_relax,0.1,20,44,-24,0.3048801439290542,0.0763101418049522,40,56
1238,just_relax,0.1,2,0,2,87.65484550912558,-0.0922279045790394,10,15
1239,just_relax,0.1,0,0,0,0.0,-0.1967895223216922,21,20
1240,just_relax,0.1,2,1,1,29.32614163206435,0.2589389754185764,30,35
1241,just_relax,0.1,1,2,-1,-5.914187841564228,-0.5986200551490333,71,77
1242,relax_and_recompute,0.15,0,2,-2,-69.78018506816971,-0.0601365273628556,17,18
1243,relax_and_recompute,0.15,9,9,0,19.661709546152338,-0.3424672377036608,43,48
1244,relax_and_recompute,0.15,2,3,-1,17.155817206824423,-0.100959841681483,38,45
1245,relax_and_recompute,0.15,0,0,0,0.0,0.2430258307545403,12,12
1246,relax_and_recompute,0.15,31,9,22,-10.260054848978015,0.169909563004555,23,38
1247,relax_and_recompute,0.15,1,1,0,2.497970713120921,0.0137875417287429,19,22
1248,relax_and_recompute,0.15,711,800,-89,0.8198756813716344,0.2372726980156319,35,143
1249,relax_and_recompute,0.15,1,1,0,0.1965325210997122,0.0102956265221717,92,91
1250,relax_and_recompute,0.15,3,2,1,3.386567442020869,-0.1560766746519141,43,51
1251,relax_and_recompute,0.15,0,1,-1,-66.02383228755987,0.0548725519407181,35,36
1252,relax_and_recompute,0.15,0,0,0,0.0,0.347169806705529,11,13
1253,relax_and_recompute,0.15,20,16,4,-4.232836886828061,-0.0271489188495398,10,25
1254,relax_and_recompute,0.15,25,22,3,8.059617099297277,-0.043093380020149,86,136
1255,relax_and_recompute,0.15,0,0,0,0.0,0.6734755990419641,10,12
1256,relax_and_recompute,0.15,0,0,0,0.0,0.0279262190837322,32,31
1257,relax_and_recompute,0.15,5,3,2,7.840963312235608,-0.2118344954395361,20,26
1258,relax_and_recompute,0.15,0,0,0,0.0,-0.4357408291313635,11,11
1259,relax_and_recompute,0.15,4,3,1,-6.550720367142802,0.0122206412334017,34,42
1260,relax_and_recompute,0.15,16,15,1,-4.91306475271368,0.2407776293610939,14,25
1261,relax_and_recompute,0.15,16,7,9,-0.4854396335119233,0.0631671334494827,31,46
1262,relax_and_recompute,0.15,4,1,3,-5.160931701627263,0.1130990525564716,42,45
1263,relax_and_recompute,0.15,1076,1080,-4,-0.567691818832941,-0.1624782531228333,39,173
1264,relax_and_recompute,0.15,8,11,-3,5.19608796277744,0.1316975466494099,14,24
1265,relax_and_recompute,0.15,0,1,-1,-68.31652324275989,-0.0815104296461901,24,25
1266,relax_and_recompute,0.15,0,1,-1,-77.61053406717247,-0.0891014049431014,12,19
1267,relax_and_recompute,0.15,88,59,29,-1.583033789520094,-0.1215196048447725,41,72
1268,relax_and_recompute,0.15,193,162,31,0.1792132374682395,-0.0775715912041751,59,115
1269,relax_and_recompute,0.15,3,7,-4,-13.781633701179594,-0.1379754182752857,32,37
1270,relax_and_recompute,0.15,1,0,1,78.97995267091277,0.1654009734642295,20,20
1271,relax_and_recompute,0.15,30,28,2,-6.186070510842377,-0.0543993341334947,12,31
1272,relax_and_recompute,0.15,0,0,0,0.0,0.4007896076135666,10,10
1273,relax_and_recompute,0.15,0,0,0,0.0,-0.0193637645538079,20,21
1274,relax_and_recompute,0.15,23,26,-3,-2.740335271290533,0.0052319541846941,39,52
1275,relax_and_recompute,0.15,357,314,43,0.1055266877192977,0.1948611288585418,42,109
1276,relax_and_recompute,0.15,7,0,7,70.25504254381697,0.2984435001459637,25,28
1277,relax_and_recompute,0.15,205,177,28,1.5459882525910729,-0.1520890996901487,56,106
1278,relax_and_recompute,0.15,516,430,86,-1.1602997549638516,-0.3058811205995652,87,189
1279,relax_and_recompute,0.15,56,53,3,-0.7068196669607545,-0.0115435618822484,56,82
1280,relax_and_recompute,0.15,3,1,2,-18.74026924446992,-0.0967848447516981,13,15
1281,relax_and_recompute,0.15,120,69,51,-3.689238441977629,-0.1560662487091738,36,63
1282,relax_and_recompute,0.15,2,0,2,67.50468431002648,-0.1273497804650678,16,15
1283,relax_and_recompute,0.15,0,0,0,0.0,0.257408767299892,67,66
1284,relax_and_recompute,0.15,23,9,14,-4.735791810399078,0.1190529800251362,42,60
1285,relax_and_recompute,0.15,2,0,2,83.84005438079834,0.0581824206555401,39,38
1286,relax_and_recompute,0.15,13,12,1,6.470197265494932,0.4107915826665004,20,36
1287,relax_and_recompute,0.15,0,0,0,0.0,0.3707768553956843,10,9
1288,relax_and_recompute,0.15,1,0,1,86.84452360278168,0.0302200474707788,13,15
1289,relax_and_recompute,0.15,4,12,-8,-1.8490310288171368,-0.0279149379465598,34,41
1290,relax_and_recompute,0.15,5,4,1,30.337814815083952,0.2024646636206534,37,42
1291,relax_and_recompute,0.15,25,24,1,-2.1562937669414595,-0.0487016064725134,18,29
1292,relax_and_recompute,0.15,0,0,0,0.0,-0.0414166589908353,23,22
1293,relax_and_recompute,0.15,0,0,0,0.0,0.3406137915239446,13,12
1294,relax_and_recompute,0.15,0,0,0,0.0,-0.5283334782126756,15,14
1295,relax_and_recompute,0.15,0,0,0,0.0,0.2491516878446642,69,68
1296,relax_and_recompute,0.15,0,0,0,0.0,0.0146318793260719,40,39
1297,relax_and_recompute,0.15,3,0,3,50.19918939252195,0.188141028854372,89,93
1298,relax_and_recompute,0.15,9,8,1,-15.72056759091886,-0.0355275004926703,20,32
1299,relax_and_recompute,0.15,2,4,-2,-22.308973155432057,0.0127693812022505,69,83
1300,relax_and_recompute,0.15,2,2,0,-24.96089554814391,-0.0295554648678487,12,15
1301,relax_and_recompute,0.15,0,0,0,0.0,0.2389934357871516,15,14
1302,relax_and_recompute,0.15,4,1,3,3.784699505149973,0.0079710042549107,23,26
1303,relax_and_recompute,0.15,2,5,-3,17.289244367082063,-0.0535480023949783,12,20
1304,relax_and_recompute,0.15,196,174,22,2.037625001498114,0.2650144907599832,64,122
1305,relax_and_recompute,0.15,34,3,31,-14.828293707370976,0.3136013139790892,58,71
1306,relax_and_recompute,0.15,0,0,0,0.0,0.3722946859547853,20,19
1307,relax_and_recompute,0.15,319,283,36,-2.3134046695736004,0.1277362690520803,100,191
1308,relax_and_recompute,0.15,81,33,48,0.3276760317831346,-0.0864079220697053,41,61
1309,relax_and_recompute,0.15,19,21,-2,3.71591354983903,0.0743043580094472,13,31
1310,relax_and_recompute,0.15,3,3,0,15.57895650759059,0.2865751454762462,10,15
1311,relax_and_recompute,0.15,9,9,0,-9.4079027114024,0.2283671785437068,37,47
1312,relax_and_recompute,0.15,0,0,0,0.0,0.0977322229471676,21,21
1313,relax_and_recompute,0.15,0,0,0,0.0,-0.213473299797239,11,10
1314,relax_and_recompute,0.15,67,45,22,-1.1991395100152005,-0.0620849039060121,44,80
1315,relax_and_recompute,0.15,3,3,0,6.855374033363944,0.0458370461753276,12,21
1316,relax_and_recompute,0.15,2,3,-1,20.826304838382868,0.0812082366161713,37,43
1317,relax_and_recompute,0.15,17,10,7,4.419989113577671,0.176617321126714,41,52
1318,relax_and_recompute,0.15,0,0,0,0.0,-0.1682618281717197,90,89
1319,relax_and_recompute,0.15,0,0,0,0.0,0.0564989590916767,22,21
1320,relax_and_recompute,0.15,1,1,0,1.7761575649891057,0.04214577193551,37,43
1321,relax_and_recompute,0.15,1,2,-1,2.8571364367939367,-0.0301229061995389,47,47
1322,relax_and_recompute,0.15,4,6,-2,4.145765706265834,-0.2012504357917808,12,20
1323,relax_and_recompute,0.15,117,111,6,-1.6450050187696732,0.1457297196516439,84,124
1324,relax_and_recompute,0.15,0,8,-8,-59.19713535146245,0.6432024926035562,88,92
1325,relax_and_recompute,0.15,297,403,-106,4.143545274536486,-0.1112834793612991,59,122
1326,relax_and_recompute,0.15,5,4,1,7.319072527325495,0.2294396141623681,26,31
1327,relax_and_recompute,0.15,0,0,0,0.0,0.1694234898405732,28,27
1328,relax_and_recompute,0.15,1,3,-2,-34.22213734886567,0.1829543701110519,18,26
1329,relax_and_recompute,0.15,1,4,-3,7.29104816395774,-0.1464618972146857,23,26
1330,relax_and_recompute,0.15,1,3,-2,24.07080631183983,-0.0136835179871713,43,43
1331,relax_and_recompute,0.15,2,2,0,10.35240204264376,-0.241705405816646,22,26
1332,relax_and_recompute,0.15,0,0,0,0.0,-0.0577701135867334,15,14
1333,relax_and_recompute,0.15,22,10,12,-1.89360132906856,0.1877946206884025,36,48
1334,relax_and_recompute,0.15,3,5,-2,3.3165157837515267,-0.011403659795231,30,37
1335,relax_and_recompute,0.15,2,1,1,5.302820806387302,-0.2397119321084748,10,13
1336,relax_and_recompute,0.15,1,0,1,85.65995204414997,0.3871171836193312,12,11
1337,relax_and_recompute,0.15,197,161,36,-3.232853719579758,-0.1449536995277509,55,105
1338,relax_and_recompute,0.15,1,1,0,7.263140739227566,0.3624839875094188,13,17
1339,relax_and_recompute,0.15,0,0,0,0.0,0.0232729246302482,30,29
1340,relax_and_recompute,0.15,6,11,-5,4.393598173466145,0.3024028005046055,36,43
1341,relax_and_recompute,0.15,46,20,26,-4.086282639909491,-0.2724535214320646,40,60
1342,relax_and_recompute,0.15,1,0,1,69.85083217796951,-0.0928199018658776,13,17
1343,relax_and_recompute,0.15,16,7,9,-0.197114454196992,0.124161479053671,23,30
1344,relax_and_recompute,0.15,3,1,2,45.4879137424401,0.089396652738276,12,16
1345,relax_and_recompute,0.15,3,0,3,68.93531698953383,-0.145480219297743,26,26
1346,relax_and_recompute,0.15,6,1,5,-0.1282106716870501,0.2676250401125559,22,31
1347,relax_and_recompute,0.15,0,1,-1,-67.66421076246007,-0.0150856647140613,68,68
1348,relax_and_recompute,0.15,0,0,0,0.0,-0.0047905248095139,23,22
1349,relax_and_recompute,0.15,0,0,0,0.0,-0.2319201509979628,43,42
1350,relax_and_recompute,0.15,0,0,0,0.0,-0.094380796221359,18,17
1351,relax_and_recompute,0.15,5,5,0,13.62472245604998,-0.1655721158951699,28,42
1352,relax_and_recompute,0.15,49,38,11,0.1417737680022952,0.0935300823435081,21,44
1353,relax_and_recompute,0.15,0,3,-3,-77.32592733837213,0.3371415822083154,36,37
1354,relax_and_recompute,0.15,0,0,0,0.0,-0.1391927454795206,15,14
1355,relax_and_recompute,0.15,2,0,2,73.92960173858442,0.0022889971643428,14,16
1356,relax_and_recompute,0.15,277,189,88,0.1214357437018449,-0.1290226641198244,61,119
1357,relax_and_recompute,0.15,0,0,0,0.0,0.1255380522351906,19,20
1358,relax_and_recompute,0.15,1,0,1,51.9422535110223,-0.0528796877947574,22,22
1359,relax_and_recompute,0.15,3,3,0,-1.848122483883316,-0.2322651398197123,54,58
1360,relax_and_recompute,0.15,457,505,-48,0.9662835338669212,-0.009788392969247,65,135
1361,relax_and_recompute,0.15,1,1,0,5.975249993790527,0.2738342215121987,16,18
1362,relax_and_recompute,0.15,10,15,-5,7.089341508142169,-0.1535758501824257,17,27
1363,relax_and_recompute,0.15,27,16,11,1.5795579459791895,0.3321774643003676,54,71
1364,relax_and_recompute,0.15,2,0,2,77.05683427114622,0.0950657271177175,23,22
1365,relax_and_recompute,0.15,2,1,1,-15.728527665028096,0.3025491755329552,13,16
1366,relax_and_recompute,0.15,137,141,-4,6.439315204728032,-0.4233442681133108,85,131
1367,relax_and_recompute,0.15,49,36,13,-4.546219812576148,0.1752421072655441,28,55
1368,relax_and_recompute,0.15,12,3,9,28.486131437076104,-0.0376406020734541,18,24
1369,relax_and_recompute,0.15,1,2,-1,37.54486288529687,-0.0002752814221196,19,22
1370,relax_and_recompute,0.15,0,1,-1,-88.87695706721269,-0.2065350427824223,47,46
1371,relax_and_recompute,0.15,49,47,2,-0.0891039436852878,-0.0455541768688261,39,64
1372,relax_and_recompute,0.15,5,0,5,64.16111635470473,-0.0222140194324279,17,18
1373,relax_and_recompute,0.15,2,1,1,5.763200912821858,-0.0763184882237292,23,24
1374,relax_and_recompute,0.15,0,1,-1,-56.431085288558805,-0.0290298424557374,13,16
1375,relax_and_recompute,0.15,18,23,-5,3.257070237925774,-0.2623480676197167,40,56
1376,relax_and_recompute,0.15,1,1,0,-29.26642125239038,0.2789638960649565,10,15
1377,relax_and_recompute,0.15,0,0,0,0.0,0.5549991398646454,21,20
1378,relax_and_recompute,0.15,1,2,-1,12.256527077330633,-0.3023218324782196,30,35
1379,relax_and_recompute,0.15,6,4,2,0.9195708372852848,0.2006043445645223,71,77
1380,relax_one,0.15,1,1,0,28.354140249870326,0.2491161146164298,17,18
1381,relax_one,0.15,6,11,-5,24.701475495829712,0.1356242247824262,43,48
1382,relax_one,0.15,9,5,4,-24.21360088390682,-0.0435084897451217,38,45
1383,relax_one,0.15,0,0,0,0.0,0.6142392667323457,12,12
1384,relax_one,0.15,20,10,10,-4.0163054675887935,-0.344734661998317,23,38
1385,relax_one,0.15,0,2,-2,-64.72726046385118,-0.2236249163540945,19,22
1386,relax_one,0.15,886,766,120,0.6886472076738812,-0.0455670293839636,35,143
1387,relax_one,0.15,6,0,6,62.52815219342691,0.1324820925902106,92,91
1388,relax_one,0.15,11,6,5,-0.9336924075185492,0.1463914204989075,43,51
1389,relax_one,0.15,4,1,3,9.065723513004215,0.1482697458604293,35,36
1390,relax_one,0.15,1,0,1,81.49466355676596,0.0657110843806795,11,13
1391,relax_one,0.15,20,20,0,5.636700827737968,0.0873624886177307,10,25
1392,relax_one,0.15,36,35,1,5.675564447678184,-0.1077077197795226,86,136
1393,relax_one,0.15,0,0,0,0.0,-0.022199730738622,10,12
1394,relax_one,0.15,0,0,0,0.0,-0.0112746610910606,32,31
1395,relax_one,0.15,2,16,-14,-6.897755823984866,-0.1096316337341314,20,26
1396,relax_one,0.15,2,1,1,-5.9713378511914215,0.1554900830649294,11,11
1397,relax_one,0.15,3,4,-1,31.155445588943323,-0.1929640893420442,34,42
1398,relax_one,0.15,10,13,-3,-0.1609223495604794,-0.029913418134591,14,25
1399,relax_one,0.15,7,10,-3,1.5153503009663751,0.1106996402361247,31,46
1400,relax_one,0.15,0,1,-1,-71.38823094115052,-0.294768857641703,42,45
1401,relax_one,0.15,1039,1075,-36,0.075936943012465,0.1182469262698812,39,173
1402,relax_one,0.15,9,10,-1,-5.479297857155132,-0.4846039488405783,14,24
1403,relax_one,0.15,0,0,0,0.0,0.1008169567927272,24,25
1404,relax_one,0.15,1,1,0,-15.356241641443988,0.2874731483816211,12,19
1405,relax_one,0.15,72,60,12,2.198451113246051,-0.0480899987953449,41,72
1406,relax_one,0.15,209,200,9,0.2521141407520701,-0.134471832556386,59,115
1407,relax_one,0.15,6,8,-2,4.328200432438052,-0.1780318297856533,32,37
1408,relax_one,0.15,0,0,0,0.0,0.2927115420899729,20,20
1409,relax_one,0.15,33,28,5,3.762741289126964,0.0216784574614371,12,31
1410,relax_one,0.15,0,0,0,0.0,-0.0702890730540146,10,10
1411,relax_one,0.15,2,2,0,-3.6957355264300418,-0.0834611728035371,20,21
1412,relax_one,0.15,19,12,7,-12.13188579149412,-0.266056422380036,39,52
1413,relax_one,0.15,361,406,-45,-1.1652363347996442,-0.1112058772561628,42,109
1414,relax_one,0.15,1,1,0,11.52127414800647,-0.2091609820635634,25,28
1415,relax_one,0.15,195,194,1,-0.6033600356980813,0.1233564256547341,56,106
1416,relax_one,0.15,487,432,55,2.392647994986234,-0.0686103257399403,87,189
1417,relax_one,0.15,37,28,9,2.26077191953582,-0.0896082671051035,56,82
1418,relax_one,0.15,1,0,1,83.3159181387368,-0.2716809606057213,13,15
1419,relax_one,0.15,82,68,14,-4.26407660682527,0.0508245385482165,36,63
1420,relax_one,0.15,1,0,1,77.66792434758788,-0.0878463670864626,16,15
1421,relax_one,0.15,0,0,0,0.0,-0.3622496381964992,67,66
1422,relax_one,0.15,24,21,3,5.867342772315801,-0.3788205553017377,42,60
1423,relax_one,0.15,0,0,0,0.0,-0.2473383521248069,39,38
1424,relax_one,0.15,9,9,0,1.5993293424630082,-0.1258431732685303,20,36
1425,relax_one,0.15,0,0,0,0.0,-0.0890961317491941,10,9
1426,relax_one,0.15,0,0,0,0.0,0.0355602422890172,13,15
1427,relax_one,0.15,15,4,11,-13.094124904801085,0.0092111031062582,34,41
1428,relax_one,0.15,6,4,2,13.455057921395074,-0.0423566119266877,37,42
1429,relax_one,0.15,34,25,9,1.4478742658512544,0.1096620487081254,18,29
1430,relax_one,0.15,2,0,2,56.54114358130791,0.108058864760971,23,22
1431,relax_one,0.15,0,0,0,0.0,0.262596187164733,13,12
1432,relax_one,0.15,0,0,0,0.0,0.2498745043489388,15,14
1433,relax_one,0.15,7,0,7,69.52060328643122,0.2675236414676206,69,68
1434,relax_one,0.15,2,0,2,72.45393748418351,0.3098476704379268,40,39
1435,relax_one,0.15,8,1,7,-19.03346854675512,-0.3560757341279108,89,93
1436,relax_one,0.15,19,7,12,5.618958900984097,0.0488900205157397,20,32
1437,relax_one,0.15,1,8,-7,20.61862862356287,0.0545355715006603,69,83
1438,relax_one,0.15,3,3,0,-15.34913620564948,0.0189593902090875,12,15
1439,relax_one,0.15,0,0,0,0.0,-0.1517241208033147,15,14
1440,relax_one,0.15,0,9,-9,-66.51471878352328,0.0259375663276267,23,26
1441,relax_one,0.15,2,2,0,0.5318291783166842,0.2159742390160531,12,20
1442,relax_one,0.15,235,184,51,-4.905951333370048,0.1436407144116325,64,122
1443,relax_one,0.15,13,8,5,-1.4695901567745937,-0.1298213029315428,58,71
1444,relax_one,0.15,0,0,0,0.0,-0.0216417499158818,20,19
1445,relax_one,0.15,280,268,12,-0.1618149342913568,-0.1238508028418613,100,191
1446,relax_one,0.15,28,24,4,0.8837836483748021,0.0356283129482203,41,61
1447,relax_one,0.15,23,21,2,2.3976431059764423,0.0638606909842048,13,31
1448,relax_one,0.15,6,3,3,-2.2261346348019515,-0.2895730301969719,10,15
1449,relax_one,0.15,35,9,26,-12.833317137750818,0.2297650117180855,37,47
1450,relax_one,0.15,0,1,-1,-82.27001597990396,-0.2844819534779889,21,21
1451,relax_one,0.15,1,1,0,7.807334384582717,0.143299621683394,11,10
1452,relax_one,0.15,78,40,38,-1.846833276200499,-0.1272082134896758,44,80
1453,relax_one,0.15,5,2,3,-2.5201731271875474,-0.2796768651378445,12,21
1454,relax_one,0.15,3,1,2,6.978177374817193,0.0299077929175317,37,43
1455,relax_one,0.15,16,11,5,-12.594128119327898,-0.0458042751439569,41,52
1456,relax_one,0.15,0,1,-1,-86.17527256153878,-0.3485851341199432,90,89
1457,relax_one,0.15,1,0,1,83.10169529323252,-0.3534968284236887,22,21
1458,relax_one,0.15,9,2,7,9.608090879692476,0.01971611575908,37,43
1459,relax_one,0.15,9,3,6,20.8283596983893,0.1376202366330028,47,47
1460,relax_one,0.15,5,4,1,-5.315980892962003,-0.1042068723106183,12,20
1461,relax_one,0.15,127,118,9,-5.768591785818266,0.145995033748962,84,124
1462,relax_one,0.15,0,0,0,0.0,0.0165794351838991,88,92
1463,relax_one,0.15,367,312,55,-0.4138973394261143,0.0301331631264896,59,122
1464,relax_one,0.15,8,3,5,-3.400198196157632,-0.1066156906899781,26,31
1465,relax_one,0.15,0,0,0,0.0,0.0103024582662557,28,27
1466,relax_one,0.15,2,2,0,29.6296637996548,-0.1233792330145788,18,26
1467,relax_one,0.15,2,1,1,-16.484061378598497,0.1356277781103444,23,26
1468,relax_one,0.15,0,1,-1,-77.5765283963928,0.1973819756388708,43,43
1469,relax_one,0.15,0,1,-1,-84.38474463551317,0.1163922494148136,22,26
1470,relax_one,0.15,0,0,0,0.0,0.2416851697609462,15,14
1471,relax_one,0.15,11,11,0,-3.916047893447441,0.2041029399287693,36,48
1472,relax_one,0.15,11,6,5,-0.5628916130069541,-0.2354483774425076,30,37
1473,relax_one,0.15,2,4,-2,10.183567451622892,0.1417980041839559,10,13
1474,relax_one,0.15,1,0,1,85.11427280969323,0.1681365888839667,12,11
1475,relax_one,0.15,200,168,32,0.3009309318293134,0.1715264827609256,55,105
1476,relax_one,0.15,5,0,5,77.39852749033612,0.1792822961091807,13,17
1477,relax_one,0.15,1,1,0,-1.4222585396210832,0.2086749126438291,30,29
1478,relax_one,0.15,3,10,-7,-2.2530444571474675,0.1828204728559713,36,43
1479,relax_one,0.15,23,18,5,3.5296716963920147,-0.249254158031616,40,60
1480,relax_one,0.15,2,1,1,-39.17656225598696,0.0882843451415753,13,17
1481,relax_one,0.15,10,8,2,-15.0371720308666,-0.1843905362849733,23,30
1482,relax_one,0.15,5,4,1,12.033937278583773,-0.249540806451964,12,16
1483,relax_one,0.15,0,0,0,0.0,0.1877051061757098,26,26
1484,relax_one,0.15,3,1,2,32.95692291908291,0.060489761735897,22,31
1485,relax_one,0.15,1,0,1,71.80145346615578,0.1317715530444231,68,68
1486,relax_one,0.15,0,0,0,0.0,-0.1307343826711623,23,22
1487,relax_one,0.15,4,0,4,61.84144618432475,0.1743125193086315,43,42
1488,relax_one,0.15,0,3,-3,-78.43202281393813,-0.1592981986963081,18,17
1489,relax_one,0.15,11,7,4,-8.345210790801445,0.0167609585014457,28,42
1490,relax_one,0.15,46,38,8,1.5999871644431778,0.0423082545779703,21,44
1491,relax_one,0.15,4,8,-4,-7.1060197087302015,0.1958061301729904,36,37
1492,relax_one,0.15,0,0,0,0.0,-0.0379837714870017,15,14
1493,relax_one,0.15,0,2,-2,-52.6992570982063,0.0093079983533256,14,16
1494,relax_one,0.15,241,221,20,0.6831592174291146,-0.1329790220561676,61,119
1495,relax_one,0.15,0,0,0,0.0,-0.0364354682766565,19,20
1496,relax_one,0.15,0,0,0,0.0,0.2178644073911277,22,22
1497,relax_one,0.15,2,3,-1,-0.1662842301746394,0.0087188416695245,54,58
1498,relax_one,0.15,571,483,88,-1.5418656848552672,-0.2468686589584886,65,135
1499,relax_one,0.15,1,2,-1,-2.2437234353632505,-0.0761048876599334,16,18
1500,relax_one,0.15,12,6,6,3.636931594080615,0.1273226632917018,17,27
1501,relax_one,0.15,43,25,18,-4.031766695636918,0.1872305766316083,54,71
1502,relax_one,0.15,0,0,0,0.0,0.2648584387498854,23,22
1503,relax_one,0.15,0,0,0,0.0,0.093829562034493,13,16
1504,relax_one,0.15,186,139,47,-1.362642796380669,0.1242306133337699,85,131
1505,relax_one,0.15,37,74,-37,4.971540946140102,-0.0545700773346248,28,55
1506,relax_one,0.15,7,2,5,14.811240085809189,0.2362041183590478,18,24
1507,relax_one,0.15,0,1,-1,-36.20714011802975,0.2035109830117657,19,22
1508,relax_one,0.15,1,0,1,77.08017074593721,0.0622526584111639,47,46
1509,relax_one,0.15,41,18,23,0.0351956913903848,-0.1540190711981034,39,64
1510,relax_one,0.15,1,0,1,64.40244160544206,0.0711297049213532,17,18
1511,relax_one,0.15,1,2,-1,9.561881092207416,-0.0385196141386738,23,24
1512,relax_one,0.15,1,0,1,67.31694341377472,-0.2775843549327187,13,16
1513,relax_one,0.15,25,18,7,6.941545955064662,-0.0145268066720007,40,56
1514,relax_one,0.15,0,4,-4,-78.59660225615602,0.0046909950490787,10,15
1515,relax_one,0.15,1,0,1,66.59947443543717,0.0093933821878631,21,20
1516,relax_one,0.15,6,1,5,10.46660226929754,-0.0347962363906446,30,35
1517,relax_one,0.15,3,2,1,6.731614043720498,0.1153156002703097,71,77
1518,just_relax,0.15,0,0,0,0.0,0.0164388650863411,17,18
1519,just_relax,0.15,4,4,0,12.223570126631216,-0.1257717914788833,43,48
1520,just_relax,0.15,8,5,3,-0.1989608560162707,0.2016884037358164,38,45
1521,just_relax,0.15,0,0,0,0.0,-0.2931741234319865,12,12
1522,just_relax,0.15,21,15,6,2.862816692274869,-0.2735014045316315,23,38
1523,just_relax,0.15,2,0,2,72.31015127852417,0.1331899891440479,19,22
1524,just_relax,0.15,995,734,261,0.1616616428957371,0.2143082525799591,35,143
1525,just_relax,0.15,5,6,-1,19.60853947618753,-0.0117188579960859,92,91
1526,just_relax,0.15,10,35,-25,16.072205975704314,0.0612544914392665,43,51
1527,just_relax,0.15,3,1,2,9.217500471939388,-0.2113262150055402,35,36
1528,just_relax,0.15,1,0,1,86.53254032965494,-0.2634809155285001,11,13
1529,just_relax,0.15,10,28,-18,4.446114774116637,0.2543474618888215,10,25
1530,just_relax,0.15,44,49,-5,13.759118356519153,-0.015245170583871,86,136
1531,just_relax,0.15,0,0,0,0.0,0.2416245250276713,10,12
1532,just_relax,0.15,0,0,0,0.0,0.0011097679623176,32,31
1533,just_relax,0.15,7,7,0,10.082552392121094,0.2754644454161528,20,26
1534,just_relax,0.15,0,0,0,0.0,0.1553155517614889,11,11
1535,just_relax,0.15,13,8,5,22.952277487449308,0.2923496613209471,34,42
1536,just_relax,0.15,11,18,-7,10.396463400431088,-0.2721764408050196,14,25
1537,just_relax,0.15,11,15,-4,4.051090565207787,-0.2019489508157128,31,46
1538,just_relax,0.15,4,5,-1,13.716595542313556,-0.0096952074065981,42,45
1539,just_relax,0.15,1273,1154,119,-1.5506054075589688,-0.0122800325326352,39,173
1540,just_relax,0.15,8,11,-3,11.964036026205932,0.3856713534091296,14,24
1541,just_relax,0.15,5,0,5,66.16540505573178,0.0204749792742026,24,25
1542,just_relax,0.15,10,1,9,-25.431866786898176,-0.1975357167457761,12,19
1543,just_relax,0.15,50,63,-13,5.751764823021155,0.0948137157143371,41,72
1544,just_relax,0.15,242,248,-6,6.135447729648945,-0.105950816237506,59,115
1545,just_relax,0.15,8,7,1,4.484737147438793,-0.3087606570232383,32,37
1546,just_relax,0.15,1,0,1,86.73095504664919,0.1835660248465896,20,20
1547,just_relax,0.15,37,27,10,-3.269000391113039,-0.0003968088372788,12,31
1548,just_relax,0.15,0,0,0,0.0,0.0587311845791076,10,10
1549,just_relax,0.15,3,2,1,-8.105043583472266,-0.0409792585525319,20,21
1550,just_relax,0.15,30,33,-3,8.183280276122368,0.1574329570767856,39,52
1551,just_relax,0.15,384,352,32,1.0743615845264929,-0.3401193843152781,42,109
1552,just_relax,0.15,1,1,0,5.508730601363865,0.0276273408680391,25,28
1553,just_relax,0.15,268,247,21,1.86243040013504,-0.2530129681050197,56,106
1554,just_relax,0.15,416,652,-236,7.741660888183212,0.0459572398297208,87,189
1555,just_relax,0.15,56,45,11,3.325871022927373,-0.0997585627587727,56,82
1556,just_relax,0.15,1,1,0,-28.736409678392903,0.0403343275337992,13,15
1557,just_relax,0.15,80,97,-17,4.237656656477014,-0.0341368971598493,36,63
1558,just_relax,0.15,0,1,-1,-80.41920464528648,-0.3630606131244309,16,15
1559,just_relax,0.15,0,0,0,0.0,-0.5811555293360537,67,66
1560,just_relax,0.15,23,12,11,-9.67599020409596,-0.2149691996461973,42,60
1561,just_relax,0.15,2,4,-2,-4.082125000221083,0.1956881372678421,39,38
1562,just_relax,0.15,32,10,22,3.923103710902353,0.0303502213705502,20,36
1563,just_relax,0.15,0,1,-1,-77.1823786570401,0.0513139071399697,10,9
1564,just_relax,0.15,4,0,4,59.69780334739121,-0.0469842570865467,13,15
1565,just_relax,0.15,8,14,-6,4.951071296132355,-0.1492196367182673,34,41
1566,just_relax,0.15,10,14,-4,5.990565889767161,-0.0264193738326224,37,42
1567,just_relax,0.15,25,13,12,-6.956790919132914,0.3968100799716468,18,29
1568,just_relax,0.15,1,0,1,86.11203827540925,0.2090848702024672,23,22
1569,just_relax,0.15,0,0,0,0.0,0.1609435460280798,13,12
1570,just_relax,0.15,1,0,1,79.1008771168989,0.2728257814465498,15,14
1571,just_relax,0.15,13,0,13,57.09178364653058,-0.4110282760314455,69,68
1572,just_relax,0.15,0,0,0,0.0,-0.1824243758175959,40,39
1573,just_relax,0.15,1,32,-31,-52.36729673254291,0.1136954906092091,89,93
1574,just_relax,0.15,14,9,5,-6.0582095564003,0.1994788419090611,20,32
1575,just_relax,0.15,3,1,2,-20.094960405083185,0.1401456733901049,69,83
1576,just_relax,0.15,2,0,2,70.18597341457678,0.2254137293982034,12,15
1577,just_relax,0.15,2,0,2,82.72841034720743,-0.3846742585529485,15,14
1578,just_relax,0.15,0,3,-3,-51.85417326169059,0.2621656780600175,23,26
1579,just_relax,0.15,9,5,4,8.615763849772577,0.0504506393176423,12,20
1580,just_relax,0.15,250,219,31,2.278570887857306,0.2948093593430244,64,122
1581,just_relax,0.15,15,16,-1,17.5692527658953,0.1352401292661345,58,71
1582,just_relax,0.15,0,0,0,0.0,0.1030765572748164,20,19
1583,just_relax,0.15,361,427,-66,3.4506232487723167,-0.0003000458903809,100,191
1584,just_relax,0.15,33,40,-7,8.736279400258411,-0.0064338614092567,41,61
1585,just_relax,0.15,23,36,-13,7.89925237367671,0.0502476737868883,13,31
1586,just_relax,0.15,4,3,1,11.22052256070922,-0.0854257218287415,10,15
1587,just_relax,0.15,20,14,6,2.592225693036596,0.2068436793028358,37,47
1588,just_relax,0.15,1,1,0,-29.24334694711898,-0.117342538708107,21,21
1589,just_relax,0.15,2,0,2,69.60628806651235,0.3841107896703647,11,10
1590,just_relax,0.15,48,50,-2,1.4777676640581203,-0.0370337539669712,44,80
1591,just_relax,0.15,2,8,-6,21.8707807960144,0.0817070070219939,12,21
1592,just_relax,0.15,4,5,-1,-5.95416837824888,-0.0489375469648674,37,43
1593,just_relax,0.15,23,8,15,1.2370309364117418,0.0241789860092568,41,52
1594,just_relax,0.15,0,0,0,0.0,-0.0436744893518886,90,89
1595,just_relax,0.15,0,8,-8,-62.43064694290992,0.0828437979284073,22,21
1596,just_relax,0.15,0,1,-1,-33.98701278880512,-0.1332506742940636,37,43
1597,just_relax,0.15,3,14,-11,20.213284072218777,0.0180311792009406,47,47
1598,just_relax,0.15,12,4,8,-16.929799923176468,-0.1075167570518226,12,20
1599,just_relax,0.15,123,138,-15,0.5705965474100694,-0.1131448205382965,84,124
1600,just_relax,0.15,1,9,-8,-50.7219317287872,-0.3542928713908138,88,92
1601,just_relax,0.15,396,474,-78,1.02619761212231,0.1075867629336335,59,122
1602,just_relax,0.15,2,2,0,6.520007519816076,-0.1390561946911517,26,31
1603,just_relax,0.15,0,1,-1,-8.081130803681061,-0.4524841084540043,28,27
1604,just_relax,0.15,8,4,4,-15.05762384323225,-0.3079390705692247,18,26
1605,just_relax,0.15,3,4,-1,-24.487726223803925,0.2722878504196162,23,26
1606,just_relax,0.15,1,0,1,86.72427187010656,-0.1254803231554728,43,43
1607,just_relax,0.15,1,3,-2,23.237801804744024,-0.0940988743463024,22,26
1608,just_relax,0.15,0,0,0,0.0,0.1190768231680822,15,14
1609,just_relax,0.15,17,20,-3,8.266871169487338,0.2860087854569275,36,48
1610,just_relax,0.15,7,6,1,-8.341138825123338,-0.2716436149676261,30,37
1611,just_relax,0.15,1,2,-1,-3.9126725682017423,-0.2666919118192074,10,13
1612,just_relax,0.15,1,0,1,68.51260518340062,0.3327388707433824,12,11
1613,just_relax,0.15,184,194,-10,2.5883363024601564,0.1803254807425295,55,105
1614,just_relax,0.15,3,0,3,71.54249785994547,0.5148800283459087,13,17
1615,just_relax,0.15,0,13,-13,-52.68621557815159,-0.22567665260998,30,29
1616,just_relax,0.15,8,3,5,-9.763674598508246,-0.0212936516311155,36,43
1617,just_relax,0.15,22,27,-5,8.71748550543763,-0.2521532059105422,40,60
1618,just_relax,0.15,0,3,-3,-69.16099165784605,0.1486474641350349,13,17
1619,just_relax,0.15,8,5,3,7.215736599727755,0.3835380883463462,23,30
1620,just_relax,0.15,2,0,2,70.12158320457198,-0.1292575660532764,12,16
1621,just_relax,0.15,0,1,-1,-66.98913618206176,-0.1528944615019205,26,26
1622,just_relax,0.15,1,1,0,21.796966202184656,-0.0295570866218293,22,31
1623,just_relax,0.15,2,0,2,72.65682470172095,-0.1282197004037507,68,68
1624,just_relax,0.15,0,0,0,0.0,0.1684684811089585,23,22
1625,just_relax,0.15,2,0,2,72.10106692968553,-0.2441068554419059,43,42
1626,just_relax,0.15,0,0,0,0.0,-0.5625513181407453,18,17
1627,just_relax,0.15,11,10,1,3.733568674057522,0.0063530039442627,28,42
1628,just_relax,0.15,51,59,-8,1.7596753239327256,0.175586080459853,21,44
1629,just_relax,0.15,1,1,0,17.399613005586062,0.0460935688982665,36,37
1630,just_relax,0.15,0,0,0,0.0,-0.2194387347634702,15,14
1631,just_relax,0.15,1,2,-1,22.243504103663938,-0.4603039485118806,14,16
1632,just_relax,0.15,270,253,17,0.051374442048619,0.1015443929002808,61,119
1633,just_relax,0.15,1,0,1,66.30296441928137,-0.1446628761045115,19,20
1634,just_relax,0.15,2,1,1,58.57300643782389,-0.0461383477051751,22,22
1635,just_relax,0.15,1,12,-11,0.2027633678936453,0.0007955634636094,54,58
1636,just_relax,0.15,498,772,-274,7.005758472230895,0.1088434592457272,65,135
1637,just_relax,0.15,2,0,2,65.83491176810423,0.0553752504953058,16,18
1638,just_relax,0.15,6,6,0,4.016459032497686,0.2691477165840638,17,27
1639,just_relax,0.15,22,12,10,5.624266883785118,0.3098196052581716,54,71
1640,just_relax,0.15,0,0,0,0.0,0.0416880711677564,23,22
1641,just_relax,0.15,0,1,-1,-42.71707166019001,0.2565317489263083,13,16
1642,just_relax,0.15,223,246,-23,2.213018335852034,-0.1264552192988746,85,131
1643,just_relax,0.15,33,42,-9,-2.4550432652608976,-0.1034194487409017,28,55
1644,just_relax,0.15,2,2,0,6.21506679955256,0.2666506438723054,18,24
1645,just_relax,0.15,1,1,0,10.70632048642628,0.2057962944704101,19,22
1646,just_relax,0.15,4,0,4,77.0502728726684,0.0196395769877965,47,46
1647,just_relax,0.15,36,59,-23,11.078144533040645,0.090310103313645,39,64
1648,just_relax,0.15,1,0,1,46.4917178597875,-0.0081297312063194,17,18
1649,just_relax,0.15,6,1,5,-13.00397129175505,0.0714267461289445,23,24
1650,just_relax,0.15,1,2,-1,3.4132799858146257,0.2945852437496953,13,16
1651,just_relax,0.15,22,45,-23,1.881220385436961,-0.1113443109249758,40,56
1652,just_relax,0.15,0,0,0,0.0,0.5085566715549652,10,15
1653,just_relax,0.15,0,0,0,0.0,-0.1062120993220968,21,20
1654,just_relax,0.15,6,8,-2,3.793982250952581,-0.2124303999404379,30,35
1655,just_relax,0.15,2,6,-4,-21.43233202234692,0.119376903494375,71,77
1656,relax_and_recompute,0.2,0,2,-2,-74.12220357201397,-0.2224150117631356,17,18
1657,relax_and_recompute,0.2,7,2,5,15.48312359925319,0.2066343666278698,43,48
1658,relax_and_recompute,0.2,5,3,2,-1.910175939001789,0.153255883756981,38,45
1659,relax_and_recompute,0.2,0,0,0,0.0,0.1371562040112017,12,12
1660,relax_and_recompute,0.2,17,3,14,-8.503964677984726,0.0381348345676405,23,38
1661,relax_and_recompute,0.2,1,0,1,74.78692580879954,0.1246234241795092,19,22
1662,relax_and_recompute,0.2,750,773,-23,-0.8025139448399088,0.2111826943856252,35,143
1663,relax_and_recompute,0.2,15,4,11,4.251892523131261,0.0444109298323538,92,91
1664,relax_and_recompute,0.2,7,2,5,49.37843840193073,-0.1162827780841345,43,51
1665,relax_and_recompute,0.2,1,3,-2,3.184734743451159,0.1702952912259815,35,36
1666,relax_and_recompute,0.2,0,0,0,0.0,-0.1750480299514922,11,13
1667,relax_and_recompute,0.2,22,15,7,-2.368159660027416,-0.0580014035334458,10,25
1668,relax_and_recompute,0.2,25,28,-3,4.877438426937189,0.2087752551651834,86,136
1669,relax_and_recompute,0.2,0,0,0,0.0,0.2758906895127436,10,12
1670,relax_and_recompute,0.2,0,0,0,0.0,-0.0624518811777222,32,31
1671,relax_and_recompute,0.2,5,9,-4,7.410929470506943,0.1688525982986323,20,26
1672,relax_and_recompute,0.2,1,1,0,0.9464114393395278,-0.1094029979278856,11,11
1673,relax_and_recompute,0.2,2,3,-1,-12.192161996832368,0.0063856766739598,34,42
1674,relax_and_recompute,0.2,11,15,-4,-1.4200624969119175,-0.3291614880326028,14,25
1675,relax_and_recompute,0.2,11,7,4,11.576143497737595,-0.1443766770934568,31,46
1676,relax_and_recompute,0.2,4,3,1,-6.862073366419537,-0.2895567149748117,42,45
1677,relax_and_recompute,0.2,1157,1114,43,-0.7949113859978354,-0.0941521026441341,39,173
1678,relax_and_recompute,0.2,12,8,4,-5.687517866388063,0.0520792854200885,14,24
1679,relax_and_recompute,0.2,2,0,2,84.10075603465451,0.2078981234917727,24,25
1680,relax_and_recompute,0.2,1,1,0,0.9121141523954606,0.1674298312943778,12,19
1681,relax_and_recompute,0.2,85,50,35,4.0966085261844825,-0.1736739240193269,41,72
1682,relax_and_recompute,0.2,196,163,33,-0.4760502519019525,0.2600195666934058,59,115
1683,relax_and_recompute,0.2,5,6,-1,-4.10527874764108,0.36588570843148,32,37
1684,relax_and_recompute,0.2,0,0,0,0.0,0.0966876382427477,20,20
1685,relax_and_recompute,0.2,25,21,4,1.0971729995240764,0.176606389831502,12,31
1686,relax_and_recompute,0.2,0,0,0,0.0,-0.3119566283457696,10,10
1687,relax_and_recompute,0.2,1,1,0,-4.343937368107234,-0.2943777317770588,20,21
1688,relax_and_recompute,0.2,22,9,13,2.213749314960438,0.0871345444546889,39,52
1689,relax_and_recompute,0.2,326,353,-27,-0.8569943362027743,-0.0454095486585365,42,109
1690,relax_and_recompute,0.2,3,0,3,68.15924873011802,0.4251404927197289,25,28
1691,relax_and_recompute,0.2,240,161,79,-0.8628611017586536,-0.0625303017362686,56,106
1692,relax_and_recompute,0.2,434,420,14,-0.6399941289352,-0.0355923549250902,87,189
1693,relax_and_recompute,0.2,94,56,38,2.7587434830850697,-0.03661934842778,56,82
1694,relax_and_recompute,0.2,1,2,-1,6.9664379237433565,-0.2133621506545254,13,15
1695,relax_and_recompute,0.2,87,60,27,-2.5356086227837977,0.2622277810950493,36,63
1696,relax_and_recompute,0.2,2,0,2,64.78792226559477,-0.1239200284829913,16,15
1697,relax_and_recompute,0.2,0,0,0,0.0,0.2955033063319167,67,66
1698,relax_and_recompute,0.2,17,20,-3,7.873825495276392,-0.0397979653189967,42,60
1699,relax_and_recompute,0.2,3,0,3,70.8454006927317,0.2939745582580503,39,38
1700,relax_and_recompute,0.2,13,9,4,2.580570276987629,0.233380855739593,20,36
1701,relax_and_recompute,0.2,0,0,0,0.0,0.027948392792809,10,9
1702,relax_and_recompute,0.2,2,0,2,75.2422492674754,0.2093014524635671,13,15
1703,relax_and_recompute,0.2,8,9,-1,8.192253290842004,0.2198368880438188,34,41
1704,relax_and_recompute,0.2,5,8,-3,7.815119348366991,0.4193535184208732,37,42
1705,relax_and_recompute,0.2,30,17,13,10.102240195176726,-0.1267776755645684,18,29
1706,relax_and_recompute,0.2,0,0,0,0.0,-0.0497254028825573,23,22
1707,relax_and_recompute,0.2,0,0,0,0.0,-0.2262742855867562,13,12
1708,relax_and_recompute,0.2,0,1,-1,-54.49040946725215,0.0764577288854709,15,14
1709,relax_and_recompute,0.2,0,0,0,0.0,0.4210546986626992,69,68
1710,relax_and_recompute,0.2,0,0,0,0.0,-0.5452645432712344,40,39
1711,relax_and_recompute,0.2,9,1,8,-20.099835506346466,-0.1130738654163351,89,93
1712,relax_and_recompute,0.2,13,13,0,-7.032675469087721,-0.0004777424454586,20,32
1713,relax_and_recompute,0.2,4,5,-1,13.450043561368544,-0.1417435246318585,69,83
1714,relax_and_recompute,0.2,1,1,0,2.7177692958153727,0.2869195694926926,12,15
1715,relax_and_recompute,0.2,0,0,0,0.0,-0.0928160939764711,15,14
1716,relax_and_recompute,0.2,4,1,3,0.4664484249865808,0.0689689844950458,23,26
1717,relax_and_recompute,0.2,3,4,-1,9.178696783823767,-0.0200402759952239,12,20
1718,relax_and_recompute,0.2,261,172,89,-1.601184999335068,-0.0669633369953123,64,122
1719,relax_and_recompute,0.2,5,5,0,-0.8544277986908213,0.204279830328923,58,71
1720,relax_and_recompute,0.2,0,0,0,0.0,-0.2478844058466036,20,19
1721,relax_and_recompute,0.2,519,305,214,-0.2555586351387404,0.0259163317364441,100,191
1722,relax_and_recompute,0.2,41,26,15,-11.118730789257498,0.0421467850277441,41,61
1723,relax_and_recompute,0.2,28,35,-7,-2.9625947310697143,-0.164352243231366,13,31
1724,relax_and_recompute,0.2,6,2,4,18.928722369654324,-0.254481877275736,10,15
1725,relax_and_recompute,0.2,17,17,0,-2.0659856140492394,-0.0673037274292291,37,47
1726,relax_and_recompute,0.2,1,1,0,36.57933446983844,-0.0216226146453856,21,21
1727,relax_and_recompute,0.2,0,0,0,0.0,-0.3369502805439639,11,10
1728,relax_and_recompute,0.2,61,39,22,-0.0501548276204033,-0.0219167043551672,44,80
1729,relax_and_recompute,0.2,6,2,4,0.1369495523816368,0.017777149767314,12,21
1730,relax_and_recompute,0.2,7,1,6,11.658972374104067,-0.1084287214501101,37,43
1731,relax_and_recompute,0.2,10,9,1,-8.91309588319556,0.0706754578672175,41,52
1732,relax_and_recompute,0.2,1,0,1,82.78524407077954,0.221813223167434,90,89
1733,relax_and_recompute,0.2,0,0,0,0.0,0.2886954317003966,22,21
1734,relax_and_recompute,0.2,1,1,0,-23.449470877344496,-0.0865303306587742,37,43
1735,relax_and_recompute,0.2,7,0,7,68.67285932891488,0.0259313332831154,47,47
1736,relax_and_recompute,0.2,4,4,0,-1.605106216237715,-0.1580590098869221,12,20
1737,relax_and_recompute,0.2,151,142,9,-0.4769048836780527,-0.1174004409205335,84,124
1738,relax_and_recompute,0.2,1,0,1,82.13669056013202,0.0187011588352526,88,92
1739,relax_and_recompute,0.2,285,270,15,2.6221200016043014,0.1355380979731162,59,122
1740,relax_and_recompute,0.2,5,4,1,8.830337773914152,0.1547155599292088,26,31
1741,relax_and_recompute,0.2,0,0,0,0.0,0.3419385066682852,28,27
1742,relax_and_recompute,0.2,8,4,4,0.8154833600931113,0.0016836182156942,18,26
1743,relax_and_recompute,0.2,1,1,0,18.29197396390433,0.3153503055701119,23,26
1744,relax_and_recompute,0.2,1,1,0,2.672088857104171,-0.0806171816874271,43,43
1745,relax_and_recompute,0.2,1,3,-2,-4.453528263733482,-0.1814963012021289,22,26
1746,relax_and_recompute,0.2,0,0,0,0.0,-0.2647658086633306,15,14
1747,relax_and_recompute,0.2,9,9,0,5.681857621923456,0.1527076184069775,36,48
1748,relax_and_recompute,0.2,7,3,4,-10.15705656443368,0.0400482298031366,30,37
1749,relax_and_recompute,0.2,1,1,0,-5.678599608961719,-0.0843733895999849,10,13
1750,relax_and_recompute,0.2,0,0,0,0.0,-0.0828884797044123,12,11
1751,relax_and_recompute,0.2,240,185,55,1.716506000944122,0.0661987002215298,55,105
1752,relax_and_recompute,0.2,2,1,1,-27.07825028133693,0.0858776924348926,13,17
1753,relax_and_recompute,0.2,1,2,-1,-12.383127102860044,0.1213179525937272,30,29
1754,relax_and_recompute,0.2,4,2,2,20.40172997739089,0.5849906186609757,36,43
1755,relax_and_recompute,0.2,36,22,14,-2.5144175649418017,0.1158852174867198,40,60
1756,relax_and_recompute,0.2,0,1,-1,-68.43148049821518,0.2202297914310196,13,17
1757,relax_and_recompute,0.2,8,11,-3,-2.2203058667652726,0.0647982095503583,23,30
1758,relax_and_recompute,0.2,7,1,6,26.00867221339572,-0.1156411582813297,12,16
1759,relax_and_recompute,0.2,0,0,0,0.0,0.0119476496037413,26,26
1760,relax_and_recompute,0.2,1,0,1,38.38480856324728,0.3021604878091866,22,31
1761,relax_and_recompute,0.2,0,0,0,0.0,-0.0247558177508596,68,68
1762,relax_and_recompute,0.2,0,0,0,0.0,0.1160590193803772,23,22
1763,relax_and_recompute,0.2,0,0,0,0.0,-0.1613088835793502,43,42
1764,relax_and_recompute,0.2,0,2,-2,-76.19284577049729,-0.1143037372566443,18,17
1765,relax_and_recompute,0.2,10,11,-1,-9.056681051982572,0.312656616665905,28,42
1766,relax_and_recompute,0.2,48,55,-7,-0.2479051067759172,-0.0711488485976575,21,44
1767,relax_and_recompute,0.2,4,0,4,73.42917899493784,-0.2045507907018271,36,37
1768,relax_and_recompute,0.2,0,0,0,0.0,-0.0226478537813367,15,14
1769,relax_and_recompute,0.2,0,0,0,0.0,-0.0293936484466381,14,16
1770,relax_and_recompute,0.2,293,210,83,1.3016084455887835,-0.0246294958104764,61,119
1771,relax_and_recompute,0.2,0,0,0,0.0,0.2022540138855147,19,20
1772,relax_and_recompute,0.2,1,2,-1,-5.096446478592384,0.0467397242508839,22,22
1773,relax_and_recompute,0.2,0,3,-3,-70.73266468262152,-0.1574408772171242,54,58
1774,relax_and_recompute,0.2,462,445,17,-1.2718519793072005,-0.0839690769778475,65,135
1775,relax_and_recompute,0.2,1,0,1,77.22327761699103,0.0137112780640116,16,18
1776,relax_and_recompute,0.2,8,5,3,-0.7783691053220565,0.1834419692275807,17,27
1777,relax_and_recompute,0.2,8,10,-2,10.117175103138765,0.051190745209406,54,71
1778,relax_and_recompute,0.2,1,1,0,15.997670002799268,-0.3250263142718103,23,22
1779,relax_and_recompute,0.2,4,0,4,66.67492802555695,0.1741469081811331,13,16
1780,relax_and_recompute,0.2,130,127,3,-2.2407852683209555,-0.1357948450645142,85,131
1781,relax_and_recompute,0.2,48,49,-1,1.5028466264157458,-0.19202734127422,28,55
1782,relax_and_recompute,0.2,1,1,0,15.523060875689232,0.2006706427924319,18,24
1783,relax_and_recompute,0.2,3,0,3,69.09481234224116,0.105109862552069,19,22
1784,relax_and_recompute,0.2,1,2,-1,40.12447359166047,0.4646378519111775,47,46
1785,relax_and_recompute,0.2,32,17,15,-4.483417160934081,0.2781709527216406,39,64
1786,relax_and_recompute,0.2,0,0,0,0.0,-0.0953496779053574,17,18
1787,relax_and_recompute,0.2,1,2,-1,-7.638645866311137,-0.3427424738094192,23,24
1788,relax_and_recompute,0.2,2,1,1,-15.099749687080433,0.31659105926851,13,16
1789,relax_and_recompute,0.2,16,14,2,12.00041126487065,0.0519125964811202,40,56
1790,relax_and_recompute,0.2,1,1,0,18.9738525158718,0.1083850208178069,10,15
1791,relax_and_recompute,0.2,0,0,0,0.0,0.1661358520654959,21,20
1792,relax_and_recompute,0.2,4,1,3,15.158654764903162,0.0399605848578612,30,35
1793,relax_and_recompute,0.2,1,2,-1,18.42301347456909,-0.244475626829855,71,77
1794,relax_one,0.2,0,0,0,0.0,0.2360567519978791,17,18
1795,relax_one,0.2,17,13,4,-3.104546948623096,-0.2141906187512582,43,48
1796,relax_one,0.2,10,13,-3,-16.35430408317532,0.1700476715416218,38,45
1797,relax_one,0.2,0,1,-1,-58.9651674515486,-0.0429763521722508,12,12
1798,relax_one,0.2,7,24,-17,2.3298670818074783,-0.088608737502889,23,38
1799,relax_one,0.2,1,1,0,5.257568079297968,-0.2368724889723448,19,22
1800,relax_one,0.2,753,869,-116,-0.2088499527108638,0.1130112756024595,35,143
1801,relax_one,0.2,3,2,1,-6.365415626512075,0.1453879723173929,92,91
1802,relax_one,0.2,3,2,1,-4.293942782922976,-0.0090664615022041,43,51
1803,relax_one,0.2,2,0,2,69.04215739772147,-0.2239872156017012,35,36
1804,relax_one,0.2,0,0,0,0.0,-0.4065282724221535,11,13
1805,relax_one,0.2,17,15,2,0.9709430865308236,-0.0051356399265836,10,25
1806,relax_one,0.2,31,29,2,-2.9571679337389014,0.4467880420100936,86,136
1807,relax_one,0.2,0,0,0,0.0,-0.1602681767854157,10,12
1808,relax_one,0.2,0,0,0,0.0,0.0978238373863548,32,31
1809,relax_one,0.2,5,10,-5,-4.415508462780124,0.1993228586310667,20,26
1810,relax_one,0.2,1,0,1,69.38829355640353,0.1845220582927337,11,11
1811,relax_one,0.2,1,6,-5,10.965450715550702,0.2813389763064715,34,42
1812,relax_one,0.2,8,13,-5,14.900652993232292,0.0915986808916169,14,25
1813,relax_one,0.2,8,5,3,-5.097676206989561,0.0404810767445376,31,46
1814,relax_one,0.2,1,0,1,66.97001752800847,-0.1031449534341838,42,45
1815,relax_one,0.2,1088,1254,-166,0.0647920816541969,-0.1920794438532242,39,173
1816,relax_one,0.2,11,11,0,6.547043742818055,0.145869514210619,14,24
1817,relax_one,0.2,2,0,2,84.97969715664347,-0.0265612430864125,24,25
1818,relax_one,0.2,1,1,0,13.979917388809495,-0.4192523071567935,12,19
1819,relax_one,0.2,66,81,-15,0.4704750427582311,-0.0305924953294309,41,72
1820,relax_one,0.2,200,194,6,0.1224118471413788,0.0737991851116336,59,115
1821,relax_one,0.2,6,4,2,0.8900756434924872,0.0667377845108766,32,37
1822,relax_one,0.2,1,1,0,17.813243836525416,0.1466617150463079,20,20
1823,relax_one,0.2,19,24,-5,-4.313729933646769,0.1847348140156957,12,31
1824,relax_one,0.2,1,0,1,72.40310082211728,0.3192225400905344,10,10
1825,relax_one,0.2,0,2,-2,-62.910663560373465,0.3300859564429383,20,21
1826,relax_one,0.2,34,21,13,1.7822342864493237,-0.0036126081700238,39,52
1827,relax_one,0.2,374,322,52,-2.2474399977637347,0.0236562994227058,42,109
1828,relax_one,0.2,4,1,3,-17.68094250999117,-0.101422384914928,25,28
1829,relax_one,0.2,178,163,15,1.1809525671481111,0.1754426380991904,56,106
1830,relax_one,0.2,511,429,82,0.836826248953848,0.0698398381836202,87,189
1831,relax_one,0.2,38,39,-1,-2.9216654263039743,0.2655615104533841,56,82
1832,relax_one,0.2,1,1,0,10.952511830880738,0.0450511065157525,13,15
1833,relax_one,0.2,89,82,7,-1.4916589680937165,0.0573990511632771,36,63
1834,relax_one,0.2,0,0,0,0.0,0.3135750337081019,16,15
1835,relax_one,0.2,0,0,0,0.0,-0.172234617228993,67,66
1836,relax_one,0.2,20,24,-4,-5.20216012441022,0.121160481898456,42,60
1837,relax_one,0.2,0,3,-3,-77.34562690311732,0.0320179578534719,39,38
1838,relax_one,0.2,12,12,0,1.90314664012746,0.0086289367394944,20,36
1839,relax_one,0.2,0,0,0,0.0,-0.2785253156519497,10,9
1840,relax_one,0.2,0,0,0,0.0,-0.1469637795035404,13,15
1841,relax_one,0.2,9,3,6,-11.073304802688384,-0.2367705794096769,34,41
1842,relax_one,0.2,9,14,-5,-12.222961520652468,0.0882700187791362,37,42
1843,relax_one,0.2,29,21,8,-1.232762994161888,0.159301059625005,18,29
1844,relax_one,0.2,0,2,-2,-82.24134428124904,-0.0853060535255927,23,22
1845,relax_one,0.2,0,0,0,0.0,0.2174781529286062,13,12
1846,relax_one,0.2,0,1,-1,-58.92626732363479,-0.3830344742569855,15,14
1847,relax_one,0.2,0,0,0,0.0,-0.2133313362328756,69,68
1848,relax_one,0.2,0,17,-17,-56.992415226182914,-0.186962714707115,40,39
1849,relax_one,0.2,1,5,-4,11.03275338467656,-0.0236491990061431,89,93
1850,relax_one,0.2,9,15,-6,-2.9344988048304543,0.1064035142733889,20,32
1851,relax_one,0.2,5,7,-2,-1.9781242549838536,0.3250214353113518,69,83
1852,relax_one,0.2,1,0,1,69.3756968015114,-0.3049599850611117,12,15
1853,relax_one,0.2,2,0,2,51.88844402779083,-0.14176394352816,15,14
1854,relax_one,0.2,4,2,2,10.800800426596211,0.0778737756996297,23,26
1855,relax_one,0.2,9,13,-4,8.35993493122487,0.0564051508770382,12,20
1856,relax_one,0.2,175,190,-15,-1.7502749631663477,0.1496367055884601,64,122
1857,relax_one,0.2,8,5,3,8.706953266746837,0.1576119364292454,58,71
1858,relax_one,0.2,0,1,-1,-88.94220401050221,0.1271601945648646,20,19
1859,relax_one,0.2,440,273,167,-1.0140647734306398,-0.2001305709474125,100,191
1860,relax_one,0.2,40,34,6,0.3587493279549392,-0.0274779091295905,41,61
1861,relax_one,0.2,19,29,-10,1.709889233208315,0.012774650344998,13,31
1862,relax_one,0.2,4,0,4,76.78557492070335,-0.1552746793799131,10,15
1863,relax_one,0.2,10,16,-6,1.4757958867268923,0.0008140510570385,37,47
1864,relax_one,0.2,1,0,1,58.66770411243718,0.1308689755390769,21,21
1865,relax_one,0.2,0,0,0,0.0,0.0863775486577044,11,10
1866,relax_one,0.2,53,51,2,1.2377166051524853,0.2912679428402532,44,80
1867,relax_one,0.2,5,3,2,3.771381187746073,-0.0277992533984248,12,21
1868,relax_one,0.2,6,4,2,-22.90153465510712,-0.291702479432154,37,43
1869,relax_one,0.2,4,5,-1,0.4836815234496896,0.1761833308900238,41,52
1870,relax_one,0.2,1,0,1,66.15031543247089,0.0260252542936678,90,89
1871,relax_one,0.2,1,0,1,68.49317585154955,0.0611582594681898,22,21
1872,relax_one,0.2,0,1,-1,-67.47066016210151,-0.2144981141218157,37,43
1873,relax_one,0.2,2,0,2,68.08767123686289,-0.0057029245521857,47,47
1874,relax_one,0.2,4,4,0,9.622330136379231,0.2030170243302163,12,20
1875,relax_one,0.2,113,113,0,3.200871615144088,-0.0310809149965211,84,124
1876,relax_one,0.2,0,0,0,0.0,-0.2739436280450571,88,92
1877,relax_one,0.2,399,333,66,3.776436896431264,0.1745743258837013,59,122
1878,relax_one,0.2,7,3,4,4.3426952057316015,-0.3815459566748129,26,31
1879,relax_one,0.2,0,0,0,0.0,-0.139667191424836,28,27
1880,relax_one,0.2,6,5,1,-4.652048700324293,0.1338782321723207,18,26
1881,relax_one,0.2,4,1,3,-7.683641648957163,0.0809798792133728,23,26
1882,relax_one,0.2,0,0,0,0.0,-0.054878243128683,43,43
1883,relax_one,0.2,0,2,-2,-60.3510488467313,-0.0753357064532853,22,26
1884,relax_one,0.2,0,0,0,0.0,0.1265126544850437,15,14
1885,relax_one,0.2,18,9,9,-17.192846899038315,0.0425385929860909,36,48
1886,relax_one,0.2,4,3,1,-4.350465988566455,-0.0321188474272059,30,37
1887,relax_one,0.2,2,6,-4,13.370389868991303,0.1298557347146197,10,13
1888,relax_one,0.2,0,0,0,0.0,-0.0883431284343152,12,11
1889,relax_one,0.2,183,170,13,-1.6478568334022157,-0.0105490435319065,55,105
1890,relax_one,0.2,2,0,2,84.07892237863774,0.2295607590402568,13,17
1891,relax_one,0.2,0,1,-1,-88.70769373129313,-0.1235537771672781,30,29
1892,relax_one,0.2,12,4,8,4.34373778773579,-0.1833148631252045,36,43
1893,relax_one,0.2,30,17,13,1.1652209393655966,0.1057785062271989,40,60
1894,relax_one,0.2,2,1,1,10.611992774496692,-0.1006402682365873,13,17
1895,relax_one,0.2,7,8,-1,-4.308749485718309,0.1491459002251632,23,30
1896,relax_one,0.2,1,2,-1,-10.235865053966757,0.058161400288856,12,16
1897,relax_one,0.2,1,1,0,-14.95358327707497,0.3703065605467887,26,26
1898,relax_one,0.2,1,4,-3,18.663922053967767,-0.0315929200793129,22,31
1899,relax_one,0.2,6,1,5,-29.58275946838402,-0.3074387002635964,68,68
1900,relax_one,0.2,0,0,0,0.0,-0.0788513184077842,23,22
1901,relax_one,0.2,0,0,0,0.0,-0.0029391836978605,43,42
1902,relax_one,0.2,0,0,0,0.0,0.2375226338330266,18,17
1903,relax_one,0.2,11,10,1,-0.5704793675744924,-0.1291851625449273,28,42
1904,relax_one,0.2,50,45,5,-4.106695124539193,-0.0510186027690663,21,44
1905,relax_one,0.2,0,1,-1,-84.13880252800183,-0.1424170789124281,36,37
1906,relax_one,0.2,0,0,0,0.0,-0.1685507140261601,15,14
1907,relax_one,0.2,1,1,0,0.9169820607637432,0.390586794832287,14,16
1908,relax_one,0.2,232,182,50,-0.0108155731693386,-0.3823228804291233,61,119
1909,relax_one,0.2,0,0,0,0.0,-0.0103566484847005,19,20
1910,relax_one,0.2,1,0,1,77.60548306899604,-0.3367865297260269,22,22
1911,relax_one,0.2,3,2,1,3.2471561322310407,0.2371380385744855,54,58
1912,relax_one,0.2,421,511,-90,2.7939325186261783,-0.184283301359058,65,135
1913,relax_one,0.2,1,1,0,-3.429834044052214,-0.092848572828,16,18
1914,relax_one,0.2,9,8,1,3.676430885829248,0.4328700635473632,17,27
1915,relax_one,0.2,21,22,-1,-0.0829964869367358,-0.0985136588231193,54,71
1916,relax_one,0.2,0,0,0,0.0,0.0613444028624304,23,22
1917,relax_one,0.2,3,4,-1,18.69086344378998,-0.0433482610746474,13,16
1918,relax_one,0.2,163,153,10,0.7931291761390611,-0.114989020931683,85,131
1919,relax_one,0.2,31,42,-11,-2.7809418611447327,0.0833654058817118,28,55
1920,relax_one,0.2,3,3,0,32.317902317181655,-0.0676602349274703,18,24
1921,relax_one,0.2,5,1,4,-7.159324815649725,-0.0020715729177497,19,22
1922,relax_one,0.2,3,1,2,-4.773802455874488,0.1455535092236716,47,46
1923,relax_one,0.2,45,29,16,-4.034529285151294,0.1306714873769764,39,64
1924,relax_one,0.2,1,0,1,74.13381085820309,0.06765923106978,17,18
1925,relax_one,0.2,3,2,1,-14.581236639380236,0.0402656171868917,23,24
1926,relax_one,0.2,1,1,0,-1.6456904069428333,-0.1431116318850104,13,16
1927,relax_one,0.2,22,23,-1,0.5290447405073451,-0.069410823393925,40,56
1928,relax_one,0.2,1,0,1,78.37723517073461,0.1660010429502749,10,15
1929,relax_one,0.2,1,0,1,63.658833347568034,0.1708506450286037,21,20
1930,relax_one,0.2,5,3,2,-6.402237235560335,0.1940594509159715,30,35
1931,relax_one,0.2,2,4,-2,16.700981506135726,0.0414961677524516,71,77
1932,just_relax,0.2,1,1,0,-4.396579014207077,0.1141533954960118,17,18
1933,just_relax,0.2,10,8,2,1.6929713448397337,-0.0442739337012098,43,48
1934,just_relax,0.2,2,3,-1,17.207478504262944,0.1149395198627596,38,45
1935,just_relax,0.2,0,0,0,0.0,0.0686291221810085,12,12
1936,just_relax,0.2,8,14,-6,27.30532614916443,-0.2687059885360733,23,38
1937,just_relax,0.2,1,0,1,77.37773471193434,0.0814475038862677,19,22
1938,just_relax,0.2,921,698,223,-1.068444703906145,-0.0622653407987053,35,143
1939,just_relax,0.2,2,8,-6,20.29837429697244,-0.0337415261107491,92,91
1940,just_relax,0.2,29,37,-8,5.304215712950715,-0.3136232818623362,43,51
1941,just_relax,0.2,1,4,-3,11.094549800823302,-0.047954848414155,35,36
1942,just_relax,0.2,0,0,0,0.0,-0.2022074713904084,11,13
1943,just_relax,0.2,18,22,-4,28.91377419816137,0.0064910991118073,10,25
1944,just_relax,0.2,36,59,-23,1.871287272124853,-0.3067626413123195,86,136
1945,just_relax,0.2,0,0,0,0.0,0.540024193074087,10,12
1946,just_relax,0.2,0,0,0,0.0,-0.0520832610533504,32,31
1947,just_relax,0.2,11,3,8,-25.91117626566673,0.1077479508200296,20,26
1948,just_relax,0.2,0,0,0,0.0,0.4843539826456006,11,11
1949,just_relax,0.2,13,5,8,-5.21164266827941,-0.00411129472494,34,42
1950,just_relax,0.2,15,20,-5,16.536734170765264,-0.2709556143378875,14,25
1951,just_relax,0.2,13,10,3,-1.0082837987453246,-0.0856800919321879,31,46
1952,just_relax,0.2,4,5,-1,-4.796309167827431,-0.0308435660790081,42,45
1953,just_relax,0.2,1135,1031,104,-0.2002692317959074,-0.0390380631364983,39,173
1954,just_relax,0.2,9,9,0,19.51293460233949,0.1740780193437745,14,24
1955,just_relax,0.2,0,1,-1,-49.96888128283516,-0.0775705583501217,24,25
1956,just_relax,0.2,3,1,2,-17.765583458371893,-0.1984510132921834,12,19
1957,just_relax,0.2,102,70,32,-1.2386609233315298,0.4106881476596664,41,72
1958,just_relax,0.2,200,203,-3,4.76199937588391,0.2481509153250438,59,115
1959,just_relax,0.2,4,11,-7,-0.4010538436602289,-0.2700075592206762,32,37
1960,just_relax,0.2,0,0,0,0.0,-0.0542938163715973,20,20
1961,just_relax,0.2,29,25,4,-4.41698834435806,-0.2334243850762948,12,31
1962,just_relax,0.2,1,0,1,82.26059484819156,0.1480988560439277,10,10
1963,just_relax,0.2,1,1,0,-34.35743672200722,-0.4986550420117109,20,21
1964,just_relax,0.2,24,25,-1,3.092823626924748,0.1514208847600133,39,52
1965,just_relax,0.2,335,434,-99,-0.498182492933509,-0.0317783471105661,42,109
1966,just_relax,0.2,1,1,0,-38.9812256577751,-0.1348761878906605,25,28
1967,just_relax,0.2,193,337,-144,1.4143863629301592,-0.1467762445443687,56,106
1968,just_relax,0.2,429,686,-257,9.358586460277962,0.1373170763618979,87,189
1969,just_relax,0.2,43,46,-3,0.0591928842985112,0.0307178359492583,56,82
1970,just_relax,0.2,1,1,0,1.8582251426007304,0.2948847891861366,13,15
1971,just_relax,0.2,97,123,-26,1.4614640377668522,-0.1797235845277845,36,63
1972,just_relax,0.2,1,1,0,33.733144417677906,0.0625700507693066,16,15
1973,just_relax,0.2,0,0,0,0.0,0.3556788924631913,67,66
1974,just_relax,0.2,20,17,3,-3.4266735308096585,0.349765717540544,42,60
1975,just_relax,0.2,1,0,1,75.05114825362055,-0.1508285096353091,39,38
1976,just_relax,0.2,9,11,-2,9.392680516694426,0.345720880688701,20,36
1977,just_relax,0.2,1,0,1,77.82191643202174,0.1536504196165818,10,9
1978,just_relax,0.2,2,0,2,75.74289314880166,-0.120067742638073,13,15
1979,just_relax,0.2,28,9,19,-5.23336058264448,-0.1000306791083577,34,41
1980,just_relax,0.2,14,6,8,-7.143315033572783,0.0435036037670979,37,42
1981,just_relax,0.2,27,23,4,-6.445657780039667,0.185178499638704,18,29
1982,just_relax,0.2,2,1,1,12.252797895240008,-0.0831442849526802,23,22
1983,just_relax,0.2,0,0,0,0.0,0.3374843204820512,13,12
1984,just_relax,0.2,3,0,3,52.88132450992174,-0.1133168428773468,15,14
1985,just_relax,0.2,0,7,-7,-73.47533260342053,0.0075577886384604,69,68
1986,just_relax,0.2,0,0,0,0.0,0.0859672296754967,40,39
1987,just_relax,0.2,0,6,-6,-63.61181676494229,-0.4401984650524346,89,93
1988,just_relax,0.2,13,15,-2,8.779269222485603,-0.075562367714822,20,32
1989,just_relax,0.2,2,2,0,-8.400835913159156,0.0720675073742469,69,83
1990,just_relax,0.2,1,2,-1,14.617471764136994,0.2359369333497549,12,15
1991,just_relax,0.2,0,0,0,0.0,-0.2131171845684701,15,14
1992,just_relax,0.2,3,2,1,-25.883850374863272,0.4707283803363109,23,26
1993,just_relax,0.2,4,4,0,20.530147578243287,-0.2711126491362692,12,20
1994,just_relax,0.2,239,176,63,0.6738268378653913,0.1778314856398889,64,122
1995,just_relax,0.2,34,20,14,-6.898819016974031,0.1210671300360581,58,71
1996,just_relax,0.2,0,0,0,0.0,0.0763762519579365,20,19
1997,just_relax,0.2,353,370,-17,4.820084175894891,0.0812311582736694,100,191
1998,just_relax,0.2,51,34,17,18.362811693481888,0.1358116072728503,41,61
1999,just_relax,0.2,16,48,-32,16.953425598254533,-0.0949950271945762,13,31
2000,just_relax,0.2,4,4,0,6.94060048303362,0.0572046787975888,10,15
2001,just_relax,0.2,20,10,10,-8.04631368734276,-0.3036707801291922,37,47
2002,just_relax,0.2,0,2,-2,-78.52635584702982,-0.217156646331436,21,21
2003,just_relax,0.2,0,0,0,0.0,0.3707750223040487,11,10
2004,just_relax,0.2,50,55,-5,-5.558987683978927,0.1498210637100892,44,80
2005,just_relax,0.2,3,2,1,-8.126996670480494,-0.2573983911878026,12,21
2006,just_relax,0.2,5,0,5,71.88734113196911,0.3883532157515799,37,43
2007,just_relax,0.2,27,9,18,-4.417267868811521,0.3266795347121607,41,52
2008,just_relax,0.2,3,7,-4,-15.980821012431662,0.0540576172412129,90,89
2009,just_relax,0.2,0,13,-13,-56.00604506558226,-0.1305644745891085,22,21
2010,just_relax,0.2,8,12,-4,-2.770358445844224,0.1832561833692524,37,43
2011,just_relax,0.2,4,8,-4,25.36065051578748,-0.0440567413504989,47,47
2012,just_relax,0.2,4,5,-1,11.68362818561583,0.0098309202449669,12,20
2013,just_relax,0.2,117,109,8,-0.6939835733817716,-0.1784029491863382,84,124
2014,just_relax,0.2,6,2,4,-3.626903598037458,-0.2824666926300947,88,92
2015,just_relax,0.2,346,385,-39,0.6785091355046902,-0.0355838022258525,59,122
2016,just_relax,0.2,9,10,-1,6.698599774807818,-0.080511348209351,26,31
2017,just_relax,0.2,0,0,0,0.0,0.055450731578581,28,27
2018,just_relax,0.2,1,4,-3,-12.691515810906807,0.1033340840002708,18,26
2019,just_relax,0.2,1,3,-2,1.4893774603067411,0.0545413952484556,23,26
2020,just_relax,0.2,4,0,4,58.61813903778796,0.178142215120578,43,43
2021,just_relax,0.2,1,2,-1,7.748089837754719,0.4132641887540438,22,26
2022,just_relax,0.2,0,0,0,0.0,0.2394837910739061,15,14
2023,just_relax,0.2,20,22,-2,-3.984235685051964,-0.0942996626029161,36,48
2024,just_relax,0.2,6,5,1,-19.635214152765208,0.0103457387697576,30,37
2025,just_relax,0.2,2,3,-1,2.130005177837731,-0.2261842451742464,10,13
2026,just_relax,0.2,1,0,1,83.84865183498076,0.1216190874201604,12,11
2027,just_relax,0.2,192,202,-10,4.70916846924429,0.0236518100013652,55,105
2028,just_relax,0.2,0,1,-1,-75.292931317844,-0.1363783205504415,13,17
2029,just_relax,0.2,0,2,-2,-63.73445995220997,-0.0205811620085601,30,29
2030,just_relax,0.2,6,7,-1,5.612410342690012,0.0634689292924683,36,43
2031,just_relax,0.2,36,25,11,10.099886889620976,0.3571965621932477,40,60
2032,just_relax,0.2,1,1,0,-43.325737206345295,0.4425578299074545,13,17
2033,just_relax,0.2,5,6,-1,7.365103325039172,-0.2280379954807462,23,30
2034,just_relax,0.2,3,1,2,-9.590987419212269,-0.3045362696585967,12,16
2035,just_relax,0.2,0,0,0,0.0,-0.1580875920238514,26,26
2036,just_relax,0.2,2,1,1,14.565024262698408,0.2638391970768923,22,31
2037,just_relax,0.2,2,1,1,19.210246316614047,-0.0953686605394058,68,68
2038,just_relax,0.2,0,0,0,0.0,0.0304578820981218,23,22
2039,just_relax,0.2,0,0,0,0.0,-0.0198914721386531,43,42
2040,just_relax,0.2,0,1,-1,-88.08502338920853,-0.1496380138303638,18,17
2041,just_relax,0.2,9,1,8,-12.722463624507853,-0.2471336821516391,28,42
2042,just_relax,0.2,55,34,21,-5.661916976958608,-0.3367223588753202,21,44
2043,just_relax,0.2,0,15,-15,-59.09666624540733,-0.1447638635871224,36,37
2044,just_relax,0.2,0,0,0,0.0,-0.0200170303317848,15,14
2045,just_relax,0.2,0,1,-1,-50.44752596219959,0.0292065260170788,14,16
2046,just_relax,0.2,216,212,4,-0.2991470854368998,0.0192551073594068,61,119
2047,just_relax,0.2,1,0,1,74.52147900016078,-0.3116456946176605,19,20
2048,just_relax,0.2,1,1,0,33.462370644552024,-0.1123564008890133,22,22
2049,just_relax,0.2,1,2,-1,47.07427059700785,-0.3864140184420093,54,58
2050,just_relax,0.2,584,685,-101,5.250892455614867,-0.2549130611298438,65,135
2051,just_relax,0.2,3,0,3,72.81990267272606,0.021328187622624,16,18
2052,just_relax,0.2,10,7,3,8.379361356681066,0.1894026124178279,17,27
2053,just_relax,0.2,18,14,4,-4.031253016010936,0.2811639489206186,54,71
2054,just_relax,0.2,4,1,3,-13.78208624603073,-0.1202108637701584,23,22
2055,just_relax,0.2,2,0,2,77.81432975267904,-0.0556609001535788,13,16
2056,just_relax,0.2,157,387,-230,4.234193319994006,0.0572525679201986,85,131
2057,just_relax,0.2,34,29,5,-1.6390337641328043,0.2717588578826765,28,55
2058,just_relax,0.2,1,6,-5,3.2572826786584983,0.1609205082345605,18,24
2059,just_relax,0.2,0,1,-1,-62.10278970152237,0.3356539407840386,19,22
2060,just_relax,0.2,1,0,1,85.27811974164943,0.4310940176902398,47,46
2061,just_relax,0.2,37,82,-45,0.9761466354804966,0.2281113194952297,39,64
2062,just_relax,0.2,1,3,-2,-10.49196386811748,0.2473003836498788,17,18
2063,just_relax,0.2,1,1,0,-0.5249464148511436,0.060680961588362,23,24
2064,just_relax,0.2,0,1,-1,-69.48961623016952,-0.37399858823823,13,16
2065,just_relax,0.2,25,60,-35,-1.6936021651806072,0.2321973587067468,40,56
2066,just_relax,0.2,1,0,1,79.50736690253851,-0.3296070309484408,10,15
2067,just_relax,0.2,1,1,0,60.47649414212303,-0.1406547075005144,21,20
2068,just_relax,0.2,5,5,0,21.81749383084947,0.3336955484649637,30,35
2069,just_relax,0.2,6,3,3,-10.930358499148142,-0.0241240092787614,71,77
2070,relax_and_recompute,0.25,0,2,-2,-81.33726896832043,-0.2126541467117775,17,18
2071,relax_and_recompute,0.25,21,1,20,4.237249238606971,0.1693599939018287,43,48
2072,relax_and_recompute,0.25,6,3,3,6.441794644751582,0.0167415663815956,38,45
2073,relax_and_recompute,0.25,0,0,0,0.0,-0.2329967787672662,12,12
2074,relax_and_recompute,0.25,25,13,12,-13.777869481870248,0.0104933145276009,23,38
2075,relax_and_recompute,0.25,4,1,3,-20.310338317018434,-0.4026047464719631,19,22
2076,relax_and_recompute,0.25,834,771,63,-0.9644659217748596,0.0565297272444503,35,143
2077,relax_and_recompute,0.25,1,0,1,77.64694222807496,0.0890825586001988,92,91
2078,relax_and_recompute,0.25,14,10,4,-0.8897387951380864,0.2088902077463776,43,51
2079,relax_and_recompute,0.25,0,1,-1,-64.99236072097854,0.2372672525767062,35,36
2080,relax_and_recompute,0.25,0,0,0,0.0,-0.2595568763446073,11,13
2081,relax_and_recompute,0.25,34,13,21,-3.771345973903109,0.2327449052407521,10,25
2082,relax_and_recompute,0.25,26,16,10,-8.454791726693884,-0.0505879794957647,86,136
2083,relax_and_recompute,0.25,0,0,0,0.0,-0.0136281539223993,10,12
2084,relax_and_recompute,0.25,0,0,0,0.0,-0.0169505644403022,32,31
2085,relax_and_recompute,0.25,3,3,0,9.42154016739562,0.2932172616543838,20,26
2086,relax_and_recompute,0.25,1,0,1,74.84264753848886,-0.3339775516413763,11,11
2087,relax_and_recompute,0.25,7,4,3,24.00612073008294,0.0178692978653145,34,42
2088,relax_and_recompute,0.25,11,10,1,0.5013589311989648,0.042064916047235,14,25
2089,relax_and_recompute,0.25,5,6,-1,16.120147917167415,0.0004759716304026,31,46
2090,relax_and_recompute,0.25,0,0,0,0.0,-0.4601403730299978,42,45
2091,relax_and_recompute,0.25,1120,1029,91,0.2251058373963417,0.2010770472893351,39,173
2092,relax_and_recompute,0.25,11,8,3,0.4344989586477226,0.1028923506796605,14,24
2093,relax_and_recompute,0.25,0,0,0,0.0,-0.2886697176523946,24,25
2094,relax_and_recompute,0.25,1,1,0,16.14284972073861,0.1838938537187691,12,19
2095,relax_and_recompute,0.25,82,53,29,-6.005009984359873,0.1620250059772437,41,72
2096,relax_and_recompute,0.25,265,149,116,-1.186519813739615,0.1681002849144471,59,115
2097,relax_and_recompute,0.25,9,3,6,10.885665409023254,0.0678927567471002,32,37
2098,relax_and_recompute,0.25,2,0,2,67.90558475400101,-0.2474167588682092,20,20
2099,relax_and_recompute,0.25,24,27,-3,3.0486571954651964,0.0206609918421351,12,31
2100,relax_and_recompute,0.25,1,1,0,6.68193338759103,-0.0291023112032031,10,10
2101,relax_and_recompute,0.25,0,0,0,0.0,-0.2156481378937711,20,21
2102,relax_and_recompute,0.25,16,18,-2,-4.520538793041226,-0.0314511338222694,39,52
2103,relax_and_recompute,0.25,299,338,-39,1.735065950211201,0.4276460057145551,42,109
2104,relax_and_recompute,0.25,6,0,6,59.682318548428384,-0.2581411998174722,25,28
2105,relax_and_recompute,0.25,259,164,95,-0.551738276204965,0.2228064543620708,56,106
2106,relax_and_recompute,0.25,513,496,17,0.571482040260662,-0.0944552757391571,87,189
2107,relax_and_recompute,0.25,37,75,-38,5.483114989122086,-0.0440432627841965,56,82
2108,relax_and_recompute,0.25,2,1,1,-24.89402820519348,0.0907768407399771,13,15
2109,relax_and_recompute,0.25,80,94,-14,3.010087707337988,0.4176594967795191,36,63
2110,relax_and_recompute,0.25,0,0,0,0.0,-0.3303912237937598,16,15
2111,relax_and_recompute,0.25,0,0,0,0.0,0.41683069388364,67,66
2112,relax_and_recompute,0.25,28,15,13,-9.742200762469388,-0.1152733472030027,42,60
2113,relax_and_recompute,0.25,3,0,3,59.85514159785732,0.3074826605658285,39,38
2114,relax_and_recompute,0.25,16,10,6,-5.63340896201413,0.2382012206822996,20,36
2115,relax_and_recompute,0.25,0,0,0,0.0,0.0806762959403407,10,9
2116,relax_and_recompute,0.25,1,0,1,72.55678488476447,0.1132789241904963,13,15
2117,relax_and_recompute,0.25,3,9,-6,-6.495466486577136,-0.1077899953398796,34,41
2118,relax_and_recompute,0.25,2,3,-1,16.915840038820733,-0.0170574402691801,37,42
2119,relax_and_recompute,0.25,37,26,11,-3.797418617600883,0.2009105270751551,18,29
2120,relax_and_recompute,0.25,0,1,-1,-40.33252481170461,0.1065939478680255,23,22
2121,relax_and_recompute,0.25,0,0,0,0.0,-0.0533324657900906,13,12
2122,relax_and_recompute,0.25,0,0,0,0.0,0.4376712726337476,15,14
2123,relax_and_recompute,0.25,0,0,0,0.0,0.0474495687027034,69,68
2124,relax_and_recompute,0.25,14,0,14,55.89586468852474,0.3033621492958419,40,39
2125,relax_and_recompute,0.25,10,0,10,55.80487117235325,0.0825134919864345,89,93
2126,relax_and_recompute,0.25,8,10,-2,4.908076264715504,-0.1643008081035061,20,32
2127,relax_and_recompute,0.25,8,8,0,19.172163112878863,0.2815199425387426,69,83
2128,relax_and_recompute,0.25,2,3,-1,-0.9441416249300828,-0.1629732920353014,12,15
2129,relax_and_recompute,0.25,0,0,0,0.0,0.3379139338726277,15,14
2130,relax_and_recompute,0.25,6,2,4,-31.44073546923385,0.0467806500245538,23,26
2131,relax_and_recompute,0.25,2,4,-2,9.375408331954745,0.285230590223657,12,20
2132,relax_and_recompute,0.25,226,192,34,-1.6470494249137886,-0.0934699427353352,64,122
2133,relax_and_recompute,0.25,16,7,9,0.3148407026860269,-0.1142269487292276,58,71
2134,relax_and_recompute,0.25,3,0,3,69.91885471703023,-0.2135884737009267,20,19
2135,relax_and_recompute,0.25,298,283,15,-2.942348086634496,-0.0591899374265938,100,191
2136,relax_and_recompute,0.25,34,39,-5,2.951262180786884,-0.0333270101365464,41,61
2137,relax_and_recompute,0.25,35,21,14,-5.461669350301079,-0.08785303247045,13,31
2138,relax_and_recompute,0.25,9,2,7,-21.511331167785087,0.4408493858272128,10,15
2139,relax_and_recompute,0.25,17,9,8,-6.240733849030235,-0.0987035518915526,37,47
2140,relax_and_recompute,0.25,1,0,1,68.98849042489138,-0.2699916630405351,21,21
2141,relax_and_recompute,0.25,0,2,-2,-75.80988798567348,0.0163008991699712,11,10
2142,relax_and_recompute,0.25,50,42,8,-0.4337185142981283,-0.1312346122564531,44,80
2143,relax_and_recompute,0.25,2,3,-1,2.181050392700911,-0.0263329357199633,12,21
2144,relax_and_recompute,0.25,4,6,-2,-4.115370295878982,0.0605131297950289,37,43
2145,relax_and_recompute,0.25,18,30,-12,-1.7221139788828168,0.2955760081730184,41,52
2146,relax_and_recompute,0.25,1,2,-1,9.58425899671515,0.002839237046443,90,89
2147,relax_and_recompute,0.25,0,0,0,0.0,0.1201652494871908,22,21
2148,relax_and_recompute,0.25,4,1,3,-19.248599987258142,0.1522612081847506,37,43
2149,relax_and_recompute,0.25,18,1,17,7.065222266599029,0.1208155748400359,47,47
2150,relax_and_recompute,0.25,4,6,-2,4.015820006864004,-0.1306272381528065,12,20
2151,relax_and_recompute,0.25,147,120,27,-0.3565022686994652,0.1798146736817685,84,124
2152,relax_and_recompute,0.25,0,7,-7,-65.5528204728937,0.1207402627019045,88,92
2153,relax_and_recompute,0.25,289,269,20,0.2277457052406575,0.1726147066503329,59,122
2154,relax_and_recompute,0.25,13,6,7,-5.433934044112277,0.1777620710255067,26,31
2155,relax_and_recompute,0.25,0,0,0,0.0,0.2244188432732614,28,27
2156,relax_and_recompute,0.25,7,4,3,12.98943215193193,0.1363511295705693,18,26
2157,relax_and_recompute,0.25,1,2,-1,17.19043626731596,0.2297240134283961,23,26
2158,relax_and_recompute,0.25,0,1,-1,-74.03114205947199,-0.052205977748846,43,43
2159,relax_and_recompute,0.25,5,2,3,2.907883002246592,-0.0595038554092398,22,26
2160,relax_and_recompute,0.25,0,0,0,0.0,-0.1017686506135679,15,14
2161,relax_and_recompute,0.25,15,9,6,-7.886397727479192,-0.0488600463288806,36,48
2162,relax_and_recompute,0.25,14,4,10,-6.063878879055281,0.1266915689768849,30,37
2163,relax_and_recompute,0.25,0,2,-2,-67.81956280046658,0.1993938978434971,10,13
2164,relax_and_recompute,0.25,0,0,0,0.0,-0.2489058528681162,12,11
2165,relax_and_recompute,0.25,208,204,4,-0.0699383818817622,-0.0361016421275321,55,105
2166,relax_and_recompute,0.25,4,3,1,8.196469048334507,0.0732486195171377,13,17
2167,relax_and_recompute,0.25,2,0,2,57.539933239656136,-0.3721446504572737,30,29
2168,relax_and_recompute,0.25,8,1,7,1.8904417319569544,-0.069158238583795,36,43
2169,relax_and_recompute,0.25,18,13,5,-7.230504364413029,-0.1183659994594703,40,60
2170,relax_and_recompute,0.25,3,1,2,2.7541888905887646,0.0857580204309724,13,17
2171,relax_and_recompute,0.25,13,6,7,-7.941244358058967,0.1423129182511324,23,30
2172,relax_and_recompute,0.25,4,1,3,34.021192522430766,0.1653301553200694,12,16
2173,relax_and_recompute,0.25,1,1,0,21.363665189213123,0.2032439929364399,26,26
2174,relax_and_recompute,0.25,1,1,0,21.5659938019514,0.319410255432923,22,31
2175,relax_and_recompute,0.25,0,0,0,0.0,-0.0427622413694439,68,68
2176,relax_and_recompute,0.25,0,0,0,0.0,-0.065512233983344,23,22
2177,relax_and_recompute,0.25,0,0,0,0.0,0.1200444987982425,43,42
2178,relax_and_recompute,0.25,0,1,-1,-54.99912407635851,0.0095586597616658,18,17
2179,relax_and_recompute,0.25,17,5,12,-8.078828528110591,-0.0565140901572382,28,42
2180,relax_and_recompute,0.25,38,44,-6,-5.259656622938799,0.1137931279685903,21,44
2181,relax_and_recompute,0.25,4,0,4,61.1190560402916,-0.2310495882588597,36,37
2182,relax_and_recompute,0.25,0,0,0,0.0,-0.0580186151076248,15,14
2183,relax_and_recompute,0.25,1,2,-1,14.016550010878971,0.15313832807087,14,16
2184,relax_and_recompute,0.25,245,188,57,-0.8672239480764574,-0.0607069588401518,61,119
2185,relax_and_recompute,0.25,0,0,0,0.0,-0.0318064734401472,19,20
2186,relax_and_recompute,0.25,1,0,1,32.39563720672864,-0.1147457500312256,22,22
2187,relax_and_recompute,0.25,4,3,1,-16.678746199366856,-0.1484094546708284,54,58
2188,relax_and_recompute,0.25,517,404,113,-1.7468687886066263,0.1165986243202259,65,135
2189,relax_and_recompute,0.25,0,2,-2,-78.80420232787941,-0.1569168571760402,16,18
2190,relax_and_recompute,0.25,5,5,0,14.34867514382075,-0.0570794349062401,17,27
2191,relax_and_recompute,0.25,18,9,9,-2.326008037224888,-0.1131969456206497,54,71
2192,relax_and_recompute,0.25,1,0,1,81.89022851122331,-0.1871448277194521,23,22
2193,relax_and_recompute,0.25,0,0,0,0.0,-0.0417168097074303,13,16
2194,relax_and_recompute,0.25,211,133,78,1.7314958065990922,0.0826054458068491,85,131
2195,relax_and_recompute,0.25,27,38,-11,1.2234605589669627,-0.1212893844679847,28,55
2196,relax_and_recompute,0.25,3,4,-1,13.048730490562876,0.6346062844975866,18,24
2197,relax_and_recompute,0.25,3,1,2,-7.428131251872003,-0.0350215408036939,19,22
2198,relax_and_recompute,0.25,6,0,6,64.13603759576371,0.3435622020409246,47,46
2199,relax_and_recompute,0.25,59,25,34,-6.6597083984153045,-0.3428185867564728,39,64
2200,relax_and_recompute,0.25,0,0,0,0.0,0.1869975754450076,17,18
2201,relax_and_recompute,0.25,1,1,0,5.994170020787934,0.0877590543344876,23,24
2202,relax_and_recompute,0.25,1,1,0,-1.518561814949024,0.0253934002765082,13,16
2203,relax_and_recompute,0.25,37,21,16,4.868917252432723,0.1137382288416074,40,56
2204,relax_and_recompute,0.25,1,2,-1,-14.138250851183416,0.3792368013331478,10,15
2205,relax_and_recompute,0.25,0,0,0,0.0,0.1771834671164504,21,20
2206,relax_and_recompute,0.25,3,3,0,4.386886701832282,-0.0720835220736121,30,35
2207,relax_and_recompute,0.25,3,1,2,9.276496554825428,-0.3058722596755874,71,77
2208,relax_one,0.25,0,0,0,0.0,0.0776287563124831,17,18
2209,relax_one,0.25,6,5,1,17.48124535722816,-0.1468787443283221,43,48
2210,relax_one,0.25,4,8,-4,-2.0450296507841443,-0.1373088466754418,38,45
2211,relax_one,0.25,0,0,0,0.0,0.0291839218191015,12,12
2212,relax_one,0.25,22,3,19,-18.799342144847337,-0.0554093364782544,23,38
2213,relax_one,0.25,1,0,1,70.25364449076187,-0.0335970923528109,19,22
2214,relax_one,0.25,765,770,-5,-1.0672041105196757,0.1104619530945947,35,143
2215,relax_one,0.25,3,1,2,-15.352920107172054,-0.0439698022113541,92,91
2216,relax_one,0.25,2,2,0,7.47402978675278,-0.0833346749129839,43,51
2217,relax_one,0.25,0,3,-3,-79.70719572309298,0.1026596418984003,35,36
2218,relax_one,0.25,1,1,0,28.216779090271693,0.1136074620613751,11,13
2219,relax_one,0.25,28,14,14,2.099240431131093,0.1712820990506304,10,25
2220,relax_one,0.25,35,17,18,2.3325568312616696,-0.2509957346461495,86,136
2221,relax_one,0.25,0,0,0,0.0,-0.1346913323523926,10,12
2222,relax_one,0.25,0,0,0,0.0,0.0887567395047987,32,31
2223,relax_one,0.25,2,3,-1,-3.767310346508737,0.0415460775891484,20,26
2224,relax_one,0.25,3,0,3,78.99768388662478,-0.0622494671941207,11,11
2225,relax_one,0.25,8,6,2,-14.160261512016476,0.0529076484874248,34,42
2226,relax_one,0.25,10,9,1,-4.909672664767115,0.1615512346359141,14,25
2227,relax_one,0.25,8,8,0,6.880244730629613,0.1340283236389415,31,46
2228,relax_one,0.25,0,1,-1,-52.43649093934721,0.063064468317972,42,45
2229,relax_one,0.25,1169,1180,-11,-0.1165907600513875,0.0964947571929294,39,173
2230,relax_one,0.25,8,14,-6,6.521444568609397,-0.0599002607178875,14,24
2231,relax_one,0.25,0,0,0,0.0,0.1459628444974684,24,25
2232,relax_one,0.25,1,1,0,0.6717585677302651,0.0283816455799242,12,19
2233,relax_one,0.25,67,58,9,-1.005812924748298,-0.261253855131204,41,72
2234,relax_one,0.25,179,166,13,4.264651575572302,0.0062423392942529,59,115
2235,relax_one,0.25,4,4,0,7.464664790012947,0.0368848069357627,32,37
2236,relax_one,0.25,3,0,3,70.30140013984267,-0.2718803671475904,20,20
2237,relax_one,0.25,17,23,-6,-7.495841102668166,-0.0797220681159888,12,31
2238,relax_one,0.25,1,0,1,43.405734516065536,0.3674441780320938,10,10
2239,relax_one,0.25,1,0,1,65.7981700318796,0.1286087167865914,20,21
2240,relax_one,0.25,19,31,-12,12.898411928419584,0.0057341369959312,39,52
2241,relax_one,0.25,405,373,32,-2.2375560480708856,-0.3885519254132852,42,109
2242,relax_one,0.25,0,5,-5,-69.62913453659749,-0.1692781628429505,25,28
2243,relax_one,0.25,186,184,2,-2.019225141045524,0.0909368337244402,56,106
2244,relax_one,0.25,463,438,25,1.722120808435072,-0.1714241496855393,87,189
2245,relax_one,0.25,44,44,0,6.866113739991071,-0.0145781066252856,56,82
2246,relax_one,0.25,2,2,0,-20.43670491180535,0.0849442064096341,13,15
2247,relax_one,0.25,110,87,23,1.318599103315286,-0.0039358156004389,36,63
2248,relax_one,0.25,0,0,0,0.0,-0.0725302557849392,16,15
2249,relax_one,0.25,0,0,0,0.0,-0.0315895748861031,67,66
2250,relax_one,0.25,15,15,0,-7.4624399303741455,-0.2800168891949278,42,60
2251,relax_one,0.25,1,0,1,61.54421232487529,-0.0212606543849003,39,38
2252,relax_one,0.25,8,14,-6,17.44791986834423,0.0545612160622799,20,36
2253,relax_one,0.25,1,1,0,47.40491157503268,-0.4795134161940035,10,9
2254,relax_one,0.25,1,1,0,22.02137747631292,0.0244128743828427,13,15
2255,relax_one,0.25,3,9,-6,-3.3933106925810392,0.1408795736405832,34,41
2256,relax_one,0.25,8,4,4,14.338348136353034,0.0797869231109997,37,42
2257,relax_one,0.25,35,14,21,3.1381386740548294,0.0652732045749926,18,29
2258,relax_one,0.25,1,0,1,61.21542610662054,0.2336258547614356,23,22
2259,relax_one,0.25,0,0,0,0.0,0.391933704401215,13,12
2260,relax_one,0.25,0,0,0,0.0,0.1194717537212315,15,14
2261,relax_one,0.25,0,0,0,0.0,0.003402807214889,69,68
2262,relax_one,0.25,0,0,0,0.0,0.3936099904203933,40,39
2263,relax_one,0.25,3,2,1,15.72471821571596,-0.0159141716293839,89,93
2264,relax_one,0.25,10,15,-5,-16.05610437040967,0.1159327457204172,20,32
2265,relax_one,0.25,2,4,-2,27.198461057240493,-0.2306892334223573,69,83
2266,relax_one,0.25,1,1,0,4.665747610186728,0.0716908726312659,12,15
2267,relax_one,0.25,0,0,0,0.0,0.2378133379005327,15,14
2268,relax_one,0.25,0,3,-3,-77.26396633865669,-0.1139943771186638,23,26
2269,relax_one,0.25,3,2,1,-20.68120715625774,0.1649660367597266,12,20
2270,relax_one,0.25,230,217,13,2.010010732255367,0.2230667475096166,64,122
2271,relax_one,0.25,6,12,-6,-6.683993084537882,0.076484440409311,58,71
2272,relax_one,0.25,0,0,0,0.0,-0.085444306488065,20,19
2273,relax_one,0.25,255,346,-91,2.9006387618276435,0.0207608258283146,100,191
2274,relax_one,0.25,19,26,-7,4.228680963530024,-0.0270697535030567,41,61
2275,relax_one,0.25,17,22,-5,3.249620444857769,-0.0687424508029517,13,31
2276,relax_one,0.25,2,5,-3,9.272112617626236,0.3713626216310658,10,15
2277,relax_one,0.25,25,10,15,-18.54645133815857,0.4426241991478993,37,47
2278,relax_one,0.25,2,0,2,68.75538082307429,-0.1692228410778137,21,21
2279,relax_one,0.25,2,0,2,76.01217023873568,0.0162188447779871,11,10
2280,relax_one,0.25,65,79,-14,-1.000639362566659,0.0759092736855102,44,80
2281,relax_one,0.25,4,3,1,-27.79623629383704,-0.1280725635062072,12,21
2282,relax_one,0.25,2,0,2,74.51932589072756,-0.1923690927212326,37,43
2283,relax_one,0.25,15,3,12,-11.383905745373625,0.219790340706125,41,52
2284,relax_one,0.25,1,0,1,80.4746046441547,0.0228795001267245,90,89
2285,relax_one,0.25,0,0,0,0.0,0.090902496926832,22,21
2286,relax_one,0.25,2,7,-5,-7.431438001981476,0.1521301287260762,37,43
2287,relax_one,0.25,2,2,0,-18.684485592896262,-0.2139710171760463,47,47
2288,relax_one,0.25,5,11,-6,3.733529904035919,-0.2017245983500257,12,20
2289,relax_one,0.25,108,107,1,-0.0497198862059349,0.0150951259018721,84,124
2290,relax_one,0.25,6,6,0,9.516974513547297,-0.0345204340097664,88,92
2291,relax_one,0.25,420,349,71,-1.70858676825533,0.2317632084161143,59,122
2292,relax_one,0.25,16,5,11,-7.174498225938223,-0.1545380666529257,26,31
2293,relax_one,0.25,0,0,0,0.0,0.1663378563076152,28,27
2294,relax_one,0.25,5,3,2,14.358984859479513,-0.1535418276447576,18,26
2295,relax_one,0.25,1,2,-1,16.182479246680508,-0.2180759233838817,23,26
2296,relax_one,0.25,2,0,2,76.71253259025434,-0.141532453103185,43,43
2297,relax_one,0.25,2,1,1,16.5308413207171,0.2541189266524541,22,26
2298,relax_one,0.25,0,0,0,0.0,0.1645157698135404,15,14
2299,relax_one,0.25,15,9,6,-5.584010814038081,0.32944227863914,36,48
2300,relax_one,0.25,5,7,-2,6.174552377325384,0.0062060876021327,30,37
2301,relax_one,0.25,3,4,-1,-13.857829105664791,0.4510853919801166,10,13
2302,relax_one,0.25,0,0,0,0.0,-0.1584007652674538,12,11
2303,relax_one,0.25,216,227,-11,-1.6560289350922943,0.1391721298067578,55,105
2304,relax_one,0.25,3,2,1,0.6104247533433664,0.0567843498468583,13,17
2305,relax_one,0.25,0,3,-3,-54.1785039566926,-0.0216885720482397,30,29
2306,relax_one,0.25,4,1,3,-16.76162996434116,0.0084360614291906,36,43
2307,relax_one,0.25,24,13,11,4.6448331443287,0.0979831955389017,40,60
2308,relax_one,0.25,0,1,-1,-86.60686230195817,0.0802622739077643,13,17
2309,relax_one,0.25,13,14,-1,4.158559968606838,-0.2679806406467103,23,30
2310,relax_one,0.25,2,0,2,62.85671419196068,-0.0535356437827103,12,16
2311,relax_one,0.25,0,0,0,0.0,0.0277747000580065,26,26
2312,relax_one,0.25,2,2,0,16.19649640245015,-0.0377359668389095,22,31
2313,relax_one,0.25,8,2,6,-24.53408224871332,-0.1614076658223852,68,68
2314,relax_one,0.25,0,0,0,0.0,-0.0701077773802967,23,22
2315,relax_one,0.25,0,0,0,0.0,-0.1147819802947603,43,42
2316,relax_one,0.25,0,0,0,0.0,-0.0853202969334886,18,17
2317,relax_one,0.25,5,26,-21,9.473626442313638,-0.411980590552165,28,42
2318,relax_one,0.25,35,45,-10,4.201555861908055,0.0801928805326817,21,44
2319,relax_one,0.25,1,0,1,72.43074367796606,0.0226847536221583,36,37
2320,relax_one,0.25,0,0,0,0.0,-0.2113689672665488,15,14
2321,relax_one,0.25,1,2,-1,3.1737044809302404,0.220434693014575,14,16
2322,relax_one,0.25,261,191,70,-0.4839357848229113,-0.0321858988641885,61,119
2323,relax_one,0.25,0,0,0,0.0,0.3425929884527919,19,20
2324,relax_one,0.25,0,0,0,0.0,0.0156446501928674,22,22
2325,relax_one,0.25,0,0,0,0.0,0.1348303828043506,54,58
2326,relax_one,0.25,464,491,-27,-0.0044543993108234,0.2897114876608395,65,135
2327,relax_one,0.25,2,0,2,64.58777964814576,0.2730605985484516,16,18
2328,relax_one,0.25,8,8,0,-1.546564572962069,-0.0312979770416047,17,27
2329,relax_one,0.25,18,11,7,7.196333788709119,0.0337344982099575,54,71
2330,relax_one,0.25,0,0,0,0.0,0.1661609436473926,23,22
2331,relax_one,0.25,0,1,-1,-55.07278497454714,-0.0170308175374318,13,16
2332,relax_one,0.25,143,139,4,-0.1729702577648595,-0.0145210946604429,85,131
2333,relax_one,0.25,45,47,-2,-4.850083062038699,0.291728265947311,28,55
2334,relax_one,0.25,2,2,0,-8.382302250503628,-0.0206973356668599,18,24
2335,relax_one,0.25,1,2,-1,20.94996606536209,0.2045007204874719,19,22
2336,relax_one,0.25,1,0,1,67.73695436669614,0.0555911088907309,47,46
2337,relax_one,0.25,36,25,11,-1.2745199850553917,0.5038291302486944,39,64
2338,relax_one,0.25,0,1,-1,-66.05976036277946,0.0268286514309405,17,18
2339,relax_one,0.25,1,1,0,8.841218333929987,-0.0693764860908721,23,24
2340,relax_one,0.25,2,1,1,-12.697076986823332,0.2399461929428572,13,16
2341,relax_one,0.25,15,25,-10,-12.766668698753952,0.1513765795802848,40,56
2342,relax_one,0.25,2,1,1,0.9723255622776604,0.4879572409522256,10,15
2343,relax_one,0.25,0,0,0,0.0,0.5340528163271707,21,20
2344,relax_one,0.25,4,1,3,7.120679643999139,-0.1640824733236543,30,35
2345,relax_one,0.25,2,6,-4,-22.71285108631863,-0.0404641760374203,71,77
2346,just_relax,0.25,0,3,-3,-74.81077738860618,0.1072211018199923,17,18
2347,just_relax,0.25,9,11,-2,1.3860521267504566,-0.1127743276965036,43,48
2348,just_relax,0.25,6,10,-4,15.068701943132794,0.0923750645388766,38,45
2349,just_relax,0.25,1,0,1,85.64547121659238,-0.2115278300662464,12,12
2350,just_relax,0.25,19,19,0,4.936133201394654,-0.1596634406596156,23,38
2351,just_relax,0.25,1,0,1,66.06770494117373,0.0685395075872684,19,22
2352,just_relax,0.25,937,772,165,-0.8716883189382685,0.0403388858143022,35,143
2353,just_relax,0.25,3,2,1,-5.564735410376485,-0.0506415972867096,92,91
2354,just_relax,0.25,7,63,-56,10.361785660208788,-0.0050516122747101,43,51
2355,just_relax,0.25,6,0,6,64.04392925233418,0.0754669813712012,35,36
2356,just_relax,0.25,0,0,0,0.0,-0.0647228287036396,11,13
2357,just_relax,0.25,26,25,1,7.099709265664316,-0.1329097665055967,10,25
2358,just_relax,0.25,21,64,-43,13.244468690235363,0.247819592181798,86,136
2359,just_relax,0.25,0,0,0,0.0,-0.2104216986012441,10,12
2360,just_relax,0.25,0,0,0,0.0,-0.0139835766806921,32,31
2361,just_relax,0.25,8,3,5,5.260915322829504,0.0939317382803055,20,26
2362,just_relax,0.25,0,0,0,0.0,-0.5404605202736688,11,11
2363,just_relax,0.25,3,12,-9,13.51891940183168,0.2027703133929359,34,42
2364,just_relax,0.25,13,21,-8,15.675575951649058,0.3024487396505128,14,25
2365,just_relax,0.25,15,15,0,2.494744277739251,0.0870499382302671,31,46
2366,just_relax,0.25,3,12,-9,-3.545110642334386,0.0021135688720145,42,45
2367,just_relax,0.25,1263,1173,90,0.9185267376751654,-0.2382756403586565,39,173
2368,just_relax,0.25,16,12,4,2.612033544481534,0.4047646366466807,14,24
2369,just_relax,0.25,2,1,1,-15.635001372199198,-0.1572363054944469,24,25
2370,just_relax,0.25,1,1,0,13.994787523052524,-0.1701567431261252,12,19
2371,just_relax,0.25,51,56,-5,-1.263307485718066,-0.0132159111194409,41,72
2372,just_relax,0.25,146,242,-96,5.139170391588955,0.2574735607696713,59,115
2373,just_relax,0.25,5,8,-3,8.54019232207024,-0.1431258723733465,32,37
2374,just_relax,0.25,5,1,4,-21.022167874089703,-0.1701762594296691,20,20
2375,just_relax,0.25,21,23,-2,0.2967722978343659,0.1115600646349231,12,31
2376,just_relax,0.25,0,0,0,0.0,-0.159886347130942,10,10
2377,just_relax,0.25,0,0,0,0.0,-0.5409789763183739,20,21
2378,just_relax,0.25,14,43,-29,2.633038072113081,-0.0487429399749219,39,52
2379,just_relax,0.25,392,326,66,2.816119004057228,-0.0835076723773988,42,109
2380,just_relax,0.25,2,1,1,-1.149705041400125,0.0114582740282505,25,28
2381,just_relax,0.25,210,247,-37,1.326858048572113,-0.0429940826079269,56,106
2382,just_relax,0.25,477,769,-292,10.717871937970097,-0.1994676828307368,87,189
2383,just_relax,0.25,43,48,-5,-0.406884107717488,0.0886910436025083,56,82
2384,just_relax,0.25,0,5,-5,-69.19220024851253,-0.1359767764001007,13,15
2385,just_relax,0.25,86,100,-14,5.8994023106596885,-0.0421093369013779,36,63
2386,just_relax,0.25,0,0,0,0.0,0.178603132654445,16,15
2387,just_relax,0.25,0,0,0,0.0,0.0839123917351676,67,66
2388,just_relax,0.25,24,21,3,-2.669309242593912,0.0164291940970755,42,60
2389,just_relax,0.25,0,1,-1,-61.24029437097239,-0.2278993966676891,39,38
2390,just_relax,0.25,8,11,-3,16.255763033246737,0.1432288412154987,20,36
2391,just_relax,0.25,0,0,0,0.0,0.0876378153005628,10,9
2392,just_relax,0.25,1,0,1,56.020365020087056,-0.0781741338969792,13,15
2393,just_relax,0.25,12,5,7,0.7992731756928606,0.0105837968702958,34,41
2394,just_relax,0.25,13,4,9,6.778581909465061,0.1790486090747238,37,42
2395,just_relax,0.25,28,28,0,-2.190104342341968,-0.0519197932119952,18,29
2396,just_relax,0.25,0,5,-5,-68.01725579604138,-0.1234416303867531,23,22
2397,just_relax,0.25,0,0,0,0.0,0.1235141659542955,13,12
2398,just_relax,0.25,0,1,-1,-82.30684509869678,0.0755380678822389,15,14
2399,just_relax,0.25,1,0,1,22.250540658980825,-0.1418994033073746,69,68
2400,just_relax,0.25,1,1,0,2.476760354212331,0.4405711287751728,40,39
2401,just_relax,0.25,0,1,-1,-45.653745053499655,-0.3168309398411292,89,93
2402,just_relax,0.25,15,18,-3,-1.8303301476572784,0.0027319966467629,20,32
2403,just_relax,0.25,4,4,0,-14.1172519792663,0.0229595026578044,69,83
2404,just_relax,0.25,2,1,1,-5.943478877064393,-0.0452826456204114,12,15
2405,just_relax,0.25,1,0,1,74.60051544805248,-0.0321649406052558,15,14
2406,just_relax,0.25,0,0,0,0.0,-0.1083760197859173,23,26
2407,just_relax,0.25,5,2,3,-15.309669282857527,0.1655962103949044,12,20
2408,just_relax,0.25,197,219,-22,2.4990232878211813,-0.0456035705564054,64,122
2409,just_relax,0.25,22,7,15,13.952869084862606,-0.076750429113645,58,71
2410,just_relax,0.25,0,1,-1,-43.70003434905199,-0.164068440483584,20,19
2411,just_relax,0.25,297,358,-61,-0.0191975711805838,-0.0805957258520737,100,191
2412,just_relax,0.25,32,51,-19,11.5688449239953,-0.2285463709509104,41,61
2413,just_relax,0.25,25,40,-15,12.712501163747524,0.018525509868653,13,31
2414,just_relax,0.25,4,4,0,15.818080672635505,-0.1132736367827101,10,15
2415,just_relax,0.25,9,6,3,2.2492957932065,0.1946914393352969,37,47
2416,just_relax,0.25,1,1,0,-3.1600644801485345,-0.2335415817387574,21,21
2417,just_relax,0.25,0,0,0,0.0,-0.0690183302627879,11,10
2418,just_relax,0.25,47,35,12,1.096036291987616,0.3699408054160122,44,80
2419,just_relax,0.25,3,3,0,5.004709973843575,0.1259283993595835,12,21
2420,just_relax,0.25,7,0,7,56.553081021372215,-0.0981697196662946,37,43
2421,just_relax,0.25,5,7,-2,-2.360323304426913,-0.0303257502113826,41,52
2422,just_relax,0.25,0,4,-4,-63.44662708699219,0.2003501771099443,90,89
2423,just_relax,0.25,2,0,2,66.76203019828353,0.2547531614389472,22,21
2424,just_relax,0.25,8,15,-7,13.930763243531068,0.1028956322738093,37,43
2425,just_relax,0.25,1,8,-7,26.975682333973808,-0.0943926947821205,47,47
2426,just_relax,0.25,6,4,2,-22.617262636948418,0.132722041374007,12,20
2427,just_relax,0.25,138,133,5,2.473757283277834,0.1681643541204388,84,124
2428,just_relax,0.25,2,6,-4,-24.110848813702383,0.045666392778125,88,92
2429,just_relax,0.25,438,421,17,-1.431354190939814,-0.1181915687939249,59,122
2430,just_relax,0.25,3,7,-4,-4.628596870512496,0.5264505270180008,26,31
2431,just_relax,0.25,0,0,0,0.0,0.0087388492583938,28,27
2432,just_relax,0.25,4,3,1,14.043780052951384,0.1503644050889983,18,26
2433,just_relax,0.25,4,6,-2,-2.8558153452522106,-0.0355631712599422,23,26
2434,just_relax,0.25,1,1,0,11.059413324366702,-0.1079823234489798,43,43
2435,just_relax,0.25,1,3,-2,-28.00442280378772,-0.0625795804435653,22,26
2436,just_relax,0.25,0,0,0,0.0,0.3330595983200947,15,14
2437,just_relax,0.25,11,26,-15,11.510899395983536,0.2163897741316836,36,48
2438,just_relax,0.25,10,3,7,-10.761178928181067,0.3439783035339363,30,37
2439,just_relax,0.25,1,1,0,-2.193346584755517,0.1255408547278818,10,13
2440,just_relax,0.25,0,1,-1,-86.75835933794522,-0.0708681660347825,12,11
2441,just_relax,0.25,155,230,-75,4.348466642731417,-0.2629996705103672,55,105
2442,just_relax,0.25,1,3,-2,9.21414805390576,0.1714011217554646,13,17
2443,just_relax,0.25,1,2,-1,45.09369385038595,0.0071774643311498,30,29
2444,just_relax,0.25,3,8,-5,4.417625713873733,-0.3392543419275242,36,43
2445,just_relax,0.25,19,20,-1,-1.7068256267089623,-0.0726170605469143,40,60
2446,just_relax,0.25,1,0,1,48.56425621651408,0.1655035310934226,13,17
2447,just_relax,0.25,6,11,-5,20.015310699467847,0.2267131153262342,23,30
2448,just_relax,0.25,1,0,1,56.01525446826277,-0.2011093185666209,12,16
2449,just_relax,0.25,1,2,-1,8.364142057467433,0.4889967512017536,26,26
2450,just_relax,0.25,0,0,0,0.0,0.2273163953183989,22,31
2451,just_relax,0.25,0,4,-4,-69.34665394951645,-0.0642039035688393,68,68
2452,just_relax,0.25,0,0,0,0.0,0.0267169647516722,23,22
2453,just_relax,0.25,0,2,-2,-23.7624974943289,0.1003034852804424,43,42
2454,just_relax,0.25,1,0,1,86.14320854838935,0.1436602932387761,18,17
2455,just_relax,0.25,3,11,-8,-1.5400901851615885,0.0611383573247594,28,42
2456,just_relax,0.25,52,52,0,-4.707860768419913,0.2481746077124118,21,44
2457,just_relax,0.25,2,1,1,15.060652683927742,0.1252404085740157,36,37
2458,just_relax,0.25,0,0,0,0.0,0.0805779803710755,15,14
2459,just_relax,0.25,1,0,1,88.12462361651748,-0.0094276338808885,14,16
2460,just_relax,0.25,178,248,-70,-0.8528492928308822,0.0246777089612668,61,119
2461,just_relax,0.25,0,0,0,0.0,0.1871971533206284,19,20
2462,just_relax,0.25,1,2,-1,1.2125390412466288,0.127862951186529,22,22
2463,just_relax,0.25,3,9,-6,17.952648210647773,0.1618308513256238,54,58
2464,just_relax,0.25,488,997,-509,4.841837976527451,-0.0989406215437985,65,135
2465,just_relax,0.25,0,0,0,0.0,-0.0603000331630569,16,18
2466,just_relax,0.25,9,8,1,0.5425387318975083,-0.0499429610457061,17,27
2467,just_relax,0.25,7,36,-29,-3.420211875452388,0.0202982521444355,54,71
2468,just_relax,0.25,0,0,0,0.0,0.1893957140760478,23,22
2469,just_relax,0.25,1,0,1,57.01171708291014,-0.0913573147179063,13,16
2470,just_relax,0.25,227,303,-76,1.8920502202003675,-0.116925212177166,85,131
2471,just_relax,0.25,35,42,-7,0.8310796916932333,-0.0819623361530169,28,55
2472,just_relax,0.25,10,7,3,-0.3363289398102438,-0.0150508407343359,18,24
2473,just_relax,0.25,0,0,0,0.0,-0.5232785614116637,19,22
2474,just_relax,0.25,3,0,3,77.83875479355113,0.1128187671574394,47,46
2475,just_relax,0.25,51,82,-31,1.2571040604038188,-0.1417791185452245,39,64
2476,just_relax,0.25,2,0,2,61.36122985752073,0.2621006859568602,17,18
2477,just_relax,0.25,2,2,0,-11.2522209493699,-0.4982844674260684,23,24
2478,just_relax,0.25,2,1,1,1.3360572537296491,-0.4487264491436084,13,16
2479,just_relax,0.25,14,60,-46,13.586834895202555,0.4933051318282616,40,56
2480,just_relax,0.25,1,1,0,-6.834953626221349,0.5028049138763441,10,15
2481,just_relax,0.25,0,0,0,0.0,0.3872649726987471,21,20
2482,just_relax,0.25,1,8,-7,12.100921645954635,0.2274277738384148,30,35
2483,just_relax,0.25,2,3,-1,-19.456339417085445,0.0708384482291404,71,77
2484,relax_and_recompute,0.3,0,0,0,0.0,0.1876350197777969,17,18
2485,relax_and_recompute,0.3,6,8,-2,-1.8184750745257503,-0.1343967388951793,43,48
2486,relax_and_recompute,0.3,7,0,7,70.11558004781126,-0.0079722357426237,38,45
2487,relax_and_recompute,0.3,0,1,-1,-77.7685297590254,0.221159044478678,12,12
2488,relax_and_recompute,0.3,11,6,5,-4.3366618655793445,0.2176123700097869,23,38
2489,relax_and_recompute,0.3,1,1,0,-26.576965462542887,0.0184813807545201,19,22
2490,relax_and_recompute,0.3,889,793,96,-0.8532497115030466,0.0046521456603638,35,143
2491,relax_and_recompute,0.3,2,3,-1,23.928180214972947,0.1422299398460926,92,91
2492,relax_and_recompute,0.3,8,8,0,-1.9966265909782093,-0.1136962169694192,43,51
2493,relax_and_recompute,0.3,0,4,-4,-70.82026826223844,0.1705033934769264,35,36
2494,relax_and_recompute,0.3,1,0,1,73.72251946512922,-0.2943334188396077,11,13
2495,relax_and_recompute,0.3,20,14,6,-0.7187066274954077,-0.2497702222810386,10,25
2496,relax_and_recompute,0.3,26,31,-5,8.689686477746939,0.0697231744833145,86,136
2497,relax_and_recompute,0.3,0,0,0,0.0,0.1935999345108823,10,12
2498,relax_and_recompute,0.3,0,0,0,0.0,-0.0457598357917359,32,31
2499,relax_and_recompute,0.3,2,3,-1,-2.104487913635488,-0.0133037177156157,20,26
2500,relax_and_recompute,0.3,1,1,0,-8.971273961588494,0.2782525532825124,11,11
2501,relax_and_recompute,0.3,2,2,0,-14.592863028458396,-0.2352905341894281,34,42
2502,relax_and_recompute,0.3,13,11,2,-0.2495800078681611,0.2005137468564487,14,25
2503,relax_and_recompute,0.3,15,4,11,-6.782650572403085,-0.0621132413393262,31,46
2504,relax_and_recompute,0.3,6,1,5,-28.772767885483297,-0.0074322215622767,42,45
2505,relax_and_recompute,0.3,1118,1072,46,-0.3890874433825289,-0.1748778031673172,39,173
2506,relax_and_recompute,0.3,9,12,-3,-4.110350351705087,0.3208189635263436,14,24
2507,relax_and_recompute,0.3,0,0,0,0.0,0.163876288800937,24,25
2508,relax_and_recompute,0.3,1,1,0,-16.1539304908451,0.235040277590152,12,19
2509,relax_and_recompute,0.3,59,56,3,-5.183843725093098,0.0708671671226718,41,72
2510,relax_and_recompute,0.3,207,154,53,-3.036358385067622,-0.0007259018138131,59,115
2511,relax_and_recompute,0.3,12,4,8,-3.528556976233148,0.1656265125020387,32,37
2512,relax_and_recompute,0.3,0,0,0,0.0,-0.3315358431151266,20,20
2513,relax_and_recompute,0.3,28,27,1,3.923251663172991,-0.2665626300063246,12,31
2514,relax_and_recompute,0.3,2,0,2,84.25034571312474,0.1198438110191724,10,10
2515,relax_and_recompute,0.3,0,0,0,0.0,0.1736711403508817,20,21
2516,relax_and_recompute,0.3,28,12,16,-9.03028416838439,0.0168298460701836,39,52
2517,relax_and_recompute,0.3,349,358,-9,-0.7618178196852696,0.326630212687816,42,109
2518,relax_and_recompute,0.3,7,0,7,61.381624535381135,0.347880419469401,25,28
2519,relax_and_recompute,0.3,207,207,0,0.6281037947869734,0.0059728755841351,56,106
2520,relax_and_recompute,0.3,500,458,42,-0.1042112850826555,-0.0388684454504151,87,189
2521,relax_and_recompute,0.3,56,39,17,-0.3376136475575322,-0.0846889461488928,56,82
2522,relax_and_recompute,0.3,1,1,0,-1.9166106591147385,-0.0921815355750199,13,15
2523,relax_and_recompute,0.3,146,62,84,-2.2001002574247224,-0.1500916853414233,36,63
2524,relax_and_recompute,0.3,1,1,0,-15.765533734527324,-0.2111141448417183,16,15
2525,relax_and_recompute,0.3,0,0,0,0.0,0.0258652710633072,67,66
2526,relax_and_recompute,0.3,27,15,12,-0.7950600739814888,0.2247304440955314,42,60
2527,relax_and_recompute,0.3,0,0,0,0.0,-0.3669985104631672,39,38
2528,relax_and_recompute,0.3,9,12,-3,6.192241502220099,-0.4060901929662606,20,36
2529,relax_and_recompute,0.3,0,0,0,0.0,0.3702531499669222,10,9
2530,relax_and_recompute,0.3,0,1,-1,-70.3179792199671,0.374194904222911,13,15
2531,relax_and_recompute,0.3,5,11,-6,-6.500732295029806,0.0466184416888471,34,41
2532,relax_and_recompute,0.3,6,4,2,-6.253739016651039,0.4668011028101245,37,42
2533,relax_and_recompute,0.3,20,16,4,7.00822754910584,0.3305191271589822,18,29
2534,relax_and_recompute,0.3,0,1,-1,-67.73088991273595,-0.1941763668584201,23,22
2535,relax_and_recompute,0.3,0,0,0,0.0,0.5510156539580358,13,12
2536,relax_and_recompute,0.3,0,1,-1,-88.36214527701065,0.0423600021769604,15,14
2537,relax_and_recompute,0.3,0,0,0,0.0,-0.1434591012970716,69,68
2538,relax_and_recompute,0.3,2,0,2,72.47154624377251,-0.0607633007598801,40,39
2539,relax_and_recompute,0.3,0,0,0,0.0,0.0914618465468481,89,93
2540,relax_and_recompute,0.3,13,12,1,-3.3752371943821373,-0.0373948434575754,20,32
2541,relax_and_recompute,0.3,6,2,4,5.777704177778489,0.2910335587182915,69,83
2542,relax_and_recompute,0.3,2,1,1,8.260282983452925,0.0512722194902547,12,15
2543,relax_and_recompute,0.3,0,0,0,0.0,0.1915363359284648,15,14
2544,relax_and_recompute,0.3,6,0,6,67.2829217656593,-0.5218465062630484,23,26
2545,relax_and_recompute,0.3,4,4,0,3.8474064664139433,0.0001097865552466,12,20
2546,relax_and_recompute,0.3,245,221,24,0.9305129243128292,0.2816264523588989,64,122
2547,relax_and_recompute,0.3,13,1,12,10.47604441352332,-0.0907446472332185,58,71
2548,relax_and_recompute,0.3,0,0,0,0.0,0.2440158028433627,20,19
2549,relax_and_recompute,0.3,328,285,43,0.1361804507117625,0.0017164015008308,100,191
2550,relax_and_recompute,0.3,40,32,8,-6.212602719595395,0.0933779281225121,41,61
2551,relax_and_recompute,0.3,21,22,-1,-2.807652233432705,-0.1386398595307485,13,31
2552,relax_and_recompute,0.3,4,2,2,1.4180113489494488,0.2422060058509771,10,15
2553,relax_and_recompute,0.3,18,5,13,-10.195278903659826,0.2234972785001466,37,47
2554,relax_and_recompute,0.3,0,1,-1,-55.272159019679805,-0.1588422425279025,21,21
2555,relax_and_recompute,0.3,0,0,0,0.0,-0.3092621974967925,11,10
2556,relax_and_recompute,0.3,40,50,-10,-0.8517747072209758,-0.2771775261422443,44,80
2557,relax_and_recompute,0.3,3,2,1,0.2188374394452807,-0.0106711155782468,12,21
2558,relax_and_recompute,0.3,6,0,6,68.39315993958282,0.0548573057261891,37,43
2559,relax_and_recompute,0.3,4,16,-12,-2.621852831024043,0.046851582111582,41,52
2560,relax_and_recompute,0.3,5,1,4,-12.001921146649067,0.1119818450701201,90,89
2561,relax_and_recompute,0.3,2,0,2,63.81850126655389,-0.2234858667875415,22,21
2562,relax_and_recompute,0.3,22,3,19,-1.211835008954722,-0.0003231794056086,37,43
2563,relax_and_recompute,0.3,0,0,0,0.0,-0.3156781444716683,47,47
2564,relax_and_recompute,0.3,8,6,2,-7.0438975822115,0.3992933484489508,12,20
2565,relax_and_recompute,0.3,126,102,24,-4.713973279149393,0.2780504113370793,84,124
2566,relax_and_recompute,0.3,2,1,1,63.95403635211909,-0.0696491126293294,88,92
2567,relax_and_recompute,0.3,396,321,75,0.9177669765588874,0.1652028479527897,59,122
2568,relax_and_recompute,0.3,3,2,1,17.877284655034885,-0.0115484196345946,26,31
2569,relax_and_recompute,0.3,0,0,0,0.0,-0.0351895149887938,28,27
2570,relax_and_recompute,0.3,19,4,15,-0.2521742290594915,-0.1002843530760546,18,26
2571,relax_and_recompute,0.3,3,2,1,18.444736231852,0.071502809893724,23,26
2572,relax_and_recompute,0.3,1,1,0,-12.717789736718627,-0.1604304501272737,43,43
2573,relax_and_recompute,0.3,2,3,-1,0.3612382410995849,-0.0496781912205986,22,26
2574,relax_and_recompute,0.3,0,0,0,0.0,0.1353201838748823,15,14
2575,relax_and_recompute,0.3,13,12,1,16.45423181680369,0.1262444716781916,36,48
2576,relax_and_recompute,0.3,16,2,14,9.462429188468192,0.2684871241624591,30,37
2577,relax_and_recompute,0.3,2,3,-1,-2.3351038843482144,-0.2215567978218035,10,13
2578,relax_and_recompute,0.3,2,0,2,74.34396922894527,0.0473527229697766,12,11
2579,relax_and_recompute,0.3,202,183,19,1.1295646308672644,-0.1154460127176986,55,105
2580,relax_and_recompute,0.3,2,0,2,78.99071317135594,-0.1046290041124158,13,17
2581,relax_and_recompute,0.3,1,1,0,31.083799550989703,0.0404106040945708,30,29
2582,relax_and_recompute,0.3,12,0,12,71.91943281455046,0.221197640656539,36,43
2583,relax_and_recompute,0.3,25,17,8,9.714927208775435,0.28155421842491,40,60
2584,relax_and_recompute,0.3,1,2,-1,20.432109831143592,0.4911423490959104,13,17
2585,relax_and_recompute,0.3,11,8,3,1.1732921466246893,-0.2314219638087455,23,30
2586,relax_and_recompute,0.3,0,1,-1,-26.57826979562401,0.1643013477203365,12,16
2587,relax_and_recompute,0.3,2,1,1,2.6862688349427515,-0.1265052393567058,26,26
2588,relax_and_recompute,0.3,6,3,3,3.890833826982771,0.0479188256499555,22,31
2589,relax_and_recompute,0.3,2,0,2,67.71442452440525,-0.1136764712696351,68,68
2590,relax_and_recompute,0.3,0,0,0,0.0,-0.0438444247201422,23,22
2591,relax_and_recompute,0.3,0,0,0,0.0,0.0165445923160674,43,42
2592,relax_and_recompute,0.3,0,2,-2,-61.57823297577673,0.0266778213427706,18,17
2593,relax_and_recompute,0.3,13,6,7,-0.9581790479320772,-0.1999060964831148,28,42
2594,relax_and_recompute,0.3,93,46,47,-2.456728572490292,0.0449186494040745,21,44
2595,relax_and_recompute,0.3,2,0,2,87.72034408089687,0.0285525254027384,36,37
2596,relax_and_recompute,0.3,0,0,0,0.0,-0.058260783844608,15,14
2597,relax_and_recompute,0.3,1,0,1,82.88899501455225,-0.2586606475793883,14,16
2598,relax_and_recompute,0.3,213,196,17,-3.210446428159571,-0.0452202511645903,61,119
2599,relax_and_recompute,0.3,0,0,0,0.0,-0.2476015296518325,19,20
2600,relax_and_recompute,0.3,0,0,0,0.0,-0.1291613017064872,22,22
2601,relax_and_recompute,0.3,1,1,0,-2.3657515956892183,-0.0109531249744465,54,58
2602,relax_and_recompute,0.3,502,427,75,-0.5450891666210822,0.2042050621138451,65,135
2603,relax_and_recompute,0.3,0,0,0,0.0,0.0606456100545254,16,18
2604,relax_and_recompute,0.3,4,5,-1,7.056273119102755,0.0032629214389618,17,27
2605,relax_and_recompute,0.3,13,11,2,2.8181073927722053,0.4175148687727377,54,71
2606,relax_and_recompute,0.3,0,0,0,0.0,-0.0300845426001299,23,22
2607,relax_and_recompute,0.3,2,0,2,79.52651757694443,-0.2307287192845827,13,16
2608,relax_and_recompute,0.3,133,138,-5,2.31027306340561,0.0334239274124413,85,131
2609,relax_and_recompute,0.3,32,40,-8,6.742081070368457,0.1834456543438364,28,55
2610,relax_and_recompute,0.3,2,2,0,9.63389858658499,-0.0758128535561397,18,24
2611,relax_and_recompute,0.3,1,2,-1,-4.506428769699383,-0.125926493844089,19,22
2612,relax_and_recompute,0.3,3,0,3,82.12298496453224,0.0827482082380414,47,46
2613,relax_and_recompute,0.3,28,28,0,-1.4300671611624978,-0.2931024539676323,39,64
2614,relax_and_recompute,0.3,1,0,1,74.3025606009657,-0.5811790466205073,17,18
2615,relax_and_recompute,0.3,3,1,2,22.84025879581148,0.0816610020525331,23,24
2616,relax_and_recompute,0.3,2,2,0,9.99901870431411,0.0142016291849919,13,16
2617,relax_and_recompute,0.3,31,13,18,7.078373818120539,-0.1102783357575163,40,56
2618,relax_and_recompute,0.3,1,1,0,12.19302254023627,-0.179755583459211,10,15
2619,relax_and_recompute,0.3,1,1,0,-9.278844146135953,0.057668178068007,21,20
2620,relax_and_recompute,0.3,7,1,6,-2.9591095852571527,0.404666476711582,30,35
2621,relax_and_recompute,0.3,2,3,-1,13.567728071069851,0.0187016723873659,71,77
2622,relax_one,0.3,0,0,0,0.0,-0.2195647988730966,17,18
2623,relax_one,0.3,9,4,5,9.914235164643737,0.0902497602330277,43,48
2624,relax_one,0.3,5,3,2,-7.185656705260684,-0.0054602553397958,38,45
2625,relax_one,0.3,0,1,-1,-83.27601957961788,0.2824758411453479,12,12
2626,relax_one,0.3,28,9,19,-5.226159494543751,0.0524373307162104,23,38
2627,relax_one,0.3,1,1,0,17.511906773061057,0.0096803624455529,19,22
2628,relax_one,0.3,899,851,48,0.754811166648544,0.1145468810078788,35,143
2629,relax_one,0.3,6,4,2,-0.170859589937308,0.1222099641776247,92,91
2630,relax_one,0.3,3,18,-15,-2.35488485779468,0.0738771034432077,43,51
2631,relax_one,0.3,1,1,0,-55.32494009293114,-0.2325575078028151,35,36
2632,relax_one,0.3,1,0,1,86.64627451352372,0.0428290638135294,11,13
2633,relax_one,0.3,19,24,-5,2.72902838808335,-0.0072229755876684,10,25
2634,relax_one,0.3,14,23,-9,2.9180016502410666,0.194871700001353,86,136
2635,relax_one,0.3,0,0,0,0.0,-0.0358669069730134,10,12
2636,relax_one,0.3,0,0,0,0.0,0.0395182737703427,32,31
2637,relax_one,0.3,16,3,13,-8.159277025393628,0.0160912406707258,20,26
2638,relax_one,0.3,0,1,-1,-89.74987644296665,-0.0312204486596098,11,11
2639,relax_one,0.3,12,7,5,-3.9705576810163294,0.0709569131522667,34,42
2640,relax_one,0.3,12,9,3,-11.400246416811632,0.055751970148873,14,25
2641,relax_one,0.3,11,17,-6,-2.8198471599881927,0.0350929666596561,31,46
2642,relax_one,0.3,3,0,3,63.69946561418873,-0.0337459959814536,42,45
2643,relax_one,0.3,1078,1136,-58,0.639225265391822,-0.0033225860034409,39,173
2644,relax_one,0.3,11,9,2,1.1102928628667,0.1673638934773937,14,24
2645,relax_one,0.3,0,0,0,0.0,-0.0141440283402882,24,25
2646,relax_one,0.3,1,1,0,68.12961042624964,-0.1651899897321372,12,19
2647,relax_one,0.3,70,50,20,-3.4104382823499435,-0.0254530954323423,41,72
2648,relax_one,0.3,207,162,45,2.458140676186865,-0.1480107417597909,59,115
2649,relax_one,0.3,6,7,-1,4.217396162789044,0.1316898474674673,32,37
2650,relax_one,0.3,0,0,0,0.0,-0.1557493005418179,20,20
2651,relax_one,0.3,29,26,3,4.592351203797051,0.0082418392213512,12,31
2652,relax_one,0.3,1,2,-1,27.54940960892321,-0.1804678331675318,10,10
2653,relax_one,0.3,1,1,0,1.3112701324333074,-0.3463446816982887,20,21
2654,relax_one,0.3,28,18,10,3.5944997450398333,-0.100590609744422,39,52
2655,relax_one,0.3,356,348,8,-3.48162558410678,0.1766273243285611,42,109
2656,relax_one,0.3,1,4,-3,27.842314744584822,-0.0112172061527059,25,28
2657,relax_one,0.3,214,241,-27,-1.6256513088140423,0.1203722361228023,56,106
2658,relax_one,0.3,470,441,29,-1.316770458615629,-0.1441833062842739,87,189
2659,relax_one,0.3,32,41,-9,4.292943260259079,-0.0702361021233515,56,82
2660,relax_one,0.3,2,0,2,69.64158348004526,-0.2219134939052668,13,15
2661,relax_one,0.3,80,80,0,-0.6362692728444159,0.1572212234771575,36,63
2662,relax_one,0.3,0,1,-1,-83.30706604877719,0.0911345194883411,16,15
2663,relax_one,0.3,0,0,0,0.0,0.2613263838684819,67,66
2664,relax_one,0.3,16,16,0,-4.9582093042759965,-0.0143286622892034,42,60
2665,relax_one,0.3,1,0,1,87.47726268594228,-0.0650052742262329,39,38
2666,relax_one,0.3,16,10,6,9.19702255855887,0.1105185843513408,20,36
2667,relax_one,0.3,1,0,1,71.72779470033784,-0.1224904686231371,10,9
2668,relax_one,0.3,0,3,-3,-69.24460977806747,0.5386011125878838,13,15
2669,relax_one,0.3,8,12,-4,0.2616793381077826,-0.0797065138398647,34,41
2670,relax_one,0.3,3,4,-1,13.74956259515968,0.1713071935088453,37,42
2671,relax_one,0.3,32,24,8,3.1757537033351326,0.3566889616809735,18,29
2672,relax_one,0.3,0,1,-1,-76.89581872062942,0.2244655727432172,23,22
2673,relax_one,0.3,0,0,0,0.0,-0.2522131588129113,13,12
2674,relax_one,0.3,0,0,0,0.0,0.2249797431071227,15,14
2675,relax_one,0.3,1,0,1,60.38343722077461,-0.0294941823086161,69,68
2676,relax_one,0.3,0,16,-16,-50.57353182218936,-0.0299910922684912,40,39
2677,relax_one,0.3,0,1,-1,-12.490180812361514,0.1605516296262688,89,93
2678,relax_one,0.3,8,12,-4,5.150264005271126,0.1003382663201809,20,32
2679,relax_one,0.3,2,1,1,18.63915227971536,0.0431927487393549,69,83
2680,relax_one,0.3,1,1,0,18.265847152212388,0.096441499866848,12,15
2681,relax_one,0.3,0,1,-1,-53.529586595461865,0.1607370852161304,15,14
2682,relax_one,0.3,6,1,5,5.072396277536818,-0.1856501752237361,23,26
2683,relax_one,0.3,2,4,-2,18.493024484658093,-0.2689069216570493,12,20
2684,relax_one,0.3,240,195,45,-6.472946411198564,-0.0227775833470195,64,122
2685,relax_one,0.3,16,19,-3,10.503122346284664,0.0066788813768196,58,71
2686,relax_one,0.3,0,0,0,0.0,0.0197908328603829,20,19
2687,relax_one,0.3,338,268,70,2.317452721065109,0.002531690650976,100,191
2688,relax_one,0.3,29,52,-23,-9.0841477991642,-0.266362529536535,41,61
2689,relax_one,0.3,23,17,6,-3.509245101575729,0.1213045249065356,13,31
2690,relax_one,0.3,4,3,1,-5.966997111669869,-0.0515496266521259,10,15
2691,relax_one,0.3,10,5,5,6.709374192332717,-0.0949051891115748,37,47
2692,relax_one,0.3,1,0,1,71.66631923970326,-0.0656744956847782,21,21
2693,relax_one,0.3,0,0,0,0.0,0.015611044520336,11,10
2694,relax_one,0.3,59,48,11,-3.315663145097048,-0.123283459405899,44,80
2695,relax_one,0.3,8,4,4,6.757276275969431,-0.0265523579820208,12,21
2696,relax_one,0.3,0,2,-2,-54.23020381917621,0.1911047963250353,37,43
2697,relax_one,0.3,14,6,8,-0.4685891403009208,-0.0827161991881512,41,52
2698,relax_one,0.3,1,0,1,70.70017194636526,-0.067578450088082,90,89
2699,relax_one,0.3,1,0,1,84.63064094043217,0.3302867173255405,22,21
2700,relax_one,0.3,3,0,3,45.41232690560434,0.0131944743831061,37,43
2701,relax_one,0.3,7,2,5,-23.50374380569447,-0.0476384366564016,47,47
2702,relax_one,0.3,4,4,0,9.77100882207769,0.0686386282500567,12,20
2703,relax_one,0.3,120,116,4,-0.673350106378507,0.2277308206449806,84,124
2704,relax_one,0.3,0,2,-2,-75.74894577190997,0.3263118230118097,88,92
2705,relax_one,0.3,391,382,9,1.9196383295142423,0.0729153613042251,59,122
2706,relax_one,0.3,5,3,2,-8.96010381686878,-0.0029496603886401,26,31
2707,relax_one,0.3,0,0,0,0.0,-0.3677873644386858,28,27
2708,relax_one,0.3,7,2,5,5.85869960457611,0.1644604999830416,18,26
2709,relax_one,0.3,7,1,6,-10.685503021357675,-0.1723617338458258,23,26
2710,relax_one,0.3,1,0,1,85.0688040129611,-0.065438449768559,43,43
2711,relax_one,0.3,1,4,-3,0.176358256128438,0.3013331130960648,22,26
2712,relax_one,0.3,0,0,0,0.0,0.1970228065899458,15,14
2713,relax_one,0.3,15,14,1,-1.6776174002570698,0.1039537477292228,36,48
2714,relax_one,0.3,6,4,2,-20.5699322485514,-0.0840377474556115,30,37
2715,relax_one,0.3,2,1,1,-7.421931718192965,-0.2871225758122563,10,13
2716,relax_one,0.3,0,0,0,0.0,-0.1834873525784671,12,11
2717,relax_one,0.3,212,164,48,0.2400457554853901,-0.2273106555788998,55,105
2718,relax_one,0.3,0,0,0,0.0,-0.0004808715448465,13,17
2719,relax_one,0.3,0,1,-1,-58.54356666983252,0.2729896740552407,30,29
2720,relax_one,0.3,3,2,1,5.87668771719089,0.3680562620027378,36,43
2721,relax_one,0.3,16,20,-4,5.273905603814768,0.0437542842793186,40,60
2722,relax_one,0.3,0,1,-1,-72.88483495931018,0.0102190010519321,13,17
2723,relax_one,0.3,9,7,2,12.349467399659268,-0.1804378743483393,23,30
2724,relax_one,0.3,3,1,2,24.330780464876497,0.0392793690223992,12,16
2725,relax_one,0.3,0,0,0,0.0,-0.2364755319289032,26,26
2726,relax_one,0.3,1,2,-1,1.1296568452553828,0.0536811828053495,22,31
2727,relax_one,0.3,1,1,0,-7.458479668828595,-0.0295290034189248,68,68
2728,relax_one,0.3,0,0,0,0.0,-0.0704235974975279,23,22
2729,relax_one,0.3,0,0,0,0.0,0.0666433754240866,43,42
2730,relax_one,0.3,0,0,0,0.0,0.0506723729591165,18,17
2731,relax_one,0.3,12,9,3,0.4509896176620529,-0.1016615049036457,28,42
2732,relax_one,0.3,41,51,-10,-2.128677113745141,0.013466705076483,21,44
2733,relax_one,0.3,0,0,0,0.0,-0.1710018884178149,36,37
2734,relax_one,0.3,0,0,0,0.0,0.1262007290730126,15,14
2735,relax_one,0.3,0,2,-2,-83.70982544983062,-0.0057095097197717,14,16
2736,relax_one,0.3,232,177,55,-1.2392800241557893,-0.129760189399242,61,119
2737,relax_one,0.3,0,0,0,0.0,-0.1254064854578825,19,20
2738,relax_one,0.3,1,0,1,53.85820447040953,-0.1801266767755948,22,22
2739,relax_one,0.3,6,1,5,5.1261876579070815,-0.0131868559942998,54,58
2740,relax_one,0.3,393,435,-42,0.3741950991365286,0.0035069755499493,65,135
2741,relax_one,0.3,2,2,0,30.31005143085237,0.2493141552894886,16,18
2742,relax_one,0.3,10,6,4,-17.171868823109378,0.2353678060342692,17,27
2743,relax_one,0.3,10,13,-3,7.7514517800715055,0.1929444949046967,54,71
2744,relax_one,0.3,2,0,2,68.17815086545158,-0.3637983349014025,23,22
2745,relax_one,0.3,1,0,1,66.28999300762649,0.039670419670918,13,16
2746,relax_one,0.3,145,130,15,-0.2696724278599447,-0.0187898675411628,85,131
2747,relax_one,0.3,31,35,-4,4.839835717279783,0.3725009082829512,28,55
2748,relax_one,0.3,6,5,1,5.637295490285922,0.1413199858004932,18,24
2749,relax_one,0.3,2,0,2,83.80351974929522,-0.0617831689838775,19,22
2750,relax_one,0.3,1,0,1,33.58514030275189,0.0012150522058442,47,46
2751,relax_one,0.3,43,35,8,-9.7174059367117,-0.0950397172742002,39,64
2752,relax_one,0.3,3,0,3,74.41034698375294,0.3021716976197575,17,18
2753,relax_one,0.3,3,1,2,6.244250955774135,-0.2901589554463614,23,24
2754,relax_one,0.3,8,3,5,-7.901881874098862,0.1311153682388661,13,16
2755,relax_one,0.3,27,21,6,3.7657938695224544,-0.1427281058989642,40,56
2756,relax_one,0.3,1,2,-1,0.5632166343158502,0.375186907188566,10,15
2757,relax_one,0.3,0,0,0,0.0,0.0715447130549412,21,20
2758,relax_one,0.3,8,6,2,-3.6344521425719294,0.0425594721391924,30,35
2759,relax_one,0.3,21,3,18,9.347455033924431,0.5923088864147101,71,77
2760,just_relax,0.3,1,0,1,89.7534475753788,0.0030147422862166,17,18
2761,just_relax,0.3,3,5,-2,12.77338679851475,-0.1048086345738474,43,48
2762,just_relax,0.3,12,9,3,-5.0176186994399785,-0.1157261638459872,38,45
2763,just_relax,0.3,0,0,0,0.0,0.0921684796146172,12,12
2764,just_relax,0.3,15,18,-3,0.8999801456368743,-0.3125014767559382,23,38
2765,just_relax,0.3,0,1,-1,-76.62461206307921,0.4991443194122439,19,22
2766,just_relax,0.3,757,650,107,-0.5721131493094873,-0.1858350533701303,35,143
2767,just_relax,0.3,4,12,-8,-2.5533500913700493,-0.0740409500161572,92,91
2768,just_relax,0.3,7,24,-17,3.4576134747685217,-0.0482240900696389,43,51
2769,just_relax,0.3,7,1,6,41.50921576089646,-0.0794299377661401,35,36
2770,just_relax,0.3,1,0,1,88.12555546288957,0.340463782279064,11,13
2771,just_relax,0.3,23,20,3,16.016885227993434,-0.1262565297690874,10,25
2772,just_relax,0.3,23,19,4,11.965458046161018,0.1112092171122867,86,136
2773,just_relax,0.3,1,0,1,36.37601726733377,0.0530396461504293,10,12
2774,just_relax,0.3,0,0,0,0.0,0.0854761809407835,32,31
2775,just_relax,0.3,2,4,-2,-16.8932236161576,-0.1814703337443236,20,26
2776,just_relax,0.3,0,0,0,0.0,-0.237372511104088,11,11
2777,just_relax,0.3,17,18,-1,-3.2975360270615823,0.0602062796791229,34,42
2778,just_relax,0.3,14,13,1,28.153718160118487,-0.1876889617662387,14,25
2779,just_relax,0.3,13,9,4,1.1381505802818737,0.2147681558156611,31,46
2780,just_relax,0.3,0,0,0,0.0,-0.1136182319477093,42,45
2781,just_relax,0.3,1219,1116,103,-0.95689406733203,-0.0584531181352735,39,173
2782,just_relax,0.3,11,8,3,-8.833232756641614,0.5170470609347385,14,24
2783,just_relax,0.3,1,0,1,87.02071940652509,0.2299160024230686,24,25
2784,just_relax,0.3,4,2,2,-6.013868794918977,-0.20165134414757,12,19
2785,just_relax,0.3,76,72,4,1.3743504546421832,0.0861571887367164,41,72
2786,just_relax,0.3,220,219,1,7.284012550768232,-0.1334130680844246,59,115
2787,just_relax,0.3,10,8,2,-2.4388140344318145,-0.0445098596220094,32,37
2788,just_relax,0.3,0,0,0,0.0,-0.0043022818496581,20,20
2789,just_relax,0.3,26,17,9,-2.054527064922155,0.0416085317136913,12,31
2790,just_relax,0.3,0,0,0,0.0,0.2461883843046891,10,10
2791,just_relax,0.3,1,0,1,65.35890360595786,-0.0153257985809753,20,21
2792,just_relax,0.3,20,34,-14,6.655651279286559,0.1380811816470348,39,52
2793,just_relax,0.3,365,359,6,1.9560767995138804,-0.4694298427037563,42,109
2794,just_relax,0.3,0,0,0,0.0,0.5005313934926673,25,28
2795,just_relax,0.3,237,359,-122,2.768320603823128,-0.0462646798045485,56,106
2796,just_relax,0.3,439,622,-183,13.1958636580312,0.0844644389059439,87,189
2797,just_relax,0.3,35,42,-7,-4.323764342266038,0.2091970234369805,56,82
2798,just_relax,0.3,1,1,0,-33.16640308194195,-0.0844961186456272,13,15
2799,just_relax,0.3,76,109,-33,6.1764262056308965,0.0327101218696285,36,63
2800,just_relax,0.3,0,0,0,0.0,-0.0489328939684067,16,15
2801,just_relax,0.3,0,0,0,0.0,-0.3572650332124409,67,66
2802,just_relax,0.3,17,15,2,-8.356588343430943,-0.0813993968482905,42,60
2803,just_relax,0.3,0,1,-1,-67.60717681399099,-0.2086871493754563,39,38
2804,just_relax,0.3,13,9,4,-12.0296362872704,-0.2003785401247222,20,36
2805,just_relax,0.3,1,0,1,78.5371114802351,-0.0238179203930247,10,9
2806,just_relax,0.3,0,0,0,0.0,0.2987291034491454,13,15
2807,just_relax,0.3,19,10,9,14.18826360789889,0.1630919385030012,34,41
2808,just_relax,0.3,5,3,2,6.560246581428231,0.3289196087562643,37,42
2809,just_relax,0.3,13,20,-7,-10.806173308311138,0.0642563802139999,18,29
2810,just_relax,0.3,1,0,1,78.26883244828075,0.2361170545623664,23,22
2811,just_relax,0.3,0,0,0,0.0,-0.0816730584066545,13,12
2812,just_relax,0.3,0,0,0,0.0,0.0458633506620563,15,14
2813,just_relax,0.3,1,0,1,70.5564198077025,0.0059911223091962,69,68
2814,just_relax,0.3,0,0,0,0.0,-0.143403893271347,40,39
2815,just_relax,0.3,18,1,17,43.60262874953271,0.0112830801243486,89,93
2816,just_relax,0.3,12,18,-6,10.39749436266699,-0.1174804279580703,20,32
2817,just_relax,0.3,5,4,1,17.022698493301228,0.1199865274450646,69,83
2818,just_relax,0.3,1,4,-3,-11.802879083506497,0.1097999035525337,12,15
2819,just_relax,0.3,0,0,0,0.0,-0.0824597744807511,15,14
2820,just_relax,0.3,4,1,3,-14.393241971065947,0.0239073410196222,23,26
2821,just_relax,0.3,4,2,2,-20.108003378029665,-0.5091668249666683,12,20
2822,just_relax,0.3,197,216,-19,-0.542425794332253,-0.1535288345154523,64,122
2823,just_relax,0.3,4,11,-7,17.779419524176262,0.11705822664688,58,71
2824,just_relax,0.3,1,0,1,63.098635235629466,-0.2907924963055046,20,19
2825,just_relax,0.3,350,366,-16,4.651918288368513,-0.0483324294922314,100,191
2826,just_relax,0.3,24,30,-6,7.779882153556294,-0.0627571508727671,41,61
2827,just_relax,0.3,20,34,-14,14.912748665669994,0.0188504363983403,13,31
2828,just_relax,0.3,2,2,0,19.52336249051403,-0.0661196590534142,10,15
2829,just_relax,0.3,15,5,10,4.994500510621656,0.2870433446280755,37,47
2830,just_relax,0.3,1,0,1,82.28675321636959,0.0939402592690518,21,21
2831,just_relax,0.3,1,0,1,86.56713914287376,-0.3828595418944588,11,10
2832,just_relax,0.3,46,56,-10,2.139887924569841,0.0143205520186903,44,80
2833,just_relax,0.3,2,2,0,3.707687282843296,-0.0222672676848971,12,21
2834,just_relax,0.3,2,1,1,-14.505203382121016,-0.0336224596524432,37,43
2835,just_relax,0.3,13,6,7,-7.024307294393125,-0.1304186808018071,41,52
2836,just_relax,0.3,2,1,1,26.579634538067275,-0.0566560746673886,90,89
2837,just_relax,0.3,0,0,0,0.0,-0.1736358447578058,22,21
2838,just_relax,0.3,5,3,2,6.345886198097865,-0.0317062664112005,37,43
2839,just_relax,0.3,1,5,-4,45.70359055657971,0.326091209480201,47,47
2840,just_relax,0.3,5,4,1,2.363719682234091,0.0410912338925302,12,20
2841,just_relax,0.3,134,122,12,-0.8307163874201962,-0.2861460624689806,84,124
2842,just_relax,0.3,6,1,5,16.370454644965264,-0.3646902402890843,88,92
2843,just_relax,0.3,310,451,-141,1.112685787191218,-0.0946395310533645,59,122
2844,just_relax,0.3,6,9,-3,-2.667617186997198,0.0138418922017002,26,31
2845,just_relax,0.3,0,0,0,0.0,-0.3647528162943715,28,27
2846,just_relax,0.3,7,5,2,-2.8978255731167195,0.1332557267970654,18,26
2847,just_relax,0.3,4,2,2,-4.591148066269852,0.2741754865145454,23,26
2848,just_relax,0.3,1,1,0,-23.5522927194315,-0.0662801835846538,43,43
2849,just_relax,0.3,5,0,5,62.563300403900186,-0.0797996107496903,22,26
2850,just_relax,0.3,0,0,0,0.0,-0.0248911364123294,15,14
2851,just_relax,0.3,14,21,-7,-2.4940213170636696,-0.1498747993469611,36,48
2852,just_relax,0.3,19,7,12,-0.3271416686408628,0.3502687258517452,30,37
2853,just_relax,0.3,3,1,2,-10.630755358645118,0.0237774353533531,10,13
2854,just_relax,0.3,1,0,1,80.35601243715952,0.1821242105150934,12,11
2855,just_relax,0.3,202,213,-11,2.027805537973542,0.0234784641067009,55,105
2856,just_relax,0.3,0,1,-1,-69.39561759684379,0.1511123500937059,13,17
2857,just_relax,0.3,0,1,-1,-73.3667136011874,-0.0768806972538458,30,29
2858,just_relax,0.3,6,8,-2,-30.089227651773257,-0.0950315935539517,36,43
2859,just_relax,0.3,20,26,-6,-6.060800182009025,-0.1936645289899649,40,60
2860,just_relax,0.3,3,1,2,12.433962280094484,0.5449408556637715,13,17
2861,just_relax,0.3,11,13,-2,-15.62624839570153,0.001221171851061,23,30
2862,just_relax,0.3,0,1,-1,-71.45950786628146,-0.0443016304794289,12,16
2863,just_relax,0.3,2,1,1,13.411611788775986,-0.0716227977278504,26,26
2864,just_relax,0.3,2,2,0,7.382657235868521,-0.3204505061335658,22,31
2865,just_relax,0.3,2,1,1,-21.61591918765301,0.1715698424987359,68,68
2866,just_relax,0.3,0,0,0,0.0,0.0049073967958132,23,22
2867,just_relax,0.3,0,2,-2,-74.1186285315649,0.0258826265692387,43,42
2868,just_relax,0.3,0,0,0,0.0,0.4624556885269049,18,17
2869,just_relax,0.3,11,2,9,-0.6752590051946186,-0.0867024928897306,28,42
2870,just_relax,0.3,41,63,-22,-0.1092080930499861,-0.5098891283945441,21,44
2871,just_relax,0.3,3,4,-1,-10.436868596412523,-0.2887989853056902,36,37
2872,just_relax,0.3,0,0,0,0.0,-0.1689387961941513,15,14
2873,just_relax,0.3,0,3,-3,-68.99921623744542,0.1161003391345072,14,16
2874,just_relax,0.3,232,307,-75,1.0134744900390231,0.0518660426283962,61,119
2875,just_relax,0.3,0,0,0,0.0,0.0392245673789957,19,20
2876,just_relax,0.3,5,0,5,69.23208058518608,0.1212618936876843,22,22
2877,just_relax,0.3,0,19,-19,-49.911608637621136,0.0792881937750843,54,58
2878,just_relax,0.3,537,867,-330,5.623530968713766,-0.0114931234306294,65,135
2879,just_relax,0.3,1,2,-1,-1.2439201685914298,0.1762888378097442,16,18
2880,just_relax,0.3,6,7,-1,15.94358415525162,0.0356191168549702,17,27
2881,just_relax,0.3,15,18,-3,-2.1060030686194366,0.0788940779504711,54,71
2882,just_relax,0.3,0,1,-1,-79.14019327632275,-0.4080308185561592,23,22
2883,just_relax,0.3,1,1,0,58.76593045717779,0.0999962377988256,13,16
2884,just_relax,0.3,165,260,-95,-0.4321192378710705,-0.0859042034265744,85,131
2885,just_relax,0.3,33,40,-7,-0.6124761780810388,0.1933641524037752,28,55
2886,just_relax,0.3,2,2,0,-10.909886823987804,-0.3967682292940253,18,24
2887,just_relax,0.3,1,1,0,48.93095788697921,0.0631115252104721,19,22
2888,just_relax,0.3,0,4,-4,-70.32655603635536,-0.0217936383161991,47,46
2889,just_relax,0.3,46,51,-5,12.195662963467669,-0.0553843055072557,39,64
2890,just_relax,0.3,0,2,-2,-82.82943046724807,-0.1653483160064068,17,18
2891,just_relax,0.3,4,2,2,19.773245320352583,-0.0707984679652852,23,24
2892,just_relax,0.3,1,1,0,-11.880952710918136,0.0237724570614545,13,16
2893,just_relax,0.3,24,16,8,-10.572317069609449,-0.1168144639474113,40,56
2894,just_relax,0.3,0,1,-1,-84.09119883628875,-0.2070722472049069,10,15
2895,just_relax,0.3,0,1,-1,-54.77038449849815,-0.2049270522517284,21,20
2896,just_relax,0.3,5,3,2,-0.1207589550805607,-0.1446928642391272,30,35
2897,just_relax,0.3,4,12,-8,-11.999169271391224,0.0341946900211231,71,77
2898,relax_and_recompute,0.35,0,0,0,0.0,-0.1415903931005164,17,18
2899,relax_and_recompute,0.35,8,6,2,15.653056357601514,-0.1093503324785925,43,48
2900,relax_and_recompute,0.35,6,3,3,-8.768843432249,-0.1902620868814171,38,45
2901,relax_and_recompute,0.35,0,0,0,0.0,-0.3283471162553921,12,12
2902,relax_and_recompute,0.35,10,3,7,-13.177597090304983,-0.1062073165795788,23,38
2903,relax_and_recompute,0.35,1,0,1,62.54219608669183,-0.0474553439347767,19,22
2904,relax_and_recompute,0.35,900,819,81,-0.8186894152168449,0.1405862700246638,35,143
2905,relax_and_recompute,0.35,2,2,0,19.7073906108932,0.048581865876995,92,91
2906,relax_and_recompute,0.35,8,3,5,1.0422384111880303,-0.1005179496912567,43,51
2907,relax_and_recompute,0.35,1,0,1,46.68080625319661,-0.1017703479331347,35,36
2908,relax_and_recompute,0.35,1,0,1,67.15473532693035,0.0202196709920772,11,13
2909,relax_and_recompute,0.35,13,17,-4,2.0696552344103623,-0.03728288762246,10,25
2910,relax_and_recompute,0.35,48,14,34,-12.204831548924815,0.2021640067585131,86,136
2911,relax_and_recompute,0.35,0,0,0,0.0,-0.0477304953953771,10,12
2912,relax_and_recompute,0.35,0,0,0,0.0,0.1287317189098697,32,31
2913,relax_and_recompute,0.35,4,3,1,22.80117850946269,-0.0961143968345622,20,26
2914,relax_and_recompute,0.35,3,0,3,78.10111950052368,0.3928247755279789,11,11
2915,relax_and_recompute,0.35,11,6,5,2.528529354934733,-0.0065365592253573,34,42
2916,relax_and_recompute,0.35,10,15,-5,-1.3957013617788334,-0.2727313799346089,14,25
2917,relax_and_recompute,0.35,14,6,8,-8.806548005196035,0.1211496447691586,31,46
2918,relax_and_recompute,0.35,1,0,1,74.29163318153348,0.0380473381259259,42,45
2919,relax_and_recompute,0.35,1174,1099,75,0.3329854545567485,-0.1040536190202283,39,173
2920,relax_and_recompute,0.35,17,8,9,-1.1489421750320332,0.0697345678612172,14,24
2921,relax_and_recompute,0.35,0,0,0,0.0,0.0981496451936245,24,25
2922,relax_and_recompute,0.35,2,1,1,-0.9293776569152924,-0.328247104823833,12,19
2923,relax_and_recompute,0.35,58,57,1,-4.568969540584384,0.1008448305958776,41,72
2924,relax_and_recompute,0.35,169,160,9,1.2956771208750268,-0.1740693215103697,59,115
2925,relax_and_recompute,0.35,6,4,2,-5.844421592620414,0.4063080893713332,32,37
2926,relax_and_recompute,0.35,0,1,-1,-83.12884400219164,0.0657321867649283,20,20
2927,relax_and_recompute,0.35,26,22,4,2.482452172083356,-0.1674400809330248,12,31
2928,relax_and_recompute,0.35,1,0,1,79.81904384033123,0.1701391688917692,10,10
2929,relax_and_recompute,0.35,1,1,0,66.6998193867166,-0.3918332811769582,20,21
2930,relax_and_recompute,0.35,35,15,20,8.16540129236273,-0.1139342736700397,39,52
2931,relax_and_recompute,0.35,354,325,29,-1.1389304921371275,-0.2957380661578412,42,109
2932,relax_and_recompute,0.35,0,2,-2,-84.05789657432952,0.1470751489999484,25,28
2933,relax_and_recompute,0.35,180,222,-42,-1.3962656772381976,0.0001770042203834,56,106
2934,relax_and_recompute,0.35,462,416,46,0.1470271391711861,-0.2879567299636016,87,189
2935,relax_and_recompute,0.35,57,47,10,2.054226541619116,-0.0980571817531285,56,82
2936,relax_and_recompute,0.35,2,1,1,-1.4411904401327291,0.1381613370415574,13,15
2937,relax_and_recompute,0.35,96,60,36,1.5446364253943372,0.1245089228648652,36,63
2938,relax_and_recompute,0.35,1,0,1,71.46814901600942,0.0489605928123629,16,15
2939,relax_and_recompute,0.35,0,0,0,0.0,0.1088233463466201,67,66
2940,relax_and_recompute,0.35,19,16,3,4.941291656029407,0.048380044913867,42,60
2941,relax_and_recompute,0.35,0,0,0,0.0,0.0463586196564438,39,38
2942,relax_and_recompute,0.35,14,14,0,-0.0768132537805001,-0.1941909843144529,20,36
2943,relax_and_recompute,0.35,0,0,0,0.0,0.1086180522181745,10,9
2944,relax_and_recompute,0.35,4,2,2,3.132385907660506,0.1746485325743098,13,15
2945,relax_and_recompute,0.35,14,4,10,-7.620236753879055,-0.0561431757504533,34,41
2946,relax_and_recompute,0.35,4,2,2,26.11549869375851,0.0522040421671635,37,42
2947,relax_and_recompute,0.35,21,11,10,1.4477024705299328,-0.1749454213318668,18,29
2948,relax_and_recompute,0.35,0,0,0,0.0,0.0696908348345992,23,22
2949,relax_and_recompute,0.35,0,0,0,0.0,0.1869803376119923,13,12
2950,relax_and_recompute,0.35,0,0,0,0.0,0.2120629359499396,15,14
2951,relax_and_recompute,0.35,2,0,2,66.51014277292069,0.0339676458596587,69,68
2952,relax_and_recompute,0.35,0,0,0,0.0,-0.2648927623564018,40,39
2953,relax_and_recompute,0.35,5,2,3,30.10499647382829,-0.1326144921279698,89,93
2954,relax_and_recompute,0.35,11,13,-2,-0.3287228951277257,-0.0672068250563248,20,32
2955,relax_and_recompute,0.35,2,3,-1,20.241606927364977,0.1862980223375101,69,83
2956,relax_and_recompute,0.35,1,2,-1,2.946160661121624,0.0438952722521845,12,15
2957,relax_and_recompute,0.35,0,0,0,0.0,0.0473081131452661,15,14
2958,relax_and_recompute,0.35,3,0,3,65.02429704082145,-0.0440118899410284,23,26
2959,relax_and_recompute,0.35,4,5,-1,-3.722968307934991,0.3539032780867268,12,20
2960,relax_and_recompute,0.35,240,206,34,-2.169468499716679,-0.0795376706697932,64,122
2961,relax_and_recompute,0.35,6,5,1,-4.798138474831418,-0.0052287074927551,58,71
2962,relax_and_recompute,0.35,0,0,0,0.0,0.2410360367364004,20,19
2963,relax_and_recompute,0.35,368,287,81,-2.505681246396648,0.2290870413881689,100,191
2964,relax_and_recompute,0.35,41,25,16,-1.8675902310681067,0.0140210074050063,41,61
2965,relax_and_recompute,0.35,28,21,7,-6.898320556912566,-0.1563232024964299,13,31
2966,relax_and_recompute,0.35,8,2,6,-1.8059230736623988,0.221790466664733,10,15
2967,relax_and_recompute,0.35,20,16,4,6.871156347154056,-0.1906886023261317,37,47
2968,relax_and_recompute,0.35,0,0,0,0.0,-0.0618861803337524,21,21
2969,relax_and_recompute,0.35,0,0,0,0.0,0.0049102385416608,11,10
2970,relax_and_recompute,0.35,47,40,7,0.4922351061472412,-0.4128235742333355,44,80
2971,relax_and_recompute,0.35,5,3,2,0.8468689922526096,0.0725149940506415,12,21
2972,relax_and_recompute,0.35,1,2,-1,-21.75532498136329,0.0259108580535821,37,43
2973,relax_and_recompute,0.35,7,27,-20,-6.280353021386112,-0.2530985561292086,41,52
2974,relax_and_recompute,0.35,4,0,4,64.26547863143512,0.2958275220135954,90,89
2975,relax_and_recompute,0.35,0,0,0,0.0,-0.3105322781974404,22,21
2976,relax_and_recompute,0.35,0,4,-4,-46.79270379165173,-0.0397554062088342,37,43
2977,relax_and_recompute,0.35,0,0,0,0.0,0.1096981852309665,47,47
2978,relax_and_recompute,0.35,11,8,3,-1.7992839166950034,0.4594449326788974,12,20
2979,relax_and_recompute,0.35,118,127,-9,-2.0946971154078184,-0.1861577920571794,84,124
2980,relax_and_recompute,0.35,0,0,0,0.0,-0.0837863723133327,88,92
2981,relax_and_recompute,0.35,414,418,-4,-0.5598713040885883,0.0615576976073222,59,122
2982,relax_and_recompute,0.35,2,5,-3,-4.384036630812659,0.0076075689151434,26,31
2983,relax_and_recompute,0.35,0,0,0,0.0,0.0241781619588983,28,27
2984,relax_and_recompute,0.35,4,4,0,-5.851890581872681,-0.3231644058803883,18,26
2985,relax_and_recompute,0.35,14,8,6,-9.276575685859209,0.0662285364770721,23,26
2986,relax_and_recompute,0.35,3,0,3,64.71294785731938,0.0837509569068792,43,43
2987,relax_and_recompute,0.35,1,5,-4,23.348887851998967,-0.3789726872698283,22,26
2988,relax_and_recompute,0.35,0,0,0,0.0,0.0310601034406562,15,14
2989,relax_and_recompute,0.35,24,22,2,0.0953676584466549,-0.2666408495699464,36,48
2990,relax_and_recompute,0.35,5,9,-4,-14.38908958171821,-0.1902566054601873,30,37
2991,relax_and_recompute,0.35,2,2,0,0.9361451923503809,0.0258295669487579,10,13
2992,relax_and_recompute,0.35,1,1,0,-2.0211333672983613,0.0639209144775228,12,11
2993,relax_and_recompute,0.35,236,168,68,-0.6883246147332045,-0.179858659100317,55,105
2994,relax_and_recompute,0.35,1,3,-2,0.143226038758172,-0.0115728691673451,13,17
2995,relax_and_recompute,0.35,0,0,0,0.0,-0.3142301203671946,30,29
2996,relax_and_recompute,0.35,8,2,6,15.324114037331327,-0.0305844176908742,36,43
2997,relax_and_recompute,0.35,30,12,18,-1.5965863759309826,0.1787245035977951,40,60
2998,relax_and_recompute,0.35,2,0,2,76.4409239191979,0.234682255671929,13,17
2999,relax_and_recompute,0.35,9,5,4,5.599282629094944,0.2772340454999087,23,30
3000,relax_and_recompute,0.35,0,1,-1,-21.909619583507578,0.0908847775911231,12,16
3001,relax_and_recompute,0.35,0,0,0,0.0,0.0763937283417588,26,26
3002,relax_and_recompute,0.35,1,4,-3,-12.224582238252786,0.2293241796925835,22,31
3003,relax_and_recompute,0.35,1,1,0,-1.9427279216437647,-0.0073299282338449,68,68
3004,relax_and_recompute,0.35,0,0,0,0.0,0.1554139159135522,23,22
3005,relax_and_recompute,0.35,0,0,0,0.0,-0.0440407496222711,43,42
3006,relax_and_recompute,0.35,1,0,1,74.96650599277548,-0.0182465907061574,18,17
3007,relax_and_recompute,0.35,4,9,-5,0.972115657112127,-0.0065121945878847,28,42
3008,relax_and_recompute,0.35,44,39,5,1.2946290873642283,0.4464560477140418,21,44
3009,relax_and_recompute,0.35,1,0,1,51.35832750551353,0.0595867936946695,36,37
3010,relax_and_recompute,0.35,0,0,0,0.0,-0.1079839476579193,15,14
3011,relax_and_recompute,0.35,1,0,1,88.27781358832603,0.5462846421848895,14,16
3012,relax_and_recompute,0.35,287,177,110,-1.739412831777372,-0.0944229898339398,61,119
3013,relax_and_recompute,0.35,0,2,-2,-87.73070551890713,-0.0315672410654767,19,20
3014,relax_and_recompute,0.35,0,0,0,0.0,0.441280741488963,22,22
3015,relax_and_recompute,0.35,0,0,0,0.0,0.3043149918161503,54,58
3016,relax_and_recompute,0.35,420,481,-61,1.6589027858970624,0.0112095457465446,65,135
3017,relax_and_recompute,0.35,0,0,0,0.0,0.2358495699426086,16,18
3018,relax_and_recompute,0.35,9,5,4,6.293371358018611,0.1509494350276545,17,27
3019,relax_and_recompute,0.35,15,9,6,5.738840066615509,0.0260168606344658,54,71
3020,relax_and_recompute,0.35,0,1,-1,-73.05484943216779,0.2171078668365749,23,22
3021,relax_and_recompute,0.35,1,0,1,88.16448853998583,-0.4102396877177546,13,16
3022,relax_and_recompute,0.35,129,145,-16,-0.7187692942290695,-0.0315628246162948,85,131
3023,relax_and_recompute,0.35,36,34,2,3.657782266639898,0.093936425656447,28,55
3024,relax_and_recompute,0.35,8,6,2,7.165361480007888,0.7237239860387799,18,24
3025,relax_and_recompute,0.35,3,4,-1,9.895952881994669,-0.4450360009260636,19,22
3026,relax_and_recompute,0.35,2,1,1,-12.823433261619812,0.192006249400453,47,46
3027,relax_and_recompute,0.35,47,37,10,1.5599862731206429,-0.0048089660765302,39,64
3028,relax_and_recompute,0.35,0,1,-1,-69.46315819537728,0.2747639098916301,17,18
3029,relax_and_recompute,0.35,1,1,0,-20.599032355512023,-0.1905450484128126,23,24
3030,relax_and_recompute,0.35,1,1,0,7.134684109836343,0.5248142819429287,13,16
3031,relax_and_recompute,0.35,25,11,14,6.082361390811862,-0.1842296460015317,40,56
3032,relax_and_recompute,0.35,2,0,2,58.75366541197367,0.1470997500852869,10,15
3033,relax_and_recompute,0.35,0,0,0,0.0,-0.0801208361527145,21,20
3034,relax_and_recompute,0.35,2,4,-2,4.477272572288371,-0.1071634579121192,30,35
3035,relax_and_recompute,0.35,1,2,-1,15.38953762525056,-0.0917884768733633,71,77
3036,relax_one,0.35,1,0,1,52.99722624397515,0.0013369269788042,17,18
3037,relax_one,0.35,4,4,0,-8.821296475402086,0.2218407429170724,43,48
3038,relax_one,0.35,5,7,-2,2.102560726107434,0.1225851487196225,38,45
3039,relax_one,0.35,2,3,-1,3.938798109966641,-0.0754505522285637,12,12
3040,relax_one,0.35,11,6,5,-8.979089376846389,0.1055677339153854,23,38
3041,relax_one,0.35,0,1,-1,-67.90471204989507,-0.0195066215508393,19,22
3042,relax_one,0.35,747,756,-9,0.5592060283990321,0.0086922955688006,35,143
3043,relax_one,0.35,1,1,0,-37.01792169517674,0.0497914019738389,92,91
3044,relax_one,0.35,2,14,-12,-41.56124808804995,0.1366467130198074,43,51
3045,relax_one,0.35,4,2,2,-12.711518884250651,0.2847860259078918,35,36
3046,relax_one,0.35,0,0,0,0.0,-0.3247961369025295,11,13
3047,relax_one,0.35,29,21,8,1.4776617810061057,0.1079655634787536,10,25
3048,relax_one,0.35,27,30,-3,-0.1636486686406328,0.0553315372779482,86,136
3049,relax_one,0.35,0,0,0,0.0,0.3354326368268999,10,12
3050,relax_one,0.35,0,0,0,0.0,-0.0516364884793193,32,31
3051,relax_one,0.35,2,6,-4,18.834496188154404,-0.0124464985105561,20,26
3052,relax_one,0.35,0,3,-3,-60.0,-0.6400046939801181,11,11
3053,relax_one,0.35,4,2,2,-13.379628794523695,0.2133238733122548,34,42
3054,relax_one,0.35,13,14,-1,1.09922037991673,0.068051013236452,14,25
3055,relax_one,0.35,12,16,-4,2.9086766762124583,-0.1236815728036753,31,46
3056,relax_one,0.35,3,1,2,-15.016600304880669,0.1263673981456324,42,45
3057,relax_one,0.35,1129,1166,-37,0.8350871764434089,0.0916641293890142,39,173
3058,relax_one,0.35,12,9,3,-0.9487838328114436,-0.3243120778980387,14,24
3059,relax_one,0.35,0,0,0,0.0,0.1675889900147319,24,25
3060,relax_one,0.35,4,2,2,-4.116654060757583,-0.318759281157734,12,19
3061,relax_one,0.35,76,74,2,3.52040186065522,-0.0026771401659562,41,72
3062,relax_one,0.35,169,192,-23,-1.5547260357550527,0.1694814183425996,59,115
3063,relax_one,0.35,9,11,-2,1.7279103365240616,0.2274548280484302,32,37
3064,relax_one,0.35,1,0,1,83.0037688873668,0.0696240611716904,20,20
3065,relax_one,0.35,24,25,-1,-3.795723288872608,0.0316911153837855,12,31
3066,relax_one,0.35,1,0,1,73.01057179042976,0.03043352372752,10,10
3067,relax_one,0.35,1,0,1,79.42425159210131,0.0567726465867848,20,21
3068,relax_one,0.35,19,23,-4,-1.0702928276498795,-0.1200343048189239,39,52
3069,relax_one,0.35,348,323,25,0.4562053598331275,0.0366688161568135,42,109
3070,relax_one,0.35,1,7,-6,13.68225931864196,0.3967185672258458,25,28
3071,relax_one,0.35,193,169,24,0.2507605723246158,-0.1357445656826158,56,106
3072,relax_one,0.35,519,432,87,-0.4281179208658869,0.3521553406901033,87,189
3073,relax_one,0.35,132,37,95,-6.434227435906642,-0.3370634106646679,56,82
3074,relax_one,0.35,1,0,1,70.28497519223723,0.1693903340112845,13,15
3075,relax_one,0.35,108,89,19,-0.1490684020726931,0.1963123560809994,36,63
3076,relax_one,0.35,0,0,0,0.0,-0.0506533263981764,16,15
3077,relax_one,0.35,0,0,0,0.0,-0.2195207324052054,67,66
3078,relax_one,0.35,14,17,-3,5.517433720961542,-0.2264529743481156,42,60
3079,relax_one,0.35,1,0,1,84.1513341682946,-0.1522524796603503,39,38
3080,relax_one,0.35,10,29,-19,-0.6327623527549093,-0.3367462050487333,20,36
3081,relax_one,0.35,0,0,0,0.0,-0.2203778965902855,10,9
3082,relax_one,0.35,5,0,5,49.85465700049524,-0.3484851381356675,13,15
3083,relax_one,0.35,9,4,5,2.815237464551096,-0.3381178943753703,34,41
3084,relax_one,0.35,4,4,0,-0.1000032526259531,0.2225437705773046,37,42
3085,relax_one,0.35,26,26,0,-3.859356913074152,0.1543849239562691,18,29
3086,relax_one,0.35,0,0,0,0.0,0.4319653742038846,23,22
3087,relax_one,0.35,1,0,1,57.81645134591615,0.1811596617955395,13,12
3088,relax_one,0.35,0,0,0,0.0,0.1619515414826676,15,14
3089,relax_one,0.35,0,0,0,0.0,-0.120514046742205,69,68
3090,relax_one,0.35,0,0,0,0.0,0.2028501272310457,40,39
3091,relax_one,0.35,0,0,0,0.0,0.1839335142605144,89,93
3092,relax_one,0.35,11,14,-3,3.8204317368009697,0.1158798635762119,20,32
3093,relax_one,0.35,6,1,5,-6.653923196272949,0.0192130242558973,69,83
3094,relax_one,0.35,2,1,1,-5.497811947374927,-0.3287974720158977,12,15
3095,relax_one,0.35,0,0,0,0.0,0.1329723565219328,15,14
3096,relax_one,0.35,1,3,-2,-42.23699529352578,0.3816865532378576,23,26
3097,relax_one,0.35,3,6,-3,16.915559996454917,-0.4362516018503903,12,20
3098,relax_one,0.35,213,168,45,-1.013121984073635,0.2132047709494198,64,122
3099,relax_one,0.35,18,7,11,7.418052143464514,0.1828589558179744,58,71
3100,relax_one,0.35,0,0,0,0.0,0.3642082965108707,20,19
3101,relax_one,0.35,364,311,53,-1.6061978295399797,-0.0662736063231008,100,191
3102,relax_one,0.35,47,25,22,0.3029749539939317,-0.177305283175445,41,61
3103,relax_one,0.35,30,31,-1,2.5509660730674284,0.0052741219630568,13,31
3104,relax_one,0.35,3,2,1,-3.332477764421455,0.0808271655519433,10,15
3105,relax_one,0.35,9,10,-1,-3.672587963133523,0.0001855551445836,37,47
3106,relax_one,0.35,0,1,-1,-68.81972767278872,-0.0103774606216244,21,21
3107,relax_one,0.35,0,0,0,0.0,-0.0534058130668387,11,10
3108,relax_one,0.35,61,85,-24,-1.0112947550209412,-0.0496239022816134,44,80
3109,relax_one,0.35,4,2,2,-12.971562672162989,0.0929758087136868,12,21
3110,relax_one,0.35,1,2,-1,-6.265054297969087,-0.0154971590275354,37,43
3111,relax_one,0.35,23,7,16,1.0140645099458112,-0.2216335213027982,41,52
3112,relax_one,0.35,1,1,0,1.9069031975707984,-0.3001777887016541,90,89
3113,relax_one,0.35,0,0,0,0.0,0.1563162933744519,22,21
3114,relax_one,0.35,7,2,5,8.299091295794412,-0.3216231174079531,37,43
3115,relax_one,0.35,1,1,0,-2.470450281003877,-0.0334951645870758,47,47
3116,relax_one,0.35,4,4,0,-3.973504014268556,-0.192179881924014,12,20
3117,relax_one,0.35,130,132,-2,0.5138388289066071,0.0606484337400606,84,124
3118,relax_one,0.35,0,3,-3,-68.47766717717634,-0.1857133717021272,88,92
3119,relax_one,0.35,314,322,-8,0.3824181761696792,0.2396700832664156,59,122
3120,relax_one,0.35,5,7,-2,-6.160455739710386,-0.3056519131788362,26,31
3121,relax_one,0.35,0,0,0,0.0,0.2202911797634723,28,27
3122,relax_one,0.35,1,4,-3,-10.9096935325841,-0.0452481431358178,18,26
3123,relax_one,0.35,1,2,-1,-12.627749067178335,0.0809846171116855,23,26
3124,relax_one,0.35,3,0,3,66.4090837029403,-0.1629654892944246,43,43
3125,relax_one,0.35,3,2,1,-8.727163795562248,0.3754404221656766,22,26
3126,relax_one,0.35,0,1,-1,-85.49799274216335,-0.0756198527229091,15,14
3127,relax_one,0.35,18,11,7,4.963833032583814,0.1534384162293033,36,48
3128,relax_one,0.35,8,7,1,-1.8688186349092817,0.1840327212657607,30,37
3129,relax_one,0.35,1,1,0,2.3071614420265973,-0.0312408035972057,10,13
3130,relax_one,0.35,0,1,-1,-76.83769614661145,-0.2959826866606279,12,11
3131,relax_one,0.35,262,171,91,0.1479779801579042,-0.026221006830164,55,105
3132,relax_one,0.35,1,3,-2,14.28996693031273,0.0793552788374342,13,17
3133,relax_one,0.35,1,1,0,14.140525644264317,0.1325503474562873,30,29
3134,relax_one,0.35,6,9,-3,-12.882024459411817,0.0878438441400669,36,43
3135,relax_one,0.35,12,46,-34,-2.445158203704324,-0.4135491588385748,40,60
3136,relax_one,0.35,0,0,0,0.0,0.2676350355126657,13,17
3137,relax_one,0.35,12,12,0,6.1926432338418,0.1335597543349098,23,30
3138,relax_one,0.35,0,1,-1,-47.9813057212219,0.0019729436240116,12,16
3139,relax_one,0.35,6,0,6,57.27007159048936,-0.0834677734657293,26,26
3140,relax_one,0.35,2,2,0,-22.36275579445971,-0.4292777926215305,22,31
3141,relax_one,0.35,1,0,1,68.37025851316756,-0.007855125214163,68,68
3142,relax_one,0.35,0,0,0,0.0,0.1203407750550995,23,22
3143,relax_one,0.35,0,0,0,0.0,0.1459264598061382,43,42
3144,relax_one,0.35,0,0,0,0.0,0.1845353056878043,18,17
3145,relax_one,0.35,7,7,0,-7.092423600469019,-0.0610211265175895,28,42
3146,relax_one,0.35,48,43,5,-1.507395804928862,0.4843506448001011,21,44
3147,relax_one,0.35,1,5,-4,1.29183249378859,-0.0041504751121433,36,37
3148,relax_one,0.35,0,0,0,0.0,-0.218332271856688,15,14
3149,relax_one,0.35,0,2,-2,-55.29250513026503,-0.42911575788877,14,16
3150,relax_one,0.35,260,195,65,-2.3098895967309687,0.1036765123987667,61,119
3151,relax_one,0.35,0,0,0,0.0,-0.341652493499449,19,20
3152,relax_one,0.35,2,0,2,78.71529969948944,-0.02981060646032,22,22
3153,relax_one,0.35,0,1,-1,-77.6006630237677,-0.1107269497370813,54,58
3154,relax_one,0.35,538,514,24,0.4237352462981789,0.0688946085060948,65,135
3155,relax_one,0.35,2,0,2,87.31469757554967,0.2065617310829112,16,18
3156,relax_one,0.35,7,8,-1,3.85816212851244,-0.0852200254961103,17,27
3157,relax_one,0.35,8,15,-7,-9.473999397571715,-0.0323428151595961,54,71
3158,relax_one,0.35,1,1,0,-9.894709434898845,-0.0708380222334816,23,22
3159,relax_one,0.35,1,1,0,-9.341403142536253,0.1977794254834372,13,16
3160,relax_one,0.35,187,112,75,-0.1466496383971574,0.0473077536415981,85,131
3161,relax_one,0.35,36,34,2,-2.6974447176536387,-0.0762796258100558,28,55
3162,relax_one,0.35,13,3,10,7.766249234393456,0.1904056293911357,18,24
3163,relax_one,0.35,1,2,-1,-10.397577606482043,0.2340280869122172,19,22
3164,relax_one,0.35,2,2,0,-0.8441013750806476,0.0610367003539848,47,46
3165,relax_one,0.35,13,57,-44,15.697152496960284,-0.1431713423410554,39,64
3166,relax_one,0.35,0,1,-1,-68.9409294881229,0.297268694075859,17,18
3167,relax_one,0.35,1,1,0,-13.542996626259908,0.040528640678929,23,24
3168,relax_one,0.35,2,1,1,-34.34404227653592,0.0708043547772234,13,16
3169,relax_one,0.35,17,29,-12,6.038765553747169,-0.1500716256910518,40,56
3170,relax_one,0.35,0,2,-2,-65.18534171902441,0.3061331008272442,10,15
3171,relax_one,0.35,1,0,1,68.30966938574934,0.0815939173550819,21,20
3172,relax_one,0.35,1,1,0,-6.530025527927705,0.0047017390788487,30,35
3173,relax_one,0.35,13,5,8,17.652895426371835,-0.1125109672011857,71,77
3174,just_relax,0.35,0,0,0,0.0,0.1073872046889663,17,18
3175,just_relax,0.35,3,14,-11,-4.510197266004241,-0.0266637807226707,43,48
3176,just_relax,0.35,1,1,0,5.167419369283607,-0.2259652240257681,38,45
3177,just_relax,0.35,1,0,1,56.52445263330139,-0.2201790629241549,12,12
3178,just_relax,0.35,6,12,-6,7.886347906066966,-0.3300561739400003,23,38
3179,just_relax,0.35,1,0,1,59.160247569613205,0.4100208503386007,19,22
3180,just_relax,0.35,732,815,-83,-0.0654990295462738,0.0243339383465913,35,143
3181,just_relax,0.35,0,5,-5,-66.12430340893738,-0.0713757714819048,92,91
3182,just_relax,0.35,11,37,-26,9.769445178939208,-0.006393483148845,43,51
3183,just_relax,0.35,0,0,0,0.0,0.0214837424570655,35,36
3184,just_relax,0.35,3,0,3,69.66608386032966,-0.4991196974477155,11,13
3185,just_relax,0.35,19,19,0,16.81094903244844,0.2706524923684414,10,25
3186,just_relax,0.35,19,56,-37,8.636756208118939,-0.0242729666693309,86,136
3187,just_relax,0.35,0,0,0,0.0,0.0961097057435103,10,12
3188,just_relax,0.35,0,0,0,0.0,-0.0523674110933313,32,31
3189,just_relax,0.35,4,7,-3,2.4242233666737505,0.291457508316461,20,26
3190,just_relax,0.35,2,2,0,-1.992100948756232,0.2620711678758983,11,11
3191,just_relax,0.35,8,3,5,8.367146010237455,-0.2066705503006206,34,42
3192,just_relax,0.35,16,12,4,12.66291383579729,-0.1972212032078816,14,25
3193,just_relax,0.35,5,12,-7,-0.2089224691394804,0.0584595509653291,31,46
3194,just_relax,0.35,1,9,-8,11.193824441144628,-0.1954875036912776,42,45
3195,just_relax,0.35,1317,1156,161,0.1241712447222056,-0.1348781518509598,39,173
3196,just_relax,0.35,11,12,-1,1.571976735156909,0.5471201812445852,14,24
3197,just_relax,0.35,3,0,3,62.83379745921882,-0.308445804683829,24,25
3198,just_relax,0.35,2,1,1,-3.6802325093376,0.614438122408545,12,19
3199,just_relax,0.35,77,70,7,4.194078454160952,0.0103325535314803,41,72
3200,just_relax,0.35,253,197,56,7.749037368869331,0.3025231050226696,59,115
3201,just_relax,0.35,6,6,0,8.112560641182654,-0.4866306192993873,32,37
3202,just_relax,0.35,0,1,-1,-71.83310792375735,-0.0262217257310261,20,20
3203,just_relax,0.35,33,29,4,0.683778291098605,-0.2790604690136208,12,31
3204,just_relax,0.35,0,0,0,0.0,-0.0776654444309039,10,10
3205,just_relax,0.35,1,0,1,81.30041914740232,0.1120874282878767,20,21
3206,just_relax,0.35,20,31,-11,8.214661780300602,-0.2097199448789194,39,52
3207,just_relax,0.35,341,430,-89,0.921969886936779,0.1781576553969511,42,109
3208,just_relax,0.35,2,1,1,3.057716337390204,0.1030331869404667,25,28
3209,just_relax,0.35,170,327,-157,5.101830418350509,-0.0022348460181906,56,106
3210,just_relax,0.35,443,645,-202,11.46277197008741,-0.0469413812204878,87,189
3211,just_relax,0.35,50,34,16,-0.2465040545764623,0.2923699026965901,56,82
3212,just_relax,0.35,0,1,-1,-77.01460531510175,-0.1813067638199104,13,15
3213,just_relax,0.35,79,88,-9,0.0999861130339425,-0.0588923396556013,36,63
3214,just_relax,0.35,0,2,-2,-71.41857114157547,0.0881366136135448,16,15
3215,just_relax,0.35,0,0,0,0.0,-0.3084636562960507,67,66
3216,just_relax,0.35,31,19,12,4.420621312290635,-0.0496989830391404,42,60
3217,just_relax,0.35,1,2,-1,17.16112176646962,0.0635467124887209,39,38
3218,just_relax,0.35,13,12,1,-8.573628394233246,0.1312954891925113,20,36
3219,just_relax,0.35,0,0,0,0.0,0.0291307214692198,10,9
3220,just_relax,0.35,4,0,4,73.82330083408647,-0.3299260425054946,13,15
3221,just_relax,0.35,7,13,-6,-7.958952700814137,0.128897371617774,34,41
3222,just_relax,0.35,8,5,3,-1.4366136578910869,0.2184988779672136,37,42
3223,just_relax,0.35,20,11,9,-3.2016840594707645,0.3160988951611476,18,29
3224,just_relax,0.35,0,3,-3,-58.50231845313568,-0.0181207160544094,23,22
3225,just_relax,0.35,0,0,0,0.0,0.371153638212834,13,12
3226,just_relax,0.35,0,0,0,0.0,0.2586161396540087,15,14
3227,just_relax,0.35,0,0,0,0.0,-0.0942729740337177,69,68
3228,just_relax,0.35,0,0,0,0.0,0.2431903963420322,40,39
3229,just_relax,0.35,23,1,22,-21.19288526893104,0.0012347067493563,89,93
3230,just_relax,0.35,10,13,-3,5.039109478096762,0.2668579752867902,20,32
3231,just_relax,0.35,3,1,2,29.37850229649136,0.1022608877527104,69,83
3232,just_relax,0.35,2,2,0,-1.6078969478428888,-0.130281244191875,12,15
3233,just_relax,0.35,2,0,2,72.91037719772586,-0.3887157123921499,15,14
3234,just_relax,0.35,0,1,-1,-87.43500332529408,0.0729363047656841,23,26
3235,just_relax,0.35,3,5,-2,-3.465630321072311,0.1150994616764532,12,20
3236,just_relax,0.35,202,226,-24,1.7434417110983418,0.0677356668656143,64,122
3237,just_relax,0.35,34,14,20,2.103297134369498,-0.1688640483270715,58,71
3238,just_relax,0.35,0,0,0,0.0,-0.3485433001267211,20,19
3239,just_relax,0.35,315,414,-99,4.142428541746469,-0.1927564929747173,100,191
3240,just_relax,0.35,26,41,-15,12.26002916911552,0.0769258490509973,41,61
3241,just_relax,0.35,22,32,-10,15.564197658753804,-0.0152041081227026,13,31
3242,just_relax,0.35,4,8,-4,0.2271830879852387,-0.3737538006284714,10,15
3243,just_relax,0.35,13,8,5,9.632235551632654,0.192643938158518,37,47
3244,just_relax,0.35,3,2,1,-20.852146944812368,-0.3896441230067379,21,21
3245,just_relax,0.35,0,0,0,0.0,0.3738452657124507,11,10
3246,just_relax,0.35,69,44,25,-2.077833309422644,-0.0278993276393535,44,80
3247,just_relax,0.35,2,2,0,5.4044255059856425,-0.28303910234422,12,21
3248,just_relax,0.35,4,6,-2,-4.021182501815225,0.2558564801587039,37,43
3249,just_relax,0.35,18,13,5,-11.31106471824431,0.2237649609932377,41,52
3250,just_relax,0.35,2,0,2,70.4953081925571,-0.2594719485701605,90,89
3251,just_relax,0.35,0,0,0,0.0,0.0307898446914316,22,21
3252,just_relax,0.35,0,4,-4,-63.60440618528125,-0.29254552563726,37,43
3253,just_relax,0.35,0,3,-3,-38.93803504851162,-0.0579111369432314,47,47
3254,just_relax,0.35,5,5,0,-7.134964610274565,-0.1090710146400102,12,20
3255,just_relax,0.35,158,120,38,-1.3070561075140574,0.1139743490000301,84,124
3256,just_relax,0.35,1,5,-4,-47.713287483587536,0.1695391385972826,88,92
3257,just_relax,0.35,491,331,160,0.9555045044900724,0.0474968767965875,59,122
3258,just_relax,0.35,8,3,5,-0.8443089738039617,0.0603091756713524,26,31
3259,just_relax,0.35,0,0,0,0.0,-0.3258216593604089,28,27
3260,just_relax,0.35,7,3,4,-0.7464848495811793,0.019495356372677,18,26
3261,just_relax,0.35,2,1,1,-14.411358721946629,0.237108340014596,23,26
3262,just_relax,0.35,5,0,5,59.38963642054788,0.169814628562132,43,43
3263,just_relax,0.35,0,1,-1,-62.584749181381866,-0.2367791767582143,22,26
3264,just_relax,0.35,0,0,0,0.0,0.0833277838297189,15,14
3265,just_relax,0.35,13,8,5,-4.933273509295049,0.3008618978252335,36,48
3266,just_relax,0.35,8,15,-7,1.3285154119818046,0.2169705312991567,30,37
3267,just_relax,0.35,1,2,-1,-21.37475526326864,0.1220724164186168,10,13
3268,just_relax,0.35,0,0,0,0.0,0.0561353863580736,12,11
3269,just_relax,0.35,171,201,-30,4.283416239381879,0.2288680027810388,55,105
3270,just_relax,0.35,6,2,4,-14.587078093583829,-0.2639770286935061,13,17
3271,just_relax,0.35,3,1,2,18.45199525236586,-0.3147884588168523,30,29
3272,just_relax,0.35,3,2,1,24.30668528422067,-0.0589389870189098,36,43
3273,just_relax,0.35,24,26,-2,21.17433208161774,0.0944983233764831,40,60
3274,just_relax,0.35,1,1,0,-13.26484625012388,-0.3663664223297561,13,17
3275,just_relax,0.35,10,5,5,-1.474662087258757,-0.1044139560315692,23,30
3276,just_relax,0.35,1,3,-2,-3.77360132419777,-0.1649818771767026,12,16
3277,just_relax,0.35,0,0,0,0.0,-0.0880235552143713,26,26
3278,just_relax,0.35,4,1,3,3.707808987575973,0.3482227523684723,22,31
3279,just_relax,0.35,0,4,-4,-41.66542153184703,-0.1738557643318182,68,68
3280,just_relax,0.35,0,0,0,0.0,-0.022222986926856,23,22
3281,just_relax,0.35,1,2,-1,56.20225190235242,-0.0522006018157713,43,42
3282,just_relax,0.35,1,0,1,89.86038356830679,0.2935136506128283,18,17
3283,just_relax,0.35,15,9,6,-15.902938600093345,-0.1374957708199143,28,42
3284,just_relax,0.35,43,40,3,-3.792441522843816,0.3392714785400788,21,44
3285,just_relax,0.35,0,2,-2,-75.97701815830195,-0.2786710106721657,36,37
3286,just_relax,0.35,0,0,0,0.0,0.1696800631324131,15,14
3287,just_relax,0.35,2,3,-1,6.432052939307368,-0.2996935277590603,14,16
3288,just_relax,0.35,204,275,-71,0.7800557144275047,-0.1140271171113116,61,119
3289,just_relax,0.35,0,0,0,0.0,-0.1035411990544032,19,20
3290,just_relax,0.35,1,5,-4,-5.755607854188355,0.2676748818664438,22,22
3291,just_relax,0.35,2,3,-1,48.033398930923966,-0.1707632638530815,54,58
3292,just_relax,0.35,478,763,-285,5.253314674028367,0.1541433546172688,65,135
3293,just_relax,0.35,2,0,2,70.19809799638807,0.2026901641842486,16,18
3294,just_relax,0.35,9,10,-1,-2.159503464849635,0.2698285164171895,17,27
3295,just_relax,0.35,15,5,10,11.23847571744288,-0.1574974994330592,54,71
3296,just_relax,0.35,1,0,1,84.61225465280583,0.0490886894171361,23,22
3297,just_relax,0.35,1,8,-7,10.518249124636997,-0.2270680440314668,13,16
3298,just_relax,0.35,314,227,87,2.936568562442268,0.1068105020497878,85,131
3299,just_relax,0.35,36,42,-6,6.429711836799115,0.3894617130609406,28,55
3300,just_relax,0.35,6,8,-2,-5.251034022860551,0.4106484145188717,18,24
3301,just_relax,0.35,0,0,0,0.0,-0.0021363757739317,19,22
3302,just_relax,0.35,4,2,2,1.7813429805713383,0.093036323613622,47,46
3303,just_relax,0.35,33,82,-49,1.694098867843337,0.0379862966284821,39,64
3304,just_relax,0.35,2,0,2,62.6429105894844,-0.4333355178912946,17,18
3305,just_relax,0.35,5,1,4,-20.45121946938972,-0.2423337924752845,23,24
3306,just_relax,0.35,2,1,1,-5.499987370803254,-0.0672994587419419,13,16
3307,just_relax,0.35,13,33,-20,15.614816384653068,-0.2636664794284933,40,56
3308,just_relax,0.35,2,3,-1,25.44580240912624,0.4582595382598206,10,15
3309,just_relax,0.35,0,0,0,0.0,0.1779556029724031,21,20
3310,just_relax,0.35,4,6,-2,9.779382529815765,0.0244210795251068,30,35
3311,just_relax,0.35,3,2,1,-30.03796451716948,-0.0017111259644713,71,77
3312,relax_and_recompute,0.4,0,0,0,0.0,-0.140993869436394,17,18
3313,relax_and_recompute,0.4,8,7,1,-15.965291350546336,-0.0317746335498954,43,48
3314,relax_and_recompute,0.4,7,1,6,5.4087893198987445,0.0689705057681477,38,45
3315,relax_and_recompute,0.4,0,1,-1,-64.29808836284253,0.3172385847743357,12,12
3316,relax_and_recompute,0.4,23,4,19,-6.724665554522915,0.1191787902022613,23,38
3317,relax_and_recompute,0.4,2,1,1,-15.262207905397275,-0.0586259994729317,19,22
3318,relax_and_recompute,0.4,820,713,107,-1.0887739662076186,0.0880991497986521,35,143
3319,relax_and_recompute,0.4,2,0,2,41.106684196757385,0.0831997072474423,92,91
3320,relax_and_recompute,0.4,3,2,1,20.10951095309013,0.0385301194138251,43,51
3321,relax_and_recompute,0.4,0,0,0,0.0,0.3697465615146879,35,36
3322,relax_and_recompute,0.4,0,0,0,0.0,-0.1496511822282358,11,13
3323,relax_and_recompute,0.4,15,17,-2,2.2443445041344603,-0.2044818401778145,10,25
3324,relax_and_recompute,0.4,16,18,-2,4.168677693643247,0.1256098375646902,86,136
3325,relax_and_recompute,0.4,0,0,0,0.0,0.0383575989009031,10,12
3326,relax_and_recompute,0.4,0,0,0,0.0,0.0642218927557232,32,31
3327,relax_and_recompute,0.4,6,6,0,-13.339974198919094,-0.0621712489966664,20,26
3328,relax_and_recompute,0.4,0,1,-1,-70.24678963076455,0.4434089106490507,11,11
3329,relax_and_recompute,0.4,3,8,-5,-5.6420929174339705,0.2747997192826028,34,42
3330,relax_and_recompute,0.4,9,11,-2,3.0897949448321924,-0.1590347705816356,14,25
3331,relax_and_recompute,0.4,10,8,2,8.736366539242908,-0.0257786005669066,31,46
3332,relax_and_recompute,0.4,0,0,0,0.0,0.369672889458298,42,45
3333,relax_and_recompute,0.4,1192,1138,54,-0.100844807127487,0.2536150745469353,39,173
3334,relax_and_recompute,0.4,8,14,-6,5.334037886363774,0.203644397845473,14,24
3335,relax_and_recompute,0.4,0,2,-2,-63.931378317755005,0.0127263436830603,24,25
3336,relax_and_recompute,0.4,1,1,0,-9.466664896402406,-0.2431672125502915,12,19
3337,relax_and_recompute,0.4,56,55,1,-3.633574860586073,0.2692369297719301,41,72
3338,relax_and_recompute,0.4,194,157,37,-3.2583123073781906,-0.0233160974139232,59,115
3339,relax_and_recompute,0.4,3,4,-1,-13.80929771918499,0.0585339118263251,32,37
3340,relax_and_recompute,0.4,0,0,0,0.0,-0.2708862126420566,20,20
3341,relax_and_recompute,0.4,24,26,-2,0.8097071782061533,-0.0122417296554316,12,31
3342,relax_and_recompute,0.4,0,0,0,0.0,-0.4066968540809499,10,10
3343,relax_and_recompute,0.4,0,2,-2,-49.07331351440571,0.2590447690324172,20,21
3344,relax_and_recompute,0.4,26,19,7,-2.0510079521237543,-0.1966193830928921,39,52
3345,relax_and_recompute,0.4,441,305,136,-2.34850221863951,-0.0289402433217028,42,109
3346,relax_and_recompute,0.4,0,2,-2,-88.54535493438236,-0.1059722808070866,25,28
3347,relax_and_recompute,0.4,263,175,88,-1.5428367207320548,-0.0352923412584806,56,106
3348,relax_and_recompute,0.4,411,412,-1,0.783924594077611,-0.0144997019301342,87,189
3349,relax_and_recompute,0.4,48,25,23,-1.2539109272642437,0.2519621997813055,56,82
3350,relax_and_recompute,0.4,1,1,0,19.30259108263837,0.413174369383836,13,15
3351,relax_and_recompute,0.4,90,82,8,5.797186985817341,0.1248012275455481,36,63
3352,relax_and_recompute,0.4,4,0,4,72.76493937864025,-0.0451402259440365,16,15
3353,relax_and_recompute,0.4,0,0,0,0.0,0.0645196103915758,67,66
3354,relax_and_recompute,0.4,19,21,-2,7.000176164897397,0.2849926518177137,42,60
3355,relax_and_recompute,0.4,7,0,7,65.02222506683226,0.1285364832115133,39,38
3356,relax_and_recompute,0.4,18,8,10,-28.36622774794057,0.3253474152236505,20,36
3357,relax_and_recompute,0.4,0,0,0,0.0,-0.16217998624362,10,9
3358,relax_and_recompute,0.4,1,0,1,84.90135212829088,0.244254541840281,13,15
3359,relax_and_recompute,0.4,6,17,-11,-3.7455351542105007,0.0726263059777394,34,41
3360,relax_and_recompute,0.4,7,3,4,-12.65204506487798,0.0387388118328173,37,42
3361,relax_and_recompute,0.4,35,20,15,1.1921598906422588,0.2115178244029101,18,29
3362,relax_and_recompute,0.4,1,0,1,82.59174194086305,0.0333497107120367,23,22
3363,relax_and_recompute,0.4,0,0,0,0.0,0.0526884799571556,13,12
3364,relax_and_recompute,0.4,0,0,0,0.0,0.1953940878473658,15,14
3365,relax_and_recompute,0.4,1,0,1,89.0253798579248,-0.3320046652163235,69,68
3366,relax_and_recompute,0.4,0,0,0,0.0,-0.1384921849467896,40,39
3367,relax_and_recompute,0.4,7,1,6,-13.708651733754891,-0.0559295221117821,89,93
3368,relax_and_recompute,0.4,17,14,3,0.852265504005473,0.1499579241512205,20,32
3369,relax_and_recompute,0.4,1,3,-2,-7.372209203540912,-0.0321842543974073,69,83
3370,relax_and_recompute,0.4,1,1,0,19.706075449973355,0.1406737870011686,12,15
3371,relax_and_recompute,0.4,0,0,0,0.0,-0.3262870238677565,15,14
3372,relax_and_recompute,0.4,8,2,6,-10.36333613693833,0.1149085100055998,23,26
3373,relax_and_recompute,0.4,2,2,0,-6.769219874491725,0.113943375046178,12,20
3374,relax_and_recompute,0.4,195,172,23,2.093974084542978,0.1783533854262146,64,122
3375,relax_and_recompute,0.4,5,7,-2,4.564042016697066,-0.0969862195681098,58,71
3376,relax_and_recompute,0.4,0,0,0,0.0,-0.242912270309565,20,19
3377,relax_and_recompute,0.4,378,318,60,-1.607719499491587,0.0118551682350719,100,191
3378,relax_and_recompute,0.4,23,47,-24,2.162372552272096,0.0520907299779683,41,61
3379,relax_and_recompute,0.4,20,21,-1,-0.417077390209684,0.0293262366723848,13,31
3380,relax_and_recompute,0.4,3,3,0,6.299400228755253,0.4492999737612284,10,15
3381,relax_and_recompute,0.4,11,9,2,-8.36992787195014,-0.2207937913407616,37,47
3382,relax_and_recompute,0.4,1,0,1,84.31310259777456,-0.0011853137865929,21,21
3383,relax_and_recompute,0.4,0,0,0,0.0,0.3874140304566978,11,10
3384,relax_and_recompute,0.4,59,39,20,-1.8214338062065487,0.0746461764664169,44,80
3385,relax_and_recompute,0.4,2,3,-1,5.01318841948121,-0.1337352761157246,12,21
3386,relax_and_recompute,0.4,3,1,2,22.018975271401068,0.0294502647212152,37,43
3387,relax_and_recompute,0.4,20,10,10,-7.524372984901831,0.1543238921665733,41,52
3388,relax_and_recompute,0.4,1,0,1,88.98147206445365,0.0466984502201193,90,89
3389,relax_and_recompute,0.4,0,0,0,0.0,-0.0184603769131549,22,21
3390,relax_and_recompute,0.4,9,2,7,-10.8097706942725,0.198404341064229,37,43
3391,relax_and_recompute,0.4,0,0,0,0.0,0.4762202381355039,47,47
3392,relax_and_recompute,0.4,4,7,-3,6.875749763660451,-0.1258057136647988,12,20
3393,relax_and_recompute,0.4,147,152,-5,-0.8645122306834452,-0.022615695435178,84,124
3394,relax_and_recompute,0.4,1,0,1,50.92388211476951,-0.0564879450070853,88,92
3395,relax_and_recompute,0.4,374,271,103,-0.1735127217728376,-0.035821096472877,59,122
3396,relax_and_recompute,0.4,2,2,0,-16.00637136479267,0.1824372277886052,26,31
3397,relax_and_recompute,0.4,0,0,0,0.0,0.0734092877269247,28,27
3398,relax_and_recompute,0.4,6,4,2,17.407864594911423,0.0023277505120621,18,26
3399,relax_and_recompute,0.4,1,1,0,-17.51501711522893,0.2409991156286046,23,26
3400,relax_and_recompute,0.4,0,1,-1,-58.86230935397096,0.1420890410937304,43,43
3401,relax_and_recompute,0.4,1,2,-1,-14.15137944112778,-0.1531506895093101,22,26
3402,relax_and_recompute,0.4,0,0,0,0.0,0.0417812415743154,15,14
3403,relax_and_recompute,0.4,17,15,2,-2.473917337008132,0.2099352823385797,36,48
3404,relax_and_recompute,0.4,6,4,2,-0.5672887176142467,-0.3108037455389074,30,37
3405,relax_and_recompute,0.4,3,2,1,-32.66254302505609,0.1038329818529703,10,13
3406,relax_and_recompute,0.4,1,0,1,38.75033486301305,-0.0459880409020312,12,11
3407,relax_and_recompute,0.4,171,153,18,-1.7946516402049753,0.0624488142539588,55,105
3408,relax_and_recompute,0.4,1,0,1,64.69006385521176,0.4570543549490385,13,17
3409,relax_and_recompute,0.4,3,2,1,-1.124639479288419,0.2472792547360999,30,29
3410,relax_and_recompute,0.4,3,6,-3,-3.833813482352781,0.0366232838663129,36,43
3411,relax_and_recompute,0.4,24,13,11,0.3640146742142036,0.4271289771973137,40,60
3412,relax_and_recompute,0.4,1,1,0,-0.265206975530404,-0.3657027434085892,13,17
3413,relax_and_recompute,0.4,7,7,0,5.082111874929353,0.1624965197211004,23,30
3414,relax_and_recompute,0.4,1,1,0,35.62193026427805,-0.1033449390074807,12,16
3415,relax_and_recompute,0.4,0,0,0,0.0,-0.0714052650249273,26,26
3416,relax_and_recompute,0.4,5,0,5,70.88161842250932,0.3492687981651712,22,31
3417,relax_and_recompute,0.4,0,0,0,0.0,-0.1214036677896668,68,68
3418,relax_and_recompute,0.4,0,0,0,0.0,0.1632914010110503,23,22
3419,relax_and_recompute,0.4,0,0,0,0.0,0.0382558859777755,43,42
3420,relax_and_recompute,0.4,3,0,3,62.45892238528376,0.1219736707995049,18,17
3421,relax_and_recompute,0.4,5,5,0,2.6442465414599496,0.3482180194230616,28,42
3422,relax_and_recompute,0.4,48,41,7,0.8703252093440597,0.1765366504341272,21,44
3423,relax_and_recompute,0.4,0,0,0,0.0,0.0398893747458453,36,37
3424,relax_and_recompute,0.4,0,0,0,0.0,0.3287743945109622,15,14
3425,relax_and_recompute,0.4,0,1,-1,-58.916735629062266,-0.3265327683463171,14,16
3426,relax_and_recompute,0.4,220,213,7,1.1738200465596762,0.0043746259473627,61,119
3427,relax_and_recompute,0.4,0,0,0,0.0,-0.4424622507432142,19,20
3428,relax_and_recompute,0.4,0,0,0,0.0,0.1841516284743346,22,22
3429,relax_and_recompute,0.4,2,0,2,63.47671724302067,0.1987569948078533,54,58
3430,relax_and_recompute,0.4,414,548,-134,1.9630499852058487,-0.0280942634517679,65,135
3431,relax_and_recompute,0.4,1,1,0,-10.608668937161951,-0.1963399750034731,16,18
3432,relax_and_recompute,0.4,9,6,3,4.55711775649938,0.0148944845787029,17,27
3433,relax_and_recompute,0.4,26,20,6,-0.7639229994635244,0.0413110558292874,54,71
3434,relax_and_recompute,0.4,0,0,0,0.0,-0.1920517989925591,23,22
3435,relax_and_recompute,0.4,1,0,1,60.76215029163236,0.010307130946034,13,16
3436,relax_and_recompute,0.4,243,120,123,4.5818918541205065,-0.0239827776463791,85,131
3437,relax_and_recompute,0.4,60,36,24,-1.7913738194450983,0.0012286286874878,28,55
3438,relax_and_recompute,0.4,3,1,2,8.62465449352235,-0.0079134912900694,18,24
3439,relax_and_recompute,0.4,2,1,1,18.20452377029278,0.1711059920869565,19,22
3440,relax_and_recompute,0.4,1,2,-1,31.36160391288645,-0.0347970736133101,47,46
3441,relax_and_recompute,0.4,32,33,-1,3.273298039008317,0.387168499624704,39,64
3442,relax_and_recompute,0.4,2,0,2,81.61330727532172,-0.2257277118373017,17,18
3443,relax_and_recompute,0.4,2,2,0,14.471466650108148,-0.24404974440381,23,24
3444,relax_and_recompute,0.4,2,2,0,-17.568322568172732,-0.3033298562641788,13,16
3445,relax_and_recompute,0.4,27,49,-22,-11.955901081925605,-0.042021777411478,40,56
3446,relax_and_recompute,0.4,1,1,0,-3.4943579838479337,-0.5811194107728072,10,15
3447,relax_and_recompute,0.4,0,0,0,0.0,0.3412553101763433,21,20
3448,relax_and_recompute,0.4,1,1,0,-12.43449954980057,-0.0025348638361917,30,35
3449,relax_and_recompute,0.4,1,4,-3,11.30338792183447,0.2305423265482536,71,77
3450,relax_one,0.4,2,1,1,11.723702144467964,-0.1294408633004663,17,18
3451,relax_one,0.4,7,6,1,11.030515435155197,-0.0035732832514701,43,48
3452,relax_one,0.4,6,6,0,-17.618310458252793,-0.0431379382046057,38,45
3453,relax_one,0.4,0,1,-1,-87.77362955695843,0.1322864528212934,12,12
3454,relax_one,0.4,9,11,-2,0.4941700553225416,0.3231371276616229,23,38
3455,relax_one,0.4,1,1,0,8.83394852999605,-0.1565754158452929,19,22
3456,relax_one,0.4,846,908,-62,-0.0751384867495446,0.0742772943646749,35,143
3457,relax_one,0.4,3,5,-2,17.556227332091638,0.000218420635112,92,91
3458,relax_one,0.4,15,2,13,19.218798135361773,-0.0703198775923551,43,51
3459,relax_one,0.4,1,3,-2,40.07361958816549,-0.1430040406884988,35,36
3460,relax_one,0.4,0,1,-1,-87.73396228618245,-0.1620950726313916,11,13
3461,relax_one,0.4,19,27,-8,-5.334784241491576,0.1406201121698431,10,25
3462,relax_one,0.4,21,31,-10,3.083129126650832,0.0516408363562128,86,136
3463,relax_one,0.4,0,0,0,0.0,0.234934483056025,10,12
3464,relax_one,0.4,0,0,0,0.0,0.1506988975998313,32,31
3465,relax_one,0.4,7,3,4,10.072967361644857,0.0069122381128488,20,26
3466,relax_one,0.4,1,1,0,-2.174794221533688,0.297742374391731,11,11
3467,relax_one,0.4,11,6,5,13.060163896448458,0.2020354923305676,34,42
3468,relax_one,0.4,15,11,4,-5.099650725936826,0.2952812472203123,14,25
3469,relax_one,0.4,10,9,1,-1.0159557098157208,-0.250616208214463,31,46
3470,relax_one,0.4,9,0,9,61.41077291650595,-0.1593128628374263,42,45
3471,relax_one,0.4,1112,1070,42,-0.7342539377539623,0.1289070153514364,39,173
3472,relax_one,0.4,14,7,7,1.3430566166447448,0.4210381023682883,14,24
3473,relax_one,0.4,1,0,1,77.32008176733862,-0.0776485769827554,24,25
3474,relax_one,0.4,1,1,0,4.227973095526622,-0.054215591155719,12,19
3475,relax_one,0.4,84,69,15,1.1541126472431031,0.0375427813565595,41,72
3476,relax_one,0.4,192,193,-1,4.233458891431944,0.1452312078884513,59,115
3477,relax_one,0.4,9,10,-1,4.332648796603834,0.0169693438841556,32,37
3478,relax_one,0.4,0,0,0,0.0,0.1398365705543183,20,20
3479,relax_one,0.4,33,24,9,-1.9727051651950087,-0.0860506155064013,12,31
3480,relax_one,0.4,1,2,-1,73.59120036916549,0.5040918899753666,10,10
3481,relax_one,0.4,1,0,1,88.61465483055387,-0.1319816961939464,20,21
3482,relax_one,0.4,12,13,-1,2.1815647691384896,-0.0081561020811324,39,52
3483,relax_one,0.4,345,352,-7,-1.19548982218911,-0.1226430554913678,42,109
3484,relax_one,0.4,0,0,0,0.0,-0.1127418195220351,25,28
3485,relax_one,0.4,169,184,-15,2.52094951299614,0.0303045345650168,56,106
3486,relax_one,0.4,383,460,-77,0.5467994170793773,0.0716178733506643,87,189
3487,relax_one,0.4,64,66,-2,-0.472144834661762,0.3611790574158451,56,82
3488,relax_one,0.4,1,1,0,10.022242095982977,-0.0527267994921717,13,15
3489,relax_one,0.4,76,83,-7,-1.232692480063676,-0.129320366028027,36,63
3490,relax_one,0.4,1,0,1,86.68494100745242,0.2705075745547551,16,15
3491,relax_one,0.4,0,0,0,0.0,-0.1885249259348048,67,66
3492,relax_one,0.4,13,12,1,-11.719101453402082,0.1290854183776861,42,60
3493,relax_one,0.4,1,0,1,84.65961166666412,-0.2038542781520588,39,38
3494,relax_one,0.4,12,15,-3,3.389706944608463,-0.1056953076513175,20,36
3495,relax_one,0.4,0,0,0,0.0,-0.267318794210291,10,9
3496,relax_one,0.4,2,0,2,63.86469286170409,0.3196780056769067,13,15
3497,relax_one,0.4,4,6,-2,-16.813457413605803,-0.0116149648663577,34,41
3498,relax_one,0.4,5,4,1,-13.756660758818072,-0.0708683746491689,37,42
3499,relax_one,0.4,20,17,3,-4.480220906498516,0.1297963941630472,18,29
3500,relax_one,0.4,0,0,0,0.0,-0.469666324438877,23,22
3501,relax_one,0.4,0,0,0,0.0,-0.1853833622325161,13,12
3502,relax_one,0.4,0,0,0,0.0,0.1256880408898185,15,14
3503,relax_one,0.4,0,0,0,0.0,0.0858074298635966,69,68
3504,relax_one,0.4,0,0,0,0.0,-0.1274310108040216,40,39
3505,relax_one,0.4,2,8,-6,14.699741372586416,-0.0634576424805122,89,93
3506,relax_one,0.4,16,9,7,-11.367640481787326,-0.0689412624381593,20,32
3507,relax_one,0.4,7,1,6,-18.059370648608848,-0.000579220119999,69,83
3508,relax_one,0.4,2,2,0,-3.7604588903880938,0.0450915126037816,12,15
3509,relax_one,0.4,0,0,0,0.0,0.0250601567393464,15,14
3510,relax_one,0.4,6,0,6,74.26093707444123,-0.1683144472220508,23,26
3511,relax_one,0.4,2,2,0,-4.0097583581902825,-0.0159716355522978,12,20
3512,relax_one,0.4,203,199,4,0.4780512475133278,0.2606030379147008,64,122
3513,relax_one,0.4,29,9,20,-4.035057903184914,0.1678830807765157,58,71
3514,relax_one,0.4,0,0,0,0.0,-0.1623231011843108,20,19
3515,relax_one,0.4,306,271,35,-1.2633304649468542,0.1612459712014289,100,191
3516,relax_one,0.4,29,45,-16,-7.924067934687109,-0.1624171040463441,41,61
3517,relax_one,0.4,24,34,-10,3.2673403639699075,-0.0345249138191288,13,31
3518,relax_one,0.4,4,3,1,8.747337069536016,-0.0617587975603266,10,15
3519,relax_one,0.4,14,10,4,-4.773353631042582,0.1294730596867844,37,47
3520,relax_one,0.4,2,1,1,-16.36590160986779,0.2147861962779736,21,21
3521,relax_one,0.4,0,0,0,0.0,-0.0354029793616447,11,10
3522,relax_one,0.4,50,63,-13,-2.778335285237993,0.0378684233388016,44,80
3523,relax_one,0.4,5,2,3,-9.88988566895216,-0.1426552557777028,12,21
3524,relax_one,0.4,10,3,7,-0.8249281598897085,0.2151277322985166,37,43
3525,relax_one,0.4,13,10,3,-1.351222925188054,-0.1770457254062487,41,52
3526,relax_one,0.4,0,0,0,0.0,0.3197130771740721,90,89
3527,relax_one,0.4,0,0,0,0.0,-0.0749034503068809,22,21
3528,relax_one,0.4,5,0,5,75.36491764029441,-0.0340173719466032,37,43
3529,relax_one,0.4,0,0,0,0.0,0.0870648013943757,47,47
3530,relax_one,0.4,5,4,1,-16.7023004359975,0.1717477723527352,12,20
3531,relax_one,0.4,139,112,27,-4.378305503014943,0.0809164607034893,84,124
3532,relax_one,0.4,0,2,-2,-68.63215624224384,-0.1076822405696513,88,92
3533,relax_one,0.4,378,387,-9,-0.4922057745839439,0.0489000699177479,59,122
3534,relax_one,0.4,2,4,-2,7.958802389112407,-0.0163390125602844,26,31
3535,relax_one,0.4,0,0,0,0.0,-0.2961218757097075,28,27
3536,relax_one,0.4,19,3,16,-4.88472601021995,0.4530763547614013,18,26
3537,relax_one,0.4,1,1,0,6.75211654177761,-0.0298896507296019,23,26
3538,relax_one,0.4,0,1,-1,-88.86387322387839,0.1716360345857933,43,43
3539,relax_one,0.4,8,2,6,-2.602899406357615,-0.4243875875664364,22,26
3540,relax_one,0.4,6,0,6,63.46250360794278,0.2197429107711264,15,14
3541,relax_one,0.4,15,10,5,-4.054608446759204,0.2809996080044531,36,48
3542,relax_one,0.4,8,4,4,-2.096348114035834,-0.055002361785995,30,37
3543,relax_one,0.4,1,3,-2,6.059687298984969,0.0439203761171627,10,13
3544,relax_one,0.4,0,0,0,0.0,-0.3472209280736736,12,11
3545,relax_one,0.4,165,166,-1,1.3604971531301118,0.0860446106132154,55,105
3546,relax_one,0.4,2,1,1,-3.2442126346067823,-0.1654041768057366,13,17
3547,relax_one,0.4,1,0,1,77.69044433346355,-0.1250652966861291,30,29
3548,relax_one,0.4,6,3,3,0.1779634531155807,-0.0389616163758986,36,43
3549,relax_one,0.4,18,29,-11,-9.360762882918564,0.0686530024492144,40,60
3550,relax_one,0.4,2,1,1,10.49743791982253,0.0747986450681177,13,17
3551,relax_one,0.4,14,7,7,-10.145600633786962,-0.053009823853093,23,30
3552,relax_one,0.4,3,3,0,12.492237321776102,-0.1103024970374718,12,16
3553,relax_one,0.4,0,0,0,0.0,0.1772840633504347,26,26
3554,relax_one,0.4,1,1,0,29.364507635371865,-0.1648100405473146,22,31
3555,relax_one,0.4,2,5,-3,-7.646291733976824,0.2926845162482778,68,68
3556,relax_one,0.4,0,0,0,0.0,0.07086362971777,23,22
3557,relax_one,0.4,0,0,0,0.0,0.1026582397579016,43,42
3558,relax_one,0.4,1,0,1,89.36441505597824,0.1644812295918465,18,17
3559,relax_one,0.4,0,8,-8,-66.80293521671545,0.0802120344016648,28,42
3560,relax_one,0.4,48,41,7,2.2471686126729296,-0.0152826009672351,21,44
3561,relax_one,0.4,1,0,1,85.21655503349972,-0.0395742983839428,36,37
3562,relax_one,0.4,0,0,0,0.0,-0.1230937307110212,15,14
3563,relax_one,0.4,1,0,1,85.1182708340745,-0.1903295881591608,14,16
3564,relax_one,0.4,206,189,17,-2.969654956610277,0.226161898410405,61,119
3565,relax_one,0.4,0,0,0,0.0,0.4146054935821459,19,20
3566,relax_one,0.4,2,1,1,-10.958332697858694,0.3858113496318841,22,22
3567,relax_one,0.4,2,4,-2,-0.2351899262024233,-0.2384492967278207,54,58
3568,relax_one,0.4,437,444,-7,-1.448950162776086,-0.0720875540300119,65,135
3569,relax_one,0.4,1,2,-1,14.04538283745184,0.0068556338228837,16,18
3570,relax_one,0.4,10,7,3,-12.38944671911458,0.0606958334384482,17,27
3571,relax_one,0.4,26,22,4,5.21993245056651,-0.1609512192145382,54,71
3572,relax_one,0.4,1,0,1,89.67612958175401,-0.0309086414020236,23,22
3573,relax_one,0.4,1,0,1,64.88818958999487,0.0602965060095211,13,16
3574,relax_one,0.4,115,170,-55,2.967727694165525,0.0106514701365898,85,131
3575,relax_one,0.4,37,78,-41,1.547834721935338,0.0053140424432313,28,55
3576,relax_one,0.4,12,3,9,27.5430560543376,-0.3106305263269677,18,24
3577,relax_one,0.4,2,1,1,5.707287772312583,0.0068672522469773,19,22
3578,relax_one,0.4,5,0,5,82.12796375659583,-0.0057241742168503,47,46
3579,relax_one,0.4,36,27,9,9.052744846705105,0.0694691824421006,39,64
3580,relax_one,0.4,1,1,0,41.77476806223992,0.1788674211444837,17,18
3581,relax_one,0.4,4,1,3,-20.2450131123242,-0.2451076810421734,23,24
3582,relax_one,0.4,1,1,0,5.236807846048521,0.1775062801404811,13,16
3583,relax_one,0.4,25,24,1,-1.113493556025304,0.2310823709442623,40,56
3584,relax_one,0.4,0,1,-1,-79.08532696536949,0.3691986665039686,10,15
3585,relax_one,0.4,0,0,0,0.0,0.0863542753432221,21,20
3586,relax_one,0.4,12,4,8,-2.168508993389281,-0.2726948837424243,30,35
3587,relax_one,0.4,3,7,-4,9.475405302820448,-0.4018354998710279,71,77
3588,just_relax,0.4,1,0,1,54.223823713604816,0.1466553460850066,17,18
3589,just_relax,0.4,5,9,-4,-1.3633850425013565,-0.2383062970499624,43,48
3590,just_relax,0.4,4,4,0,8.69501705674773,-0.1623376676030142,38,45
3591,just_relax,0.4,0,0,0,0.0,-0.1524862868024176,12,12
3592,just_relax,0.4,18,35,-17,-4.55947312141177,0.2551300282031296,23,38
3593,just_relax,0.4,0,1,-1,-80.19927078617158,-0.3061946811971456,19,22
3594,just_relax,0.4,837,1025,-188,0.1784564173472773,0.0079756187254222,35,143
3595,just_relax,0.4,7,6,1,13.228988794692548,-0.0715012305997091,92,91
3596,just_relax,0.4,5,8,-3,16.964565695326797,-0.112013773601464,43,51
3597,just_relax,0.4,2,5,-3,13.74723821657824,0.1507681210803431,35,36
3598,just_relax,0.4,0,0,0,0.0,0.1063076250878579,11,13
3599,just_relax,0.4,18,24,-6,15.90044866004392,0.1410455893680462,10,25
3600,just_relax,0.4,28,33,-5,10.95195693041108,-0.0329528338440362,86,136
3601,just_relax,0.4,0,0,0,0.0,0.0477639131779706,10,12
3602,just_relax,0.4,0,0,0,0.0,-0.0210271397849243,32,31
3603,just_relax,0.4,8,5,3,-14.311700416357546,-0.4030153767438583,20,26
3604,just_relax,0.4,0,0,0,0.0,0.0230411050628731,11,11
3605,just_relax,0.4,8,18,-10,11.240544503499052,0.1491810102152225,34,42
3606,just_relax,0.4,11,9,2,4.049274509768736,-0.4413003708200851,14,25
3607,just_relax,0.4,10,11,-1,13.237753388055276,-0.2648127445188246,31,46
3608,just_relax,0.4,1,2,-1,8.179808556027396,-0.0140589948809584,42,45
3609,just_relax,0.4,1067,1187,-120,1.812975480491844,0.0904469624958504,39,173
3610,just_relax,0.4,8,8,0,-0.6809412891274178,0.1563378577313775,14,24
3611,just_relax,0.4,1,0,1,44.05358069570436,0.0822927974200593,24,25
3612,just_relax,0.4,0,1,-1,-70.51330899600077,0.068933434792331,12,19
3613,just_relax,0.4,57,90,-33,4.249120498348169,-0.0263389288097388,41,72
3614,just_relax,0.4,192,181,11,-0.9732599559622984,0.2494253304639023,59,115
3615,just_relax,0.4,6,7,-1,7.897871361208516,-0.4112863510468635,32,37
3616,just_relax,0.4,0,1,-1,-64.58044511636352,0.0163742324475154,20,20
3617,just_relax,0.4,28,33,-5,-1.2000294254763588,0.2338530924732789,12,31
3618,just_relax,0.4,1,0,1,89.66938465711625,0.30342897527982,10,10
3619,just_relax,0.4,1,2,-1,-14.909168495139312,0.1792097157839866,20,21
3620,just_relax,0.4,21,18,3,12.227443520087796,-0.0276554327911076,39,52
3621,just_relax,0.4,429,324,105,-1.23400791999984,0.0740752459812083,42,109
3622,just_relax,0.4,1,1,0,-0.9851907516138,0.2862245598395698,25,28
3623,just_relax,0.4,222,230,-8,4.181367794505,-0.0282606625449374,56,106
3624,just_relax,0.4,442,656,-214,9.007941149687396,-0.1164082413435412,87,189
3625,just_relax,0.4,59,39,20,1.85076896835497,-0.0392160667722524,56,82
3626,just_relax,0.4,1,1,0,15.483833643875355,-0.0160056211058393,13,15
3627,just_relax,0.4,60,77,-17,1.558075209182029,-0.2515499186862402,36,63
3628,just_relax,0.4,0,0,0,0.0,-0.1081466094876146,16,15
3629,just_relax,0.4,0,0,0,0.0,0.3255926070522125,67,66
3630,just_relax,0.4,17,13,4,-8.026956994583678,-0.0704014764953373,42,60
3631,just_relax,0.4,1,1,0,2.1850667185946406,-0.2758141601757954,39,38
3632,just_relax,0.4,11,8,3,-26.051826038102867,0.3384910644586026,20,36
3633,just_relax,0.4,0,0,0,0.0,-0.0379639497188559,10,9
3634,just_relax,0.4,0,0,0,0.0,-0.1677455993134423,13,15
3635,just_relax,0.4,6,13,-7,5.690913659225913,-0.1436787871533947,34,41
3636,just_relax,0.4,4,3,1,-13.086358555041071,0.2700272823091066,37,42
3637,just_relax,0.4,24,33,-9,0.3420820856974558,0.3792127186138151,18,29
3638,just_relax,0.4,0,1,-1,-74.5567865119908,0.2468002569215098,23,22
3639,just_relax,0.4,0,0,0,0.0,0.543805437074678,13,12
3640,just_relax,0.4,0,0,0,0.0,-0.4022607493792851,15,14
3641,just_relax,0.4,3,0,3,73.2213292698933,-0.2345634552473811,69,68
3642,just_relax,0.4,2,0,2,71.52642227042536,-0.0956830965951588,40,39
3643,just_relax,0.4,1,3,-2,-52.36916099293313,-0.0560422344807087,89,93
3644,just_relax,0.4,14,12,2,-6.711830206292007,0.0349932207510769,20,32
3645,just_relax,0.4,1,5,-4,-28.02709586887123,-0.0763776378112103,69,83
3646,just_relax,0.4,2,0,2,76.70623793479676,-0.1072732830270877,12,15
3647,just_relax,0.4,0,0,0,0.0,0.3535094442021298,15,14
3648,just_relax,0.4,5,0,5,68.80067146104592,0.2158524330631749,23,26
3649,just_relax,0.4,4,2,2,-1.2596469318358174,-0.1812052999552448,12,20
3650,just_relax,0.4,165,235,-70,6.4343280040466055,0.3255171917508109,64,122
3651,just_relax,0.4,8,19,-11,9.538506937045009,0.0280792915445224,58,71
3652,just_relax,0.4,0,0,0,0.0,-0.0045979635361558,20,19
3653,just_relax,0.4,375,466,-91,4.262874051120363,-0.1252681561203444,100,191
3654,just_relax,0.4,24,33,-9,9.793798957768978,0.0204289661926173,41,61
3655,just_relax,0.4,27,44,-17,8.444902038000635,-0.1514941708602135,13,31
3656,just_relax,0.4,2,2,0,-2.0906029687710657,0.4956072813864844,10,15
3657,just_relax,0.4,13,13,0,-6.465796944520768,-0.0108567782681803,37,47
3658,just_relax,0.4,0,0,0,0.0,-0.1871585042130282,21,21
3659,just_relax,0.4,0,1,-1,-73.91107138773769,0.3327433786785125,11,10
3660,just_relax,0.4,49,48,1,-2.479164307932095,0.1274252995303669,44,80
3661,just_relax,0.4,5,7,-2,1.325109234716919,-0.1416124558656423,12,21
3662,just_relax,0.4,2,4,-2,-20.079394763863093,-0.2085882969110791,37,43
3663,just_relax,0.4,13,4,9,-3.880616703074665,-0.1147389664199358,41,52
3664,just_relax,0.4,1,0,1,82.59056481580825,0.1096736844821688,90,89
3665,just_relax,0.4,0,1,-1,-39.88107143420817,-0.1357592310485308,22,21
3666,just_relax,0.4,6,5,1,-0.1609079344188302,0.0375139940467496,37,43
3667,just_relax,0.4,3,10,-7,4.660268397931098,0.0736825584560905,47,47
3668,just_relax,0.4,6,4,2,11.565538414872975,0.0513051303503461,12,20
3669,just_relax,0.4,114,140,-26,3.5485920990981583,-0.4606591171697231,84,124
3670,just_relax,0.4,3,0,3,77.84297074826857,0.1256650863585052,88,92
3671,just_relax,0.4,366,395,-29,2.9564966076626646,-0.0006484289141285,59,122
3672,just_relax,0.4,2,2,0,-13.412612057173549,-0.1238394631781187,26,31
3673,just_relax,0.4,0,0,0,0.0,-0.0470336877972191,28,27
3674,just_relax,0.4,3,2,1,3.2641026666155817,-0.023919169745703,18,26
3675,just_relax,0.4,3,3,0,-11.948869184675374,0.1112272033025428,23,26
3676,just_relax,0.4,2,3,-1,1.232535992933208,0.0570227865189084,43,43
3677,just_relax,0.4,0,1,-1,-89.95181789855418,-0.0395768821915696,22,26
3678,just_relax,0.4,0,0,0,0.0,-0.1373007687731812,15,14
3679,just_relax,0.4,22,20,2,1.799607429772628,-0.1928684790217384,36,48
3680,just_relax,0.4,4,5,-1,8.757500474972488,0.0455820412837068,30,37
3681,just_relax,0.4,2,2,0,-4.72581850743461,0.2880935410811863,10,13
3682,just_relax,0.4,0,0,0,0.0,-0.0334478993378931,12,11
3683,just_relax,0.4,165,215,-50,4.575421962682142,0.26555253138679,55,105
3684,just_relax,0.4,1,1,0,-7.371999522612711,0.1648725216356777,13,17
3685,just_relax,0.4,1,0,1,65.55685213313797,0.1138184673122525,30,29
3686,just_relax,0.4,2,2,0,4.163706596768712,-0.0292249805028379,36,43
3687,just_relax,0.4,21,24,-3,-1.1581607686836293,-0.1764810170145528,40,60
3688,just_relax,0.4,0,0,0,0.0,0.0828519384601855,13,17
3689,just_relax,0.4,9,12,-3,18.04536231150407,0.0399192136888074,23,30
3690,just_relax,0.4,4,3,1,30.50017207040641,-0.281891628331765,12,16
3691,just_relax,0.4,2,0,2,88.1052950702599,0.1542553065467774,26,26
3692,just_relax,0.4,6,0,6,68.1273391480865,-0.1176109370912916,22,31
3693,just_relax,0.4,0,11,-11,-72.71683633018773,-0.1443833676378073,68,68
3694,just_relax,0.4,0,0,0,0.0,-0.0210179977109756,23,22
3695,just_relax,0.4,0,10,-10,-52.53349455098296,0.0271339012411504,43,42
3696,just_relax,0.4,0,0,0,0.0,-0.2909303670949205,18,17
3697,just_relax,0.4,4,11,-7,19.76088197275258,-0.1984540371168494,28,42
3698,just_relax,0.4,69,53,16,0.9845033664262814,0.0435121707052906,21,44
3699,just_relax,0.4,5,0,5,57.25713982514734,0.0278408231974544,36,37
3700,just_relax,0.4,0,0,0,0.0,-0.1064453142313666,15,14
3701,just_relax,0.4,0,0,0,0.0,-0.2889450319344969,14,16
3702,just_relax,0.4,241,232,9,1.7010077940049158,-0.1152628816374515,61,119
3703,just_relax,0.4,0,0,0,0.0,0.0980419107938722,19,20
3704,just_relax,0.4,0,2,-2,-50.233074001047214,0.1653943220043595,22,22
3705,just_relax,0.4,2,4,-2,35.22479101279009,-0.1127230711739091,54,58
3706,just_relax,0.4,512,747,-235,4.964367749801035,0.1641182418605034,65,135
3707,just_relax,0.4,1,1,0,-13.99999226841038,0.28940427960118,16,18
3708,just_relax,0.4,8,7,1,-5.868269230700292,0.4427186764496781,17,27
3709,just_relax,0.4,9,16,-7,-4.047739295611791,-0.2343402257480838,54,71
3710,just_relax,0.4,0,0,0,0.0,0.0997294534996192,23,22
3711,just_relax,0.4,1,1,0,39.79075137497307,-0.2150916320305701,13,16
3712,just_relax,0.4,238,217,21,-1.510345382883706,0.1271269624853089,85,131
3713,just_relax,0.4,59,31,28,-5.129604264352004,0.2846746065467507,28,55
3714,just_relax,0.4,5,11,-6,-13.41903309674533,-0.0864641625006297,18,24
3715,just_relax,0.4,2,2,0,-12.51471350117059,0.3651884331660966,19,22
3716,just_relax,0.4,3,0,3,77.43785693305786,0.0693591592260128,47,46
3717,just_relax,0.4,70,65,5,6.01885287977062,-0.0506563471327655,39,64
3718,just_relax,0.4,1,0,1,82.77114607559413,-0.0265143621735598,17,18
3719,just_relax,0.4,1,4,-3,17.02380827591753,-0.3209744103553655,23,24
3720,just_relax,0.4,0,2,-2,-85.34173946578963,0.136874964744495,13,16
3721,just_relax,0.4,41,40,1,10.718157270205324,0.1528084208774057,40,56
3722,just_relax,0.4,0,1,-1,-86.71762212621485,-0.1248536580355467,10,15
3723,just_relax,0.4,0,0,0,0.0,-0.0284241978195279,21,20
3724,just_relax,0.4,4,4,0,34.85197561734229,0.0324151712362569,30,35
3725,just_relax,0.4,5,5,0,-13.627220395269354,-0.1680448474128905,71,77
3726,relax_and_recompute,0.45,2,0,2,86.5546590755374,0.3497068077589853,17,18
3727,relax_and_recompute,0.45,4,5,-1,-4.13354331422947,0.0425085463392125,43,48
3728,relax_and_recompute,0.45,9,1,8,-25.466334973794588,-0.0911294412582403,38,45
3729,relax_and_recompute,0.45,0,0,0,0.0,0.0840474524437333,12,12
3730,relax_and_recompute,0.45,14,11,3,1.4116783437104772,-0.0997072419434214,23,38
3731,relax_and_recompute,0.45,0,1,-1,-82.65017211883186,-0.1364352483351473,19,22
3732,relax_and_recompute,0.45,925,762,163,-0.0274113670235891,0.0505551025004431,35,143
3733,relax_and_recompute,0.45,3,1,2,-18.37125033848187,-0.1574662160705855,92,91
3734,relax_and_recompute,0.45,3,2,1,8.989008551808901,-0.046987788414864,43,51
3735,relax_and_recompute,0.45,2,0,2,51.95258597498118,0.1328752447249133,35,36
3736,relax_and_recompute,0.45,0,0,0,0.0,0.3894277307348334,11,13
3737,relax_and_recompute,0.45,21,16,5,-4.381514179785526,-0.1029353862612096,10,25
3738,relax_and_recompute,0.45,47,18,29,-1.6025239790001962,-0.1071544354235174,86,136
3739,relax_and_recompute,0.45,0,0,0,0.0,0.2516132344086989,10,12
3740,relax_and_recompute,0.45,0,0,0,0.0,-0.0033249716681303,32,31
3741,relax_and_recompute,0.45,3,2,1,-2.90757965262214,-0.1460288391485936,20,26
3742,relax_and_recompute,0.45,1,0,1,84.51789801984235,0.2869089694866878,11,11
3743,relax_and_recompute,0.45,5,5,0,19.720259706921787,-0.0205250048090639,34,42
3744,relax_and_recompute,0.45,12,13,-1,-7.920471421653239,-0.3936690898990059,14,25
3745,relax_and_recompute,0.45,9,11,-2,3.141980370953249,-0.01685797588235,31,46
3746,relax_and_recompute,0.45,2,0,2,61.751155508048186,-0.2574139485428969,42,45
3747,relax_and_recompute,0.45,1108,1129,-21,0.0232136063044734,0.118285261772507,39,173
3748,relax_and_recompute,0.45,12,8,4,-5.736852028150096,-0.0907384222324096,14,24
3749,relax_and_recompute,0.45,0,0,0,0.0,-0.0875280578741786,24,25
3750,relax_and_recompute,0.45,2,1,1,-0.3613594932179609,-0.0002922948848834,12,19
3751,relax_and_recompute,0.45,79,66,13,-1.3620566902769011,0.0168173425511437,41,72
3752,relax_and_recompute,0.45,203,173,30,1.0095037340599262,0.0929511803000141,59,115
3753,relax_and_recompute,0.45,10,6,4,5.8656868268531,0.448670917620344,32,37
3754,relax_and_recompute,0.45,2,0,2,75.92532846811731,0.384385425383411,20,20
3755,relax_and_recompute,0.45,27,31,-4,1.3508795184924338,0.1164883273988925,12,31
3756,relax_and_recompute,0.45,1,0,1,87.25583270890077,0.2086957927961185,10,10
3757,relax_and_recompute,0.45,0,1,-1,-85.1331265526467,0.0772397288725822,20,21
3758,relax_and_recompute,0.45,31,17,14,-10.13048603148156,0.1744392218701512,39,52
3759,relax_and_recompute,0.45,332,307,25,-0.9041543170631172,-0.0776741640624274,42,109
3760,relax_and_recompute,0.45,0,1,-1,-75.34811535105754,-0.1270489742217861,25,28
3761,relax_and_recompute,0.45,180,175,5,1.8675715994879385,-0.0216736771115568,56,106
3762,relax_and_recompute,0.45,479,469,10,1.1287252305803008,-0.4387505391732473,87,189
3763,relax_and_recompute,0.45,33,50,-17,3.954578924593719,0.0002715482628075,56,82
3764,relax_and_recompute,0.45,1,1,0,5.175715735790647,-0.0196767624866277,13,15
3765,relax_and_recompute,0.45,92,80,12,-0.3194300230967428,0.2082200190941125,36,63
3766,relax_and_recompute,0.45,2,0,2,71.38682130831361,-0.0816275843939218,16,15
3767,relax_and_recompute,0.45,0,0,0,0.0,0.1308353822879812,67,66
3768,relax_and_recompute,0.45,19,22,-3,8.470329396015622,0.0487347381273903,42,60
3769,relax_and_recompute,0.45,1,1,0,-11.605612757794802,-0.1946167943498757,39,38
3770,relax_and_recompute,0.45,12,11,1,-0.8339095742225879,0.2396921271800051,20,36
3771,relax_and_recompute,0.45,0,0,0,0.0,-0.1648304197094925,10,9
3772,relax_and_recompute,0.45,1,0,1,73.34782453000867,0.0935994394973473,13,15
3773,relax_and_recompute,0.45,7,7,0,-19.332528043725667,-0.058961408159702,34,41
3774,relax_and_recompute,0.45,6,5,1,11.728961165275456,0.0413700855432452,37,42
3775,relax_and_recompute,0.45,37,11,26,2.2170644127406405,-0.283537800873714,18,29
3776,relax_and_recompute,0.45,2,1,1,-1.0285241297288508,-0.2871745552867516,23,22
3777,relax_and_recompute,0.45,0,0,0,0.0,0.2027773258178069,13,12
3778,relax_and_recompute,0.45,0,2,-2,-60.98286591096455,-0.2718337022043217,15,14
3779,relax_and_recompute,0.45,0,0,0,0.0,0.1026032309208051,69,68
3780,relax_and_recompute,0.45,0,0,0,0.0,-0.5593082636125952,40,39
3781,relax_and_recompute,0.45,14,0,14,64.8098733271465,-0.1838481038491929,89,93
3782,relax_and_recompute,0.45,5,10,-5,-20.52419757336679,0.0831803845716806,20,32
3783,relax_and_recompute,0.45,2,1,1,-20.94631802513682,-0.1307004612426111,69,83
3784,relax_and_recompute,0.45,2,0,2,47.05124486262846,-0.2577298122210003,12,15
3785,relax_and_recompute,0.45,1,0,1,84.13302093957634,0.1197162715659579,15,14
3786,relax_and_recompute,0.45,2,3,-1,8.317469405725873,-0.0640444248775224,23,26
3787,relax_and_recompute,0.45,2,7,-5,10.652557449299708,0.1217383390130135,12,20
3788,relax_and_recompute,0.45,195,176,19,1.7874678807978697,0.23941514099675,64,122
3789,relax_and_recompute,0.45,7,23,-16,9.588331073050632,-0.0263119376983409,58,71
3790,relax_and_recompute,0.45,6,0,6,63.10636015120048,0.4431844104199055,20,19
3791,relax_and_recompute,0.45,300,286,14,3.908438802487275,0.234393309960362,100,191
3792,relax_and_recompute,0.45,69,27,42,1.338348841041224,-0.1610226819892013,41,61
3793,relax_and_recompute,0.45,20,31,-11,2.780042953029352,0.0100199562708941,13,31
3794,relax_and_recompute,0.45,3,3,0,5.088355884314986,-0.0624703270979165,10,15
3795,relax_and_recompute,0.45,26,6,20,-6.252287964795372,-0.4324043739705963,37,47
3796,relax_and_recompute,0.45,0,1,-1,-66.7628264227105,0.1225178529196262,21,21
3797,relax_and_recompute,0.45,0,0,0,0.0,0.0060072964534551,11,10
3798,relax_and_recompute,0.45,51,38,13,-4.84977420170906,0.3490828695249375,44,80
3799,relax_and_recompute,0.45,3,5,-2,-7.7441429504933055,0.089232787605752,12,21
3800,relax_and_recompute,0.45,4,6,-2,-2.3069355984417257,0.1692721349992592,37,43
3801,relax_and_recompute,0.45,23,13,10,-4.103009579014838,-0.1519139312023537,41,52
3802,relax_and_recompute,0.45,0,1,-1,-86.35264015610645,-0.2155193150336797,90,89
3803,relax_and_recompute,0.45,0,0,0,0.0,-0.2336994435400492,22,21
3804,relax_and_recompute,0.45,5,7,-2,9.506720021357076,0.196909173008428,37,43
3805,relax_and_recompute,0.45,0,0,0,0.0,0.3335391366024424,47,47
3806,relax_and_recompute,0.45,4,4,0,6.234486158904758,0.1867872663968958,12,20
3807,relax_and_recompute,0.45,127,115,12,1.3982924223689182,-0.090528839245948,84,124
3808,relax_and_recompute,0.45,1,2,-1,-39.0034936965143,0.0090116332293618,88,92
3809,relax_and_recompute,0.45,507,364,143,0.2003267611062682,-0.0094920082774792,59,122
3810,relax_and_recompute,0.45,7,4,3,2.241647812385061,-0.0719224106431912,26,31
3811,relax_and_recompute,0.45,0,0,0,0.0,0.1195691686535995,28,27
3812,relax_and_recompute,0.45,2,4,-2,-33.20162650445124,0.1051295867971467,18,26
3813,relax_and_recompute,0.45,2,1,1,5.6068637023563,0.1618003358526227,23,26
3814,relax_and_recompute,0.45,0,0,0,0.0,-0.1177536822336089,43,43
3815,relax_and_recompute,0.45,1,2,-1,-11.201264774928063,-0.0110167919234893,22,26
3816,relax_and_recompute,0.45,0,0,0,0.0,-0.0552401115579175,15,14
3817,relax_and_recompute,0.45,20,11,9,-4.252146759923164,-0.0546376459546483,36,48
3818,relax_and_recompute,0.45,8,7,1,2.49635564883134,-0.2034812391891385,30,37
3819,relax_and_recompute,0.45,3,3,0,-15.973741875790708,0.1821223533729198,10,13
3820,relax_and_recompute,0.45,0,1,-1,-87.00106195077743,0.2405142387658176,12,11
3821,relax_and_recompute,0.45,183,149,34,1.3272240212875983,-0.00617271740341,55,105
3822,relax_and_recompute,0.45,5,0,5,73.26633808416463,-0.0307501112651268,13,17
3823,relax_and_recompute,0.45,1,0,1,75.7551395723894,0.2174124032312299,30,29
3824,relax_and_recompute,0.45,11,2,9,22.551631938004512,-0.1935892166544652,36,43
3825,relax_and_recompute,0.45,10,16,-6,5.3871882211887865,-0.3091250317309945,40,60
3826,relax_and_recompute,0.45,0,1,-1,-59.76256452498532,-0.0240613585469092,13,17
3827,relax_and_recompute,0.45,15,8,7,-24.496478454862505,0.1061699314944244,23,30
3828,relax_and_recompute,0.45,0,1,-1,-31.01850274788725,0.0828751839745465,12,16
3829,relax_and_recompute,0.45,0,0,0,0.0,-0.3249995318569416,26,26
3830,relax_and_recompute,0.45,8,1,7,17.05918454706267,-0.0634380522387001,22,31
3831,relax_and_recompute,0.45,1,0,1,82.74299495979602,-0.077444246291855,68,68
3832,relax_and_recompute,0.45,0,0,0,0.0,0.0628760534365292,23,22
3833,relax_and_recompute,0.45,0,0,0,0.0,-0.1498809915318407,43,42
3834,relax_and_recompute,0.45,1,0,1,75.1806426485268,-0.0883245455374204,18,17
3835,relax_and_recompute,0.45,9,4,5,-6.59360684154764,0.19953545071641,28,42
3836,relax_and_recompute,0.45,39,40,-1,-0.3447088969858356,-0.0451427493824405,21,44
3837,relax_and_recompute,0.45,0,0,0,0.0,0.0556000694120878,36,37
3838,relax_and_recompute,0.45,0,0,0,0.0,0.0974523104469218,15,14
3839,relax_and_recompute,0.45,0,5,-5,-60.90045221563004,-0.1181480214359411,14,16
3840,relax_and_recompute,0.45,296,170,126,-4.672040179422716,0.0172440037713464,61,119
3841,relax_and_recompute,0.45,2,0,2,70.71176558495267,-0.1210849992928789,19,20
3842,relax_and_recompute,0.45,1,0,1,73.19136530271597,0.1896232382832949,22,22
3843,relax_and_recompute,0.45,3,0,3,65.10395086290781,-0.0122169912460305,54,58
3844,relax_and_recompute,0.45,429,492,-63,0.350595680512761,0.1754640056986508,65,135
3845,relax_and_recompute,0.45,1,0,1,83.9517384728721,0.0811609172735488,16,18
3846,relax_and_recompute,0.45,20,8,12,-2.786111560354932,0.148352816246143,17,27
3847,relax_and_recompute,0.45,9,8,1,-19.733881128709,-0.2151726430131925,54,71
3848,relax_and_recompute,0.45,0,0,0,0.0,-0.0684047132273115,23,22
3849,relax_and_recompute,0.45,1,1,0,-11.957769513752922,0.0748382191404153,13,16
3850,relax_and_recompute,0.45,129,162,-33,-0.7537978813644841,0.0959765686323018,85,131
3851,relax_and_recompute,0.45,32,35,-3,-5.261104142128012,0.2825717620272167,28,55
3852,relax_and_recompute,0.45,2,2,0,-6.355202067359073,-0.1170547300372887,18,24
3853,relax_and_recompute,0.45,1,2,-1,-14.533796396783202,0.204741002028105,19,22
3854,relax_and_recompute,0.45,0,0,0,0.0,0.0332292665932081,47,46
3855,relax_and_recompute,0.45,27,23,4,-3.5274454710348664,0.1365286951178801,39,64
3856,relax_and_recompute,0.45,1,1,0,-36.96263228102416,0.3736732211014766,17,18
3857,relax_and_recompute,0.45,2,2,0,-17.26767677586406,0.010747175231065,23,24
3858,relax_and_recompute,0.45,0,2,-2,-68.75418881795486,0.2559054685213224,13,16
3859,relax_and_recompute,0.45,17,16,1,1.1050665704544969,-0.0797027383033427,40,56
3860,relax_and_recompute,0.45,2,0,2,45.89745155905976,-0.2852007794758091,10,15
3861,relax_and_recompute,0.45,0,0,0,0.0,-0.0429369194379268,21,20
3862,relax_and_recompute,0.45,3,4,-1,-10.091393902112657,-0.0126610648427227,30,35
3863,relax_and_recompute,0.45,1,4,-3,-29.63019070731649,0.1036204663452006,71,77
3864,relax_one,0.45,1,1,0,-12.24483020553481,-0.090147104430817,17,18
3865,relax_one,0.45,8,11,-3,-3.3700950401738083,-0.2558244028398962,43,48
3866,relax_one,0.45,8,9,-1,-1.379163940189727,-0.0483769475871864,38,45
3867,relax_one,0.45,2,0,2,77.88801946493265,-0.0358633343011233,12,12
3868,relax_one,0.45,7,10,-3,-5.523014167778314,-0.1757252940850933,23,38
3869,relax_one,0.45,0,1,-1,-72.9164943382395,-0.4924561406663651,19,22
3870,relax_one,0.45,933,849,84,-0.6976154067470617,0.16102251247778,35,143
3871,relax_one,0.45,6,0,6,57.5956586392048,-0.0892496198513175,92,91
3872,relax_one,0.45,3,3,0,-4.9452596923871255,0.0879463864109122,43,51
3873,relax_one,0.45,3,1,2,-16.964538282137596,-0.062577771705042,35,36
3874,relax_one,0.45,0,0,0,0.0,0.0060087514416979,11,13
3875,relax_one,0.45,21,23,-2,1.7509683000501042,0.0131497464654328,10,25
3876,relax_one,0.45,25,17,8,-2.095444428596068,0.0474073314171629,86,136
3877,relax_one,0.45,3,0,3,71.66242692768175,0.1468960194672134,10,12
3878,relax_one,0.45,0,0,0,0.0,-0.0674373385038,32,31
3879,relax_one,0.45,2,3,-1,-21.665525305050025,0.2058031201563411,20,26
3880,relax_one,0.45,0,0,0,0.0,-0.2166419774774282,11,11
3881,relax_one,0.45,10,3,7,-5.691435819997238,0.2952155991759085,34,42
3882,relax_one,0.45,9,11,-2,-3.824125099171837,-0.2382864512206267,14,25
3883,relax_one,0.45,9,7,2,5.504482786567962,-0.4666137366653291,31,46
3884,relax_one,0.45,0,1,-1,-42.87121244711726,-0.0088001611768444,42,45
3885,relax_one,0.45,1149,1134,15,-0.4154541120304458,0.1333972876284993,39,173
3886,relax_one,0.45,11,10,1,-6.720393656300288,-0.0053047099855113,14,24
3887,relax_one,0.45,3,0,3,78.6276024491667,0.2437968251567204,24,25
3888,relax_one,0.45,4,1,3,1.949778174315924,-0.4395685034286041,12,19
3889,relax_one,0.45,53,64,-11,6.210442476767845,-0.405269288749979,41,72
3890,relax_one,0.45,251,159,92,0.749836898772493,-0.1376808675145476,59,115
3891,relax_one,0.45,5,6,-1,3.0564745899513497,0.3613371537460014,32,37
3892,relax_one,0.45,0,2,-2,-80.77360995222267,-0.1473043742060789,20,20
3893,relax_one,0.45,24,29,-5,-4.084635649303721,0.0745021187811527,12,31
3894,relax_one,0.45,1,0,1,77.37155712412508,0.3424438819782363,10,10
3895,relax_one,0.45,1,0,1,89.72725169177724,0.2686185964234703,20,21
3896,relax_one,0.45,23,21,2,-7.230566512522891,0.0846067313444449,39,52
3897,relax_one,0.45,350,328,22,0.592402874897509,0.0439206162372481,42,109
3898,relax_one,0.45,2,5,-3,10.323741116027604,-0.0243583637690431,25,28
3899,relax_one,0.45,172,208,-36,-0.0555563788142876,0.1617857472190559,56,106
3900,relax_one,0.45,470,426,44,-1.895524879513971,-0.1648803664647549,87,189
3901,relax_one,0.45,32,39,-7,0.5483241164289154,0.1032930862396341,56,82
3902,relax_one,0.45,0,1,-1,-78.02355826045333,0.0078242971584466,13,15
3903,relax_one,0.45,97,76,21,-0.7635945682117296,-0.1496890298759517,36,63
3904,relax_one,0.45,0,2,-2,-64.6588933665827,-0.0951758523928788,16,15
3905,relax_one,0.45,0,0,0,0.0,-0.3105842688186995,67,66
3906,relax_one,0.45,11,13,-2,9.02960178176562,-0.2192483904146883,42,60
3907,relax_one,0.45,0,0,0,0.0,0.303186733616927,39,38
3908,relax_one,0.45,11,8,3,-16.482187610605962,0.0788718051658857,20,36
3909,relax_one,0.45,0,1,-1,-89.65902049773145,0.1953253135315323,10,9
3910,relax_one,0.45,2,0,2,82.95765606057645,0.1664857996156442,13,15
3911,relax_one,0.45,6,13,-7,1.3210114072032724,-0.0435304068913984,34,41
3912,relax_one,0.45,5,12,-7,-8.313227517461463,0.0305923785348211,37,42
3913,relax_one,0.45,20,26,-6,-7.145073024464338,-0.1828589906138344,18,29
3914,relax_one,0.45,0,0,0,0.0,0.0132848404947973,23,22
3915,relax_one,0.45,0,0,0,0.0,-0.2634493897501029,13,12
3916,relax_one,0.45,0,0,0,0.0,0.0048811018318021,15,14
3917,relax_one,0.45,0,0,0,0.0,-0.1156614543562352,69,68
3918,relax_one,0.45,1,0,1,35.76794651214954,0.0937620000107,40,39
3919,relax_one,0.45,1,1,0,-9.744685402149235,-0.4740133349630294,89,93
3920,relax_one,0.45,14,11,3,-5.4267920855729415,0.2806514656732367,20,32
3921,relax_one,0.45,4,1,3,-2.410723910516566,-0.2101120254506132,69,83
3922,relax_one,0.45,2,0,2,47.00406586265823,0.4979038533553825,12,15
3923,relax_one,0.45,0,0,0,0.0,-0.187007935819761,15,14
3924,relax_one,0.45,3,6,-3,-0.0303875970108151,-0.0276023899585978,23,26
3925,relax_one,0.45,12,4,8,-0.5715582454113388,-0.0102943089881455,12,20
3926,relax_one,0.45,287,215,72,-0.7806921302678234,0.2375135813600815,64,122
3927,relax_one,0.45,9,7,2,-3.6293749508011928,0.1002665224912422,58,71
3928,relax_one,0.45,0,0,0,0.0,0.4890690232789759,20,19
3929,relax_one,0.45,314,235,79,-3.3592768177880643,0.1098545563444105,100,191
3930,relax_one,0.45,71,24,47,-5.578899478388614,0.1327192162483877,41,61
3931,relax_one,0.45,25,16,9,-0.8843687952553125,-0.0081056437864222,13,31
3932,relax_one,0.45,4,2,2,-21.25953360110852,0.2965280730559612,10,15
3933,relax_one,0.45,13,6,7,-8.649288346556801,-0.0032353855286346,37,47
3934,relax_one,0.45,2,1,1,-17.611506376079376,0.1873653114507962,21,21
3935,relax_one,0.45,0,0,0,0.0,-0.0244779414544918,11,10
3936,relax_one,0.45,68,37,31,-3.9450760138237584,0.0318890326039318,44,80
3937,relax_one,0.45,3,2,1,-10.732790236375893,-0.0669461567892414,12,21
3938,relax_one,0.45,8,6,2,1.874818443244344,0.1920977267903895,37,43
3939,relax_one,0.45,10,8,2,-1.538818587363508,0.0845614104197451,41,52
3940,relax_one,0.45,3,0,3,57.62157826571016,-0.0125847051476832,90,89
3941,relax_one,0.45,0,0,0,0.0,0.0029125346643623,22,21
3942,relax_one,0.45,3,2,1,1.8415850328229768,0.1753779942308856,37,43
3943,relax_one,0.45,8,0,8,67.79447785496228,-0.0664998003311927,47,47
3944,relax_one,0.45,4,4,0,4.689520130240638,-0.3593319216610331,12,20
3945,relax_one,0.45,138,131,7,4.512507540823954,-0.1044903636592788,84,124
3946,relax_one,0.45,1,8,-7,9.062863120139824,0.2241621408081671,88,92
3947,relax_one,0.45,269,293,-24,-0.2580930185199719,0.0679761313108082,59,122
3948,relax_one,0.45,5,17,-12,9.371993590721502,0.2510447536681087,26,31
3949,relax_one,0.45,0,0,0,0.0,0.2308695537798413,28,27
3950,relax_one,0.45,7,2,5,30.57301947387481,0.119071507159564,18,26
3951,relax_one,0.45,1,4,-3,6.348963508888531,-0.2513751305341305,23,26
3952,relax_one,0.45,2,0,2,74.05344939302682,-0.0496040129796732,43,43
3953,relax_one,0.45,5,2,3,38.63277917829137,-0.1368895750909734,22,26
3954,relax_one,0.45,0,0,0,0.0,0.2371971040620515,15,14
3955,relax_one,0.45,10,10,0,-12.015989575584795,0.2182128163776703,36,48
3956,relax_one,0.45,5,6,-1,10.538660362728583,0.0285607541128279,30,37
3957,relax_one,0.45,1,1,0,11.291031542015077,0.4128274646833886,10,13
3958,relax_one,0.45,0,0,0,0.0,0.1315746901767678,12,11
3959,relax_one,0.45,166,158,8,-2.2461218329752697,-0.1457459552588526,55,105
3960,relax_one,0.45,4,1,3,24.9343460382676,0.0717369188569861,13,17
3961,relax_one,0.45,1,0,1,69.42989930688853,-0.0391120315057583,30,29
3962,relax_one,0.45,3,8,-5,4.144908757845556,0.0932504682108656,36,43
3963,relax_one,0.45,32,15,17,8.848261408286056,-0.1908487374141306,40,60
3964,relax_one,0.45,2,1,1,-29.74554157369286,0.2327997944970211,13,17
3965,relax_one,0.45,13,12,1,1.5662346128612228,0.0061308616078052,23,30
3966,relax_one,0.45,2,1,1,30.658186181515816,-0.2629318189920939,12,16
3967,relax_one,0.45,0,1,-1,-77.11654156172241,0.1333556766458528,26,26
3968,relax_one,0.45,0,2,-2,-66.27147554660151,-0.3978793431515197,22,31
3969,relax_one,0.45,0,0,0,0.0,-0.0759538496405071,68,68
3970,relax_one,0.45,0,0,0,0.0,0.0228791605895303,23,22
3971,relax_one,0.45,0,0,0,0.0,0.2142147259309152,43,42
3972,relax_one,0.45,0,1,-1,-78.72654962789609,-0.2447157343632363,18,17
3973,relax_one,0.45,11,10,1,-0.8641982183826542,-0.2261622867693317,28,42
3974,relax_one,0.45,48,36,12,-0.162470782473278,0.0536429082044688,21,44
3975,relax_one,0.45,2,1,1,-9.89678287958317,-0.0832393506113455,36,37
3976,relax_one,0.45,0,0,0,0.0,0.0864690594261783,15,14
3977,relax_one,0.45,0,2,-2,-75.26631761512544,0.0752602417732045,14,16
3978,relax_one,0.45,225,229,-4,2.0236281284913886,-0.158239320538555,61,119
3979,relax_one,0.45,2,0,2,79.22750289251168,0.0062964900638036,19,20
3980,relax_one,0.45,0,0,0,0.0,0.0524193138745158,22,22
3981,relax_one,0.45,4,2,2,-2.48866068738603,0.1950324022559281,54,58
3982,relax_one,0.45,455,511,-56,-0.8967475131947467,-0.1990936903581665,65,135
3983,relax_one,0.45,1,1,0,-3.6102893524276993,-0.0116648012140756,16,18
3984,relax_one,0.45,6,6,0,-2.553708196333816,0.1102079546659088,17,27
3985,relax_one,0.45,15,17,-2,-0.5590009958927595,0.4142085519073576,54,71
3986,relax_one,0.45,0,2,-2,-66.1224401200961,0.2820014464859105,23,22
3987,relax_one,0.45,2,0,2,84.61996095073215,0.2092527112286816,13,16
3988,relax_one,0.45,217,110,107,0.754169157825153,-0.0880418045145624,85,131
3989,relax_one,0.45,42,32,10,-8.147449534453145,0.056915801207619,28,55
3990,relax_one,0.45,1,3,-2,25.966126723553515,-0.0232105033130566,18,24
3991,relax_one,0.45,1,2,-1,13.43568690320376,0.0654978973060056,19,22
3992,relax_one,0.45,4,2,2,31.480584842722514,0.0264438245544754,47,46
3993,relax_one,0.45,45,56,-11,-0.8882286756178175,0.1442585828558189,39,64
3994,relax_one,0.45,3,0,3,70.95263766795587,0.2531250207695545,17,18
3995,relax_one,0.45,1,1,0,-6.919569056721322,-0.1576945300901581,23,24
3996,relax_one,0.45,7,1,6,2.71629504393114,0.2839228896323855,13,16
3997,relax_one,0.45,23,22,1,3.272446888826515,-0.1148853793297608,40,56
3998,relax_one,0.45,1,1,0,-2.346903928143675,-0.1929450869663131,10,15
3999,relax_one,0.45,1,0,1,85.54492335606028,-0.0673451594196398,21,20
4000,relax_one,0.45,5,2,3,27.66114551612853,-0.0801172586628005,30,35
4001,relax_one,0.45,8,7,1,8.594688261886752,-0.1236339631795787,71,77
4002,just_relax,0.45,0,0,0,0.0,-0.1362571436676514,17,18
4003,just_relax,0.45,7,10,-3,-0.7220242713373608,0.0811845396067656,43,48
4004,just_relax,0.45,8,6,2,-2.2446119582685355,-0.1368668606697871,38,45
4005,just_relax,0.45,0,0,0,0.0,-0.227058867814697,12,12
4006,just_relax,0.45,17,19,-2,6.358719905160875,-0.0683025340997202,23,38
4007,just_relax,0.45,3,1,2,-4.495076992885551,-0.4021317287827379,19,22
4008,just_relax,0.45,850,936,-86,1.1650498724628164,-0.2662300981778135,35,143
4009,just_relax,0.45,3,15,-12,16.741620983545623,0.0797867984246261,92,91
4010,just_relax,0.45,18,27,-9,-2.539164338420157,0.0290619213492292,43,51
4011,just_relax,0.45,2,4,-2,9.755957175980598,0.0097797451059027,35,36
4012,just_relax,0.45,2,1,1,10.762609807302796,0.1110780967906783,11,13
4013,just_relax,0.45,23,21,2,17.198425048609096,0.7274729631357735,10,25
4014,just_relax,0.45,35,64,-29,3.976298505790993,-0.1118428689502362,86,136
4015,just_relax,0.45,0,0,0,0.0,0.3917646815425948,10,12
4016,just_relax,0.45,0,0,0,0.0,0.1231002175417422,32,31
4017,just_relax,0.45,5,2,3,-12.21741719200378,0.1259173594906663,20,26
4018,just_relax,0.45,0,0,0,0.0,0.2084438304260449,11,11
4019,just_relax,0.45,11,10,1,1.6298078754070957,-0.0149525589726873,34,42
4020,just_relax,0.45,10,24,-14,25.690844390021624,-0.3105134115203875,14,25
4021,just_relax,0.45,5,9,-4,18.154614147480245,-0.0800663037128728,31,46
4022,just_relax,0.45,2,2,0,5.9840297376913725,0.0983045692696794,42,45
4023,just_relax,0.45,1178,1126,52,-0.0687666311761105,-0.1663997613153228,39,173
4024,just_relax,0.45,14,10,4,5.796343730075144,0.1522357157568364,14,24
4025,just_relax,0.45,0,2,-2,-74.98574067948519,-0.0377789780409154,24,25
4026,just_relax,0.45,1,2,-1,-17.995407176303615,-0.0268998834171156,12,19
4027,just_relax,0.45,70,59,11,-1.325834923950886,0.0970165498488732,41,72
4028,just_relax,0.45,271,288,-17,3.6243428098701216,0.0935074567140493,59,115
4029,just_relax,0.45,8,7,1,-2.305560618350839,0.0484176050847902,32,37
4030,just_relax,0.45,0,0,0,0.0,0.101192498262277,20,20
4031,just_relax,0.45,28,28,0,1.7552201944420602,0.1359352841850679,12,31
4032,just_relax,0.45,0,0,0,0.0,0.4563658652479129,10,10
4033,just_relax,0.45,0,2,-2,-65.40635702593066,-0.3607322438404834,20,21
4034,just_relax,0.45,34,25,9,9.780833818946505,0.0659742360271209,39,52
4035,just_relax,0.45,345,486,-141,3.0170193296579058,0.0959679519687428,42,109
4036,just_relax,0.45,1,0,1,72.70170426592463,0.5518172762579943,25,28
4037,just_relax,0.45,204,283,-79,0.6227825311961723,0.1158857862642179,56,106
4038,just_relax,0.45,702,867,-165,10.356126763717306,-0.261776584644704,87,189
4039,just_relax,0.45,55,84,-29,2.782766172033398,-0.2793481838850884,56,82
4040,just_relax,0.45,1,1,0,6.658456832426083,0.0059089613860315,13,15
4041,just_relax,0.45,73,108,-35,-0.3808847951056933,-0.2027435339461671,36,63
4042,just_relax,0.45,2,0,2,43.7922915159978,-0.239479819067388,16,15
4043,just_relax,0.45,0,0,0,0.0,-0.0790179237615206,67,66
4044,just_relax,0.45,13,19,-6,-6.5772800261763535,0.081620505121542,42,60
4045,just_relax,0.45,0,0,0,0.0,0.1388605905727347,39,38
4046,just_relax,0.45,8,13,-5,10.783936523147418,0.2106677681572258,20,36
4047,just_relax,0.45,0,0,0,0.0,-0.1352934217798549,10,9
4048,just_relax,0.45,1,1,0,11.403394512959023,0.3167544225115768,13,15
4049,just_relax,0.45,8,18,-10,9.55336331325433,-0.1341222658381644,34,41
4050,just_relax,0.45,4,8,-4,6.109516367997458,0.1811148658196041,37,42
4051,just_relax,0.45,28,23,5,0.2725231547892548,0.1424290661949001,18,29
4052,just_relax,0.45,4,0,4,53.08615025436553,0.2143756011375737,23,22
4053,just_relax,0.45,0,0,0,0.0,0.5378252422243048,13,12
4054,just_relax,0.45,2,0,2,82.82519262430154,0.2101169735809871,15,14
4055,just_relax,0.45,1,0,1,41.00619223954848,0.1256887064771337,69,68
4056,just_relax,0.45,0,0,0,0.0,0.1986351174191245,40,39
4057,just_relax,0.45,20,4,16,-16.611335974597807,0.0635416173094981,89,93
4058,just_relax,0.45,15,12,3,-0.8423072864392935,0.1040164874583191,20,32
4059,just_relax,0.45,2,3,-1,11.20201879970439,0.0535605032672915,69,83
4060,just_relax,0.45,1,2,-1,-28.74939563141228,-0.4610787358780222,12,15
4061,just_relax,0.45,0,0,0,0.0,-0.0273026892275667,15,14
4062,just_relax,0.45,4,1,3,-18.70433631097545,0.035147093154195,23,26
4063,just_relax,0.45,2,2,0,-0.4356321930164455,-0.1849053273231913,12,20
4064,just_relax,0.45,165,222,-57,4.256743303740421,0.1277335544520689,64,122
4065,just_relax,0.45,28,14,14,11.21704019752206,0.1977379711959265,58,71
4066,just_relax,0.45,0,0,0,0.0,-0.0548526227628231,20,19
4067,just_relax,0.45,300,331,-31,2.3316326849402884,0.0976247763544725,100,191
4068,just_relax,0.45,39,29,10,3.438105125252441,-0.0961267471572774,41,61
4069,just_relax,0.45,19,29,-10,9.759537943931548,0.0639551274838686,13,31
4070,just_relax,0.45,2,2,0,5.1707614362757255,0.1223521212266846,10,15
4071,just_relax,0.45,10,10,0,-6.843310712875521,0.049941767136669,37,47
4072,just_relax,0.45,0,4,-4,-68.86702586720989,-0.04358854493111,21,21
4073,just_relax,0.45,0,0,0,0.0,-0.2144061668507602,11,10
4074,just_relax,0.45,72,48,24,-2.5009402204197784,0.0138326831175091,44,80
4075,just_relax,0.45,3,2,1,-1.4232398576577765,0.0986587371831224,12,21
4076,just_relax,0.45,3,3,0,-11.19012944587167,0.3228662407096,37,43
4077,just_relax,0.45,10,4,6,-4.834572372597677,0.0641203254231146,41,52
4078,just_relax,0.45,5,1,4,-21.053964402936245,0.13165917259612,90,89
4079,just_relax,0.45,0,2,-2,-86.54050650987207,-0.0313186091426143,22,21
4080,just_relax,0.45,0,21,-21,-63.62757191882096,-0.0240603371230608,37,43
4081,just_relax,0.45,0,2,-2,-44.91006243761328,0.1353879103932259,47,47
4082,just_relax,0.45,10,4,6,-4.686023706531145,-0.1336016890314995,12,20
4083,just_relax,0.45,170,133,37,2.7470843614748546,-0.0275731309150596,84,124
4084,just_relax,0.45,2,5,-3,10.897322793620988,-0.221266740623283,88,92
4085,just_relax,0.45,413,324,89,1.562827351095109,0.0046013028853636,59,122
4086,just_relax,0.45,3,2,1,-14.548216372314869,-0.2491576003844692,26,31
4087,just_relax,0.45,0,0,0,0.0,-0.1571918597296295,28,27
4088,just_relax,0.45,12,3,9,4.813568769246331,0.4370011315016896,18,26
4089,just_relax,0.45,2,2,0,-17.088913742086163,0.3925379192502441,23,26
4090,just_relax,0.45,0,2,-2,-66.95385783323775,0.0441630718705764,43,43
4091,just_relax,0.45,0,1,-1,-65.41531176776834,-0.2326745356022428,22,26
4092,just_relax,0.45,0,0,0,0.0,0.2275005770666099,15,14
4093,just_relax,0.45,22,30,-8,1.328092701696754,0.1638118563851963,36,48
4094,just_relax,0.45,14,5,9,10.215019846579947,0.028212277482589,30,37
4095,just_relax,0.45,2,4,-2,-4.906241382798385,0.0404058006378873,10,13
4096,just_relax,0.45,0,1,-1,-82.0632838814238,0.2101302942443502,12,11
4097,just_relax,0.45,172,213,-41,1.881475452840931,0.1060828584739769,55,105
4098,just_relax,0.45,1,2,-1,21.609206213345715,0.0310592155507324,13,17
4099,just_relax,0.45,0,1,-1,-53.46050447510123,-0.2255854752093443,30,29
4100,just_relax,0.45,17,11,6,6.581581404008098,0.0310131532845876,36,43
4101,just_relax,0.45,38,39,-1,0.0472769673425119,-0.1193913120165384,40,60
4102,just_relax,0.45,0,1,-1,-67.61225016971284,0.4320134686006928,13,17
4103,just_relax,0.45,5,9,-4,10.813906224168337,0.3450288655075141,23,30
4104,just_relax,0.45,0,1,-1,-57.38071650692758,0.1825135503026946,12,16
4105,just_relax,0.45,0,2,-2,-69.14175325336903,-0.1210860207808743,26,26
4106,just_relax,0.45,4,2,2,10.61146607978111,0.4784499722598933,22,31
4107,just_relax,0.45,1,20,-19,5.602249359200158,-0.0378530306441765,68,68
4108,just_relax,0.45,0,0,0,0.0,0.0463342374589585,23,22
4109,just_relax,0.45,0,3,-3,-69.66837734175574,-0.1133513375625558,43,42
4110,just_relax,0.45,1,0,1,77.49462513163093,-0.1192249085142266,18,17
4111,just_relax,0.45,2,10,-8,32.08846060138577,-0.1603201811384701,28,42
4112,just_relax,0.45,50,94,-44,0.8560442308463792,-0.2934793529050693,21,44
4113,just_relax,0.45,3,1,2,22.849342462450583,0.0169051212716812,36,37
4114,just_relax,0.45,0,0,0,0.0,0.0136294092850038,15,14
4115,just_relax,0.45,2,0,2,76.33132632736002,-0.0838985405217122,14,16
4116,just_relax,0.45,225,235,-10,1.896506629903108,0.1587200952636914,61,119
4117,just_relax,0.45,1,1,0,-2.35513906521723,0.293407793335643,19,20
4118,just_relax,0.45,2,1,1,15.48694051680215,-0.2378714435603638,22,22
4119,just_relax,0.45,0,18,-18,-61.69457401334057,-0.0897262766150251,54,58
4120,just_relax,0.45,604,788,-184,9.347577522896296,-0.2380116177432333,65,135
4121,just_relax,0.45,2,0,2,77.41426343988462,-0.1173881381437487,16,18
4122,just_relax,0.45,8,5,3,-5.349187056285729,0.2896764056380085,17,27
4123,just_relax,0.45,22,18,4,-6.275607225366045,-0.3907440736513348,54,71
4124,just_relax,0.45,1,3,-2,34.84716679448219,0.023019466493273,23,22
4125,just_relax,0.45,3,2,1,-8.785028323917324,0.0891443811536744,13,16
4126,just_relax,0.45,161,175,-14,3.321626368002597,0.0816702816011653,85,131
4127,just_relax,0.45,41,48,-7,-6.699828031580246,0.3262580348908768,28,55
4128,just_relax,0.45,3,14,-11,-11.415283063692833,-0.1846068021600361,18,24
4129,just_relax,0.45,5,1,4,-9.591553884614257,0.0002395042836311,19,22
4130,just_relax,0.45,3,5,-2,13.132492059596387,0.1435557393512515,47,46
4131,just_relax,0.45,30,47,-17,10.404620893358,0.1150460945385629,39,64
4132,just_relax,0.45,1,1,0,0.0106832197983663,0.1329227633204861,17,18
4133,just_relax,0.45,3,4,-1,-3.194802495327352,-0.0321200488279919,23,24
4134,just_relax,0.45,2,3,-1,1.6866133108094914,0.0503520028880249,13,16
4135,just_relax,0.45,16,28,-12,4.372472116099594,0.1657075058778253,40,56
4136,just_relax,0.45,0,0,0,0.0,-0.3809331377252103,10,15
4137,just_relax,0.45,1,1,0,0.1996133810958582,0.1014079736510737,21,20
4138,just_relax,0.45,4,5,-1,-17.773187320941,0.2195070211496483,30,35
4139,just_relax,0.45,6,7,-1,-14.664158152580807,0.0260794789251262,71,77
4140,relax_and_recompute,0.5,3,0,3,72.92391148429897,0.3024517920428047,17,18
4141,relax_and_recompute,0.5,5,1,4,8.068374567788588,-0.1448983907826471,43,48
4142,relax_and_recompute,0.5,7,5,2,-20.22822578254715,-0.0399956978913824,38,45
4143,relax_and_recompute,0.5,0,0,0,0.0,-0.4780416445235862,12,12
4144,relax_and_recompute,0.5,17,19,-2,-0.25156964179358,0.0712552504514572,23,38
4145,relax_and_recompute,0.5,1,1,0,-24.990481363885905,-0.2508254415122404,19,22
4146,relax_and_recompute,0.5,797,801,-4,0.6908427754103386,-0.0960203932673279,35,143
4147,relax_and_recompute,0.5,2,0,2,74.20910596844581,0.2209403554898044,92,91
4148,relax_and_recompute,0.5,9,10,-1,-17.116557291737855,0.0410314378432561,43,51
4149,relax_and_recompute,0.5,0,0,0,0.0,0.1064082117805433,35,36
4150,relax_and_recompute,0.5,0,0,0,0.0,0.295958657706532,11,13
4151,relax_and_recompute,0.5,25,25,0,2.582566567834654,0.2119423659856367,10,25
4152,relax_and_recompute,0.5,22,21,1,-1.646043376461094,-0.0379651553825874,86,136
4153,relax_and_recompute,0.5,0,0,0,0.0,-0.0456868131972699,10,12
4154,relax_and_recompute,0.5,0,0,0,0.0,0.0856595989341223,32,31
4155,relax_and_recompute,0.5,16,5,11,-7.23171884826985,0.1862290069680209,20,26
4156,relax_and_recompute,0.5,0,2,-2,-62.29111809967617,0.0001064638381896,11,11
4157,relax_and_recompute,0.5,3,2,1,5.488466142851578,-0.0306892573439256,34,42
4158,relax_and_recompute,0.5,13,11,2,0.7670805332933384,-0.343754026389745,14,25
4159,relax_and_recompute,0.5,8,11,-3,16.87003968375634,-0.0597182107972917,31,46
4160,relax_and_recompute,0.5,0,0,0,0.0,0.1065322584501298,42,45
4161,relax_and_recompute,0.5,1170,1109,61,-1.610992691945441,-0.1628330400830946,39,173
4162,relax_and_recompute,0.5,11,14,-3,7.10539323402061,0.0295623465716441,14,24
4163,relax_and_recompute,0.5,0,0,0,0.0,0.0026498781895299,24,25
4164,relax_and_recompute,0.5,1,1,0,8.538336276047815,-0.0324757454923269,12,19
4165,relax_and_recompute,0.5,53,46,7,-0.0083398283851749,-0.1441249660548776,41,72
4166,relax_and_recompute,0.5,262,158,104,1.446406575806094,0.0345761033574586,59,115
4167,relax_and_recompute,0.5,8,3,5,4.925011529812565,-0.078530598946026,32,37
4168,relax_and_recompute,0.5,0,0,0,0.0,-0.279887464866574,20,20
4169,relax_and_recompute,0.5,22,24,-2,-1.86170973493492,-0.1118618847583647,12,31
4170,relax_and_recompute,0.5,0,0,0,0.0,0.2422963820453989,10,10
4171,relax_and_recompute,0.5,0,1,-1,-72.36602166155637,-0.3529486537685949,20,21
4172,relax_and_recompute,0.5,26,13,13,-2.7932041389847626,-0.2005967470867921,39,52
4173,relax_and_recompute,0.5,334,327,7,-1.0368913803640396,0.2238476389406614,42,109
4174,relax_and_recompute,0.5,1,2,-1,-2.6636536894853435,-0.0138628521032955,25,28
4175,relax_and_recompute,0.5,195,180,15,-0.3099965999158698,0.0032219383019734,56,106
4176,relax_and_recompute,0.5,429,358,71,0.1907163234361562,0.2135767416470742,87,189
4177,relax_and_recompute,0.5,42,38,4,-3.1935463221742566,0.1029821589064866,56,82
4178,relax_and_recompute,0.5,1,1,0,28.15701839608046,0.2877867075810671,13,15
4179,relax_and_recompute,0.5,98,74,24,-2.514597553833731,0.1542533638072055,36,63
4180,relax_and_recompute,0.5,0,0,0,0.0,-0.303254038770579,16,15
4181,relax_and_recompute,0.5,0,0,0,0.0,-0.1092963744266966,67,66
4182,relax_and_recompute,0.5,12,23,-11,2.810010768531548,-0.324219569944589,42,60
4183,relax_and_recompute,0.5,2,0,2,85.06584312294495,0.0508022407609055,39,38
4184,relax_and_recompute,0.5,11,11,0,12.807245979359188,-0.0375385386757356,20,36
4185,relax_and_recompute,0.5,0,0,0,0.0,-0.3461842067097941,10,9
4186,relax_and_recompute,0.5,1,0,1,53.71597079181713,0.0011536998029729,13,15
4187,relax_and_recompute,0.5,12,12,0,6.470199694894831,-0.0657887717294319,34,41
4188,relax_and_recompute,0.5,1,15,-14,5.858807491498439,0.2346065459372508,37,42
4189,relax_and_recompute,0.5,18,14,4,9.331299397097515,0.4121871310902635,18,29
4190,relax_and_recompute,0.5,0,0,0,0.0,0.2304011021906331,23,22
4191,relax_and_recompute,0.5,0,0,0,0.0,0.056683400502728,13,12
4192,relax_and_recompute,0.5,0,0,0,0.0,-0.0433868803504251,15,14
4193,relax_and_recompute,0.5,2,0,2,64.72428938395711,-0.1049735199347479,69,68
4194,relax_and_recompute,0.5,0,0,0,0.0,0.1127892200152429,40,39
4195,relax_and_recompute,0.5,6,1,5,10.148234449378933,0.2280226721958079,89,93
4196,relax_and_recompute,0.5,11,8,3,11.841025449179677,0.0274112985072012,20,32
4197,relax_and_recompute,0.5,8,2,6,-1.2987142177035338,0.0334642566981123,69,83
4198,relax_and_recompute,0.5,1,1,0,1.2007676185320122,0.4424338203159971,12,15
4199,relax_and_recompute,0.5,1,0,1,73.82544049620935,0.2841485608297969,15,14
4200,relax_and_recompute,0.5,2,1,1,-11.481267703326154,-0.1345632002756196,23,26
4201,relax_and_recompute,0.5,3,5,-2,-2.454528418435139,-0.4103890430087863,12,20
4202,relax_and_recompute,0.5,279,197,82,-2.4938061608299265,-0.2738115308759824,64,122
4203,relax_and_recompute,0.5,12,6,6,4.088113744803849,0.0691224945636868,58,71
4204,relax_and_recompute,0.5,4,0,4,66.78646368247134,0.3129284448033876,20,19
4205,relax_and_recompute,0.5,368,327,41,-3.506356463623632,0.1200835235722393,100,191
4206,relax_and_recompute,0.5,34,29,5,3.801475758174824,-0.0871072275691995,41,61
4207,relax_and_recompute,0.5,24,13,11,-4.038585698954151,0.0398110450015382,13,31
4208,relax_and_recompute,0.5,8,3,5,3.3496873642904177,0.0621884982976006,10,15
4209,relax_and_recompute,0.5,15,9,6,0.7352829827665701,-0.0368231242154656,37,47
4210,relax_and_recompute,0.5,2,0,2,71.52639399957565,-0.081037615721677,21,21
4211,relax_and_recompute,0.5,0,0,0,0.0,-0.1954437495064651,11,10
4212,relax_and_recompute,0.5,75,38,37,-0.2747604775363044,-0.1442877193995311,44,80
4213,relax_and_recompute,0.5,7,5,2,-2.0544831249315507,0.2031568801951889,12,21
4214,relax_and_recompute,0.5,13,4,9,-10.373478052471654,-0.0824641201732959,37,43
4215,relax_and_recompute,0.5,13,24,-11,-0.0634703299937911,0.0595386839930092,41,52
4216,relax_and_recompute,0.5,1,1,0,2.473312732028788,-0.251421478820509,90,89
4217,relax_and_recompute,0.5,0,0,0,0.0,0.0519793828787229,22,21
4218,relax_and_recompute,0.5,0,0,0,0.0,0.2457259898348123,37,43
4219,relax_and_recompute,0.5,2,0,2,71.56302938116556,-0.0231640079861544,47,47
4220,relax_and_recompute,0.5,10,5,5,4.137768472243167,-0.1341248392227341,12,20
4221,relax_and_recompute,0.5,147,114,33,-1.1903992010267714,-0.0480543934125623,84,124
4222,relax_and_recompute,0.5,2,1,1,22.36139595438169,0.0461418024323283,88,92
4223,relax_and_recompute,0.5,418,262,156,-5.370186771068674,-0.1386118658811554,59,122
4224,relax_and_recompute,0.5,9,6,3,8.291853903024844,0.2248174427942998,26,31
4225,relax_and_recompute,0.5,0,0,0,0.0,-0.1347257747276953,28,27
4226,relax_and_recompute,0.5,3,3,0,-0.5737083543957056,-0.0951807204242261,18,26
4227,relax_and_recompute,0.5,2,1,1,-31.20187377610278,-0.2133550936097094,23,26
4228,relax_and_recompute,0.5,0,0,0,0.0,0.1132359643918599,43,43
4229,relax_and_recompute,0.5,0,2,-2,-63.84512869799555,0.0513435663499464,22,26
4230,relax_and_recompute,0.5,0,0,0,0.0,-0.0975801897001295,15,14
4231,relax_and_recompute,0.5,26,9,17,6.546610885580861,0.096200536294647,36,48
4232,relax_and_recompute,0.5,18,9,9,-14.54620244062354,-0.0386165510608856,30,37
4233,relax_and_recompute,0.5,1,1,0,2.9143482097112496,0.022982637360536,10,13
4234,relax_and_recompute,0.5,0,2,-2,-65.85675550728479,0.0669726813229396,12,11
4235,relax_and_recompute,0.5,228,188,40,-0.0120450578061337,0.1078680430588598,55,105
4236,relax_and_recompute,0.5,1,1,0,18.87724761610336,-0.0612212801185753,13,17
4237,relax_and_recompute,0.5,2,1,1,-22.70779659126137,0.298129695511989,30,29
4238,relax_and_recompute,0.5,6,1,5,-2.43085404367433,-0.3025582879224007,36,43
4239,relax_and_recompute,0.5,25,14,11,5.961458414893656,-0.1710255378695904,40,60
4240,relax_and_recompute,0.5,4,0,4,65.83445862394761,0.1169347580928579,13,17
4241,relax_and_recompute,0.5,8,10,-2,-1.922333695496676,-0.161263974965223,23,30
4242,relax_and_recompute,0.5,2,1,1,32.14509964939599,-0.0190913124852797,12,16
4243,relax_and_recompute,0.5,5,0,5,73.26947858961185,0.0781362154771565,26,26
4244,relax_and_recompute,0.5,3,2,1,-0.7531263112761906,0.2984759147703906,22,31
4245,relax_and_recompute,0.5,0,0,0,0.0,0.1555948026197411,68,68
4246,relax_and_recompute,0.5,0,0,0,0.0,-0.0274015430648164,23,22
4247,relax_and_recompute,0.5,3,0,3,60.03089711384947,-0.0578650643566626,43,42
4248,relax_and_recompute,0.5,0,0,0,0.0,-0.2415376184328634,18,17
4249,relax_and_recompute,0.5,7,7,0,23.619227248827485,0.2753644818155532,28,42
4250,relax_and_recompute,0.5,50,44,6,-1.6248806354247949,0.0982455016071853,21,44
4251,relax_and_recompute,0.5,1,0,1,80.2467893166124,-0.2600554375763017,36,37
4252,relax_and_recompute,0.5,0,0,0,0.0,0.0495650145834338,15,14
4253,relax_and_recompute,0.5,1,0,1,87.36928346182444,0.4041193769379444,14,16
4254,relax_and_recompute,0.5,222,170,52,-0.2085731440891152,-0.0903784103944831,61,119
4255,relax_and_recompute,0.5,0,0,0,0.0,0.356332329527648,19,20
4256,relax_and_recompute,0.5,1,2,-1,-52.11769783364461,0.1839793391912008,22,22
4257,relax_and_recompute,0.5,0,0,0,0.0,-0.1987282577772211,54,58
4258,relax_and_recompute,0.5,509,417,92,-1.77828508388928,0.1385952376626307,65,135
4259,relax_and_recompute,0.5,5,0,5,53.87066379788689,0.0832920369167347,16,18
4260,relax_and_recompute,0.5,13,5,8,-0.0920859044203439,-0.2631919089223256,17,27
4261,relax_and_recompute,0.5,32,10,22,-9.359851754513812,-0.1578512753991109,54,71
4262,relax_and_recompute,0.5,0,2,-2,-77.2459093924816,-0.3213971051543715,23,22
4263,relax_and_recompute,0.5,2,1,1,9.394515705423842,0.2985384295990502,13,16
4264,relax_and_recompute,0.5,139,131,8,-0.3453291315480271,0.0542908212599292,85,131
4265,relax_and_recompute,0.5,46,34,12,-1.7376379224369884,0.2600543657553517,28,55
4266,relax_and_recompute,0.5,2,4,-2,15.588503311393415,0.1171244098814608,18,24
4267,relax_and_recompute,0.5,2,2,0,19.930169544910733,0.0249371501145505,19,22
4268,relax_and_recompute,0.5,2,0,2,48.4764950318357,0.1706322723434249,47,46
4269,relax_and_recompute,0.5,34,22,12,-6.503378560532845,0.062461354680439,39,64
4270,relax_and_recompute,0.5,1,1,0,10.4205613732926,0.11586579192737,17,18
4271,relax_and_recompute,0.5,1,1,0,8.697885791728481,0.3673856071865601,23,24
4272,relax_and_recompute,0.5,1,1,0,-13.241905224325151,0.0548416785409798,13,16
4273,relax_and_recompute,0.5,36,9,27,-8.163711867383569,-0.2875737190078279,40,56
4274,relax_and_recompute,0.5,0,0,0,0.0,0.105534137855248,10,15
4275,relax_and_recompute,0.5,0,2,-2,-63.923583708782814,0.6441480693535144,21,20
4276,relax_and_recompute,0.5,6,3,3,-10.535695314140916,0.2418503377211653,30,35
4277,relax_and_recompute,0.5,3,3,0,30.521965917807933,0.4204762915538322,71,77
4278,relax_one,0.5,2,1,1,2.623299869167411,-0.2485185664426903,17,18
4279,relax_one,0.5,6,7,-1,-0.4287168944954231,-0.0377174228334694,43,48
4280,relax_one,0.5,7,2,5,20.176137492603125,-0.1292305441702614,38,45
4281,relax_one,0.5,0,0,0,0.0,0.0530248343590207,12,12
4282,relax_one,0.5,10,4,6,-4.651845761910067,0.2403088828063725,23,38
4283,relax_one,0.5,1,3,-2,-3.599271822196556,-0.0100264431908452,19,22
4284,relax_one,0.5,790,764,26,-0.3217423009507882,-0.1444524155543577,35,143
4285,relax_one,0.5,1,5,-4,13.223512472797095,0.0224855575133973,92,91
4286,relax_one,0.5,8,2,6,32.065464666515844,0.1466517285878151,43,51
4287,relax_one,0.5,5,2,3,19.11696123060237,-0.1081173273320265,35,36
4288,relax_one,0.5,4,1,3,7.839798010284213,0.2850042191115164,11,13
4289,relax_one,0.5,28,20,8,-8.128581921662303,-0.0440703444101078,10,25
4290,relax_one,0.5,19,15,4,-7.1556424101160445,0.2971074619333073,86,136
4291,relax_one,0.5,0,0,0,0.0,0.1894008562161546,10,12
4292,relax_one,0.5,0,0,0,0.0,0.0450403600821173,32,31
4293,relax_one,0.5,3,3,0,11.019781246957775,0.0414538738010844,20,26
4294,relax_one,0.5,0,0,0,0.0,-0.0508176204186172,11,11
4295,relax_one,0.5,5,4,1,-5.115603361858284,0.1094661984214883,34,42
4296,relax_one,0.5,11,13,-2,-0.1208500115394457,-0.2879640288408696,14,25
4297,relax_one,0.5,7,4,3,-4.797313113921675,0.0103056878987302,31,46
4298,relax_one,0.5,3,2,1,-5.662988536061057,0.1046197586678375,42,45
4299,relax_one,0.5,1056,1119,-63,0.2559505557072299,0.1329360007856203,39,173
4300,relax_one,0.5,8,14,-6,9.944194413430822,-0.0884597888025285,14,24
4301,relax_one,0.5,0,0,0,0.0,-0.1763307540252155,24,25
4302,relax_one,0.5,3,2,1,6.854891435419503,-0.3969599780925745,12,19
4303,relax_one,0.5,104,59,45,-0.6126937206055345,-0.0217383677990669,41,72
4304,relax_one,0.5,173,176,-3,-0.9566243988530232,0.2846405708609768,59,115
4305,relax_one,0.5,6,11,-5,6.786931659042978,-0.0338733240430586,32,37
4306,relax_one,0.5,3,0,3,69.70017232278269,-0.1280984281937351,20,20
4307,relax_one,0.5,22,26,-4,-1.1663912521130726,0.2848658194800663,12,31
4308,relax_one,0.5,0,1,-1,-50.56444892120314,0.0307228640023097,10,10
4309,relax_one,0.5,0,2,-2,-77.34469404458993,0.1787046273998396,20,21
4310,relax_one,0.5,30,19,11,-10.871564775372292,-0.1244247819995396,39,52
4311,relax_one,0.5,376,354,22,0.655398515727498,0.1872640072217627,42,109
4312,relax_one,0.5,1,0,1,80.7710360630708,0.1269395866960101,25,28
4313,relax_one,0.5,205,161,44,-0.6996664376071067,0.0349765209391205,56,106
4314,relax_one,0.5,479,480,-1,-0.2895804263280723,0.1253053041766905,87,189
4315,relax_one,0.5,40,38,2,0.4122680160299126,0.148456683907077,56,82
4316,relax_one,0.5,1,1,0,-4.170208045476187,0.2147378422452651,13,15
4317,relax_one,0.5,119,92,27,-1.81266137454282,0.5396247734743987,36,63
4318,relax_one,0.5,1,0,1,83.18502372356573,0.3420853432439078,16,15
4319,relax_one,0.5,0,0,0,0.0,0.4064107922050754,67,66
4320,relax_one,0.5,28,18,10,0.7251008551567963,-0.561892298983805,42,60
4321,relax_one,0.5,0,0,0,0.0,-0.1243328113909477,39,38
4322,relax_one,0.5,23,8,15,-16.61348872044242,0.0438802427565229,20,36
4323,relax_one,0.5,0,0,0,0.0,-0.050203176097673,10,9
4324,relax_one,0.5,0,2,-2,-75.80612682572931,-0.1720801942187437,13,15
4325,relax_one,0.5,7,9,-2,-4.31403333350967,-0.0307957458627192,34,41
4326,relax_one,0.5,6,8,-2,-9.697631461953732,-0.2886794236445954,37,42
4327,relax_one,0.5,20,20,0,-3.212686496223768,0.2809595125453556,18,29
4328,relax_one,0.5,0,0,0,0.0,-0.0570455769413981,23,22
4329,relax_one,0.5,0,0,0,0.0,-0.0696074048593837,13,12
4330,relax_one,0.5,0,0,0,0.0,0.2863329700302889,15,14
4331,relax_one,0.5,0,0,0,0.0,0.0431159146938335,69,68
4332,relax_one,0.5,1,0,1,89.83034639278313,0.2645814290553109,40,39
4333,relax_one,0.5,3,3,0,22.460240672485952,-0.129206530060105,89,93
4334,relax_one,0.5,11,9,2,8.403811852911687,-0.0042394152794212,20,32
4335,relax_one,0.5,5,2,3,-4.929400620741319,-0.1412378917593668,69,83
4336,relax_one,0.5,0,1,-1,-70.53930349744695,0.4371518041340314,12,15
4337,relax_one,0.5,0,1,-1,-81.8585672711933,-0.1399969287802145,15,14
4338,relax_one,0.5,1,2,-1,8.821407617920656,0.0781546716392966,23,26
4339,relax_one,0.5,6,2,4,-15.832935882088776,0.149271388682739,12,20
4340,relax_one,0.5,216,200,16,0.4289814536676175,-0.1188740774723462,64,122
4341,relax_one,0.5,9,15,-6,1.1859054380507388,-0.0108622535092063,58,71
4342,relax_one,0.5,0,0,0,0.0,-0.226786467800782,20,19
4343,relax_one,0.5,363,324,39,-4.089782382502342,0.1190097184127207,100,191
4344,relax_one,0.5,60,34,26,-0.0465045038525389,0.1467760131303972,41,61
4345,relax_one,0.5,20,25,-5,5.155766913275585,0.1780474851845174,13,31
4346,relax_one,0.5,5,2,3,4.241559190802185,0.1183259806009143,10,15
4347,relax_one,0.5,8,14,-6,-0.7247052085336136,-0.1746375388408988,37,47
4348,relax_one,0.5,1,1,0,9.288861098715302,0.0288335609826141,21,21
4349,relax_one,0.5,0,0,0,0.0,-0.2651950276259669,11,10
4350,relax_one,0.5,77,52,25,-0.2337899015436946,0.0923092034869236,44,80
4351,relax_one,0.5,2,3,-1,2.109323401617729,0.2183305250593852,12,21
4352,relax_one,0.5,0,6,-6,-50.81861225043742,0.1000381602562753,37,43
4353,relax_one,0.5,16,7,9,3.450861630324056,-0.066560496920071,41,52
4354,relax_one,0.5,0,0,0,0.0,0.2694931234324731,90,89
4355,relax_one,0.5,0,0,0,0.0,-0.3284486810077159,22,21
4356,relax_one,0.5,2,0,2,72.80690116360415,0.1535264950188992,37,43
4357,relax_one,0.5,1,1,0,5.448100699023584,0.1426373700872737,47,47
4358,relax_one,0.5,10,7,3,-8.090087049131732,-0.3404505058067788,12,20
4359,relax_one,0.5,106,127,-21,3.8827236312294673,-0.0107351132438381,84,124
4360,relax_one,0.5,0,19,-19,-52.2103842778461,-0.0424335005319671,88,92
4361,relax_one,0.5,294,274,20,1.536803039525438,0.2599017763665187,59,122
4362,relax_one,0.5,5,10,-5,10.625586109218098,-0.3418435120161335,26,31
4363,relax_one,0.5,0,0,0,0.0,0.1417668418510519,28,27
4364,relax_one,0.5,5,2,3,4.399569808846721,0.0369595637909864,18,26
4365,relax_one,0.5,6,3,3,-2.767801453975963,-0.1587494303087272,23,26
4366,relax_one,0.5,1,0,1,78.95750705276241,0.0015045079144005,43,43
4367,relax_one,0.5,2,2,0,-1.584874516147437,-0.0521948662050661,22,26
4368,relax_one,0.5,0,0,0,0.0,0.1115305060240718,15,14
4369,relax_one,0.5,14,17,-3,12.202284039037975,0.2386867742156633,36,48
4370,relax_one,0.5,2,3,-1,13.427526795145576,-0.1671774890118935,30,37
4371,relax_one,0.5,1,2,-1,-4.988529998726847,-0.0077699950427998,10,13
4372,relax_one,0.5,1,1,0,-9.208247285781908,0.5604713176682347,12,11
4373,relax_one,0.5,206,194,12,-1.7420605142335432,-0.0909224983447478,55,105
4374,relax_one,0.5,1,1,0,8.145077257251572,-0.2389154841538064,13,17
4375,relax_one,0.5,0,0,0,0.0,0.3539519523581921,30,29
4376,relax_one,0.5,25,4,21,8.99392288003682,0.1646654671670993,36,43
4377,relax_one,0.5,16,12,4,2.230878267811242,0.2124799060974628,40,60
4378,relax_one,0.5,0,0,0,0.0,-0.4076104455822983,13,17
4379,relax_one,0.5,6,7,-1,23.027649650206307,0.4134355085432968,23,30
4380,relax_one,0.5,3,0,3,55.70793907095071,0.1744437596709629,12,16
4381,relax_one,0.5,0,1,-1,-73.73978638107909,-0.305574867649991,26,26
4382,relax_one,0.5,3,3,0,5.096146859481543,-0.2565207575084551,22,31
4383,relax_one,0.5,2,0,2,78.52220870471226,0.0446099506207939,68,68
4384,relax_one,0.5,0,0,0,0.0,-0.2083625603946961,23,22
4385,relax_one,0.5,0,0,0,0.0,-0.0024125963787089,43,42
4386,relax_one,0.5,0,0,0,0.0,0.0799139287017017,18,17
4387,relax_one,0.5,5,2,3,23.582084155144628,-0.327339654038747,28,42
4388,relax_one,0.5,43,41,2,-1.1595309054078768,-0.3411295604258374,21,44
4389,relax_one,0.5,3,3,0,-19.444588323010443,0.1023026359628503,36,37
4390,relax_one,0.5,0,0,0,0.0,0.0409997184319352,15,14
4391,relax_one,0.5,2,1,1,-21.768673481055338,-0.1066108422634348,14,16
4392,relax_one,0.5,274,212,62,-2.486678798623693,0.0870285917639372,61,119
4393,relax_one,0.5,0,0,0,0.0,0.0720471657588143,19,20
4394,relax_one,0.5,3,1,2,11.923982297788116,0.1574621789949176,22,22
4395,relax_one,0.5,0,4,-4,-68.00423689289634,0.0521865559213424,54,58
4396,relax_one,0.5,471,408,63,-2.6901674726593114,0.4178342706867672,65,135
4397,relax_one,0.5,1,1,0,44.261774286232864,-0.0276141899179669,16,18
4398,relax_one,0.5,14,12,2,-6.35034470440862,-0.0532067428870932,17,27
4399,relax_one,0.5,14,20,-6,1.837242297806739,0.1296277741297407,54,71
4400,relax_one,0.5,0,0,0,0.0,0.2653578682162311,23,22
4401,relax_one,0.5,0,0,0,0.0,-0.1597560697546649,13,16
4402,relax_one,0.5,159,265,-106,1.6979146550904076,0.0336613951566651,85,131
4403,relax_one,0.5,43,31,12,-4.9692357120077375,-0.2029682438509495,28,55
4404,relax_one,0.5,5,2,3,20.70769587299968,0.1621395478833721,18,24
4405,relax_one,0.5,1,2,-1,0.7360217060618908,-0.0736202923983782,19,22
4406,relax_one,0.5,3,2,1,14.063056411175973,-0.1822191113102156,47,46
4407,relax_one,0.5,31,22,9,-9.3771908727648,0.2198171330767816,39,64
4408,relax_one,0.5,1,3,-2,33.18893077753894,0.5695564372663753,17,18
4409,relax_one,0.5,1,1,0,-20.95969824344195,-0.0694792993131467,23,24
4410,relax_one,0.5,5,2,3,-0.8625350042625826,0.3124909706443907,13,16
4411,relax_one,0.5,11,17,-6,-0.9983441618714366,0.4384630720117608,40,56
4412,relax_one,0.5,1,0,1,88.93701561205522,-0.1224036711106014,10,15
4413,relax_one,0.5,0,0,0,0.0,-0.2092309651715329,21,20
4414,relax_one,0.5,3,1,2,4.300990783133386,0.0055071888437262,30,35
4415,relax_one,0.5,4,4,0,14.107555278054017,-0.1042365041810178,71,77
4416,just_relax,0.5,1,1,0,-16.47719381194915,-0.2375466834657715,17,18
4417,just_relax,0.5,12,16,-4,2.530909578330224,0.1953033355114373,43,48
4418,just_relax,0.5,7,3,4,-0.2167567447885261,-0.1140090093154341,38,45
4419,just_relax,0.5,0,2,-2,-69.79198738698744,0.0831203075982623,12,12
4420,just_relax,0.5,19,17,2,-0.3657508839600822,-0.2550797468760724,23,38
4421,just_relax,0.5,1,0,1,61.04499736287532,0.4181587786222988,19,22
4422,just_relax,0.5,711,878,-167,1.2051916620824557,-0.0919707350246651,35,143
4423,just_relax,0.5,3,8,-5,-11.346843313735503,-0.1234993210439953,92,91
4424,just_relax,0.5,15,65,-50,6.264574815452676,-0.0646023399450197,43,51
4425,just_relax,0.5,0,2,-2,-74.25939187160529,0.0309978147615846,35,36
4426,just_relax,0.5,0,0,0,0.0,-0.1237577233584894,11,13
4427,just_relax,0.5,18,24,-6,17.342638661029746,-0.0115653235844797,10,25
4428,just_relax,0.5,17,51,-34,7.6616267455968625,-0.307126769926628,86,136
4429,just_relax,0.5,0,0,0,0.0,0.1315642879240721,10,12
4430,just_relax,0.5,0,0,0,0.0,0.0024046606676693,32,31
4431,just_relax,0.5,4,2,2,4.659216235960784,0.1059592882724499,20,26
4432,just_relax,0.5,0,0,0,0.0,0.132941042605256,11,11
4433,just_relax,0.5,4,10,-6,-3.4504121620748336,0.0406961621512329,34,42
4434,just_relax,0.5,13,15,-2,16.148546089182872,-0.3785243386705961,14,25
4435,just_relax,0.5,8,6,2,-4.990354649351104,0.0711965656074914,31,46
4436,just_relax,0.5,1,17,-16,17.98030716385007,0.0700172058376097,42,45
4437,just_relax,0.5,1106,1176,-70,-1.5572638048710488,-0.1831271566443832,39,173
4438,just_relax,0.5,11,10,1,10.45194931144114,0.0317159449162455,14,24
4439,just_relax,0.5,3,1,2,-18.124642274786893,-0.2756311809490173,24,25
4440,just_relax,0.5,3,1,2,-9.381434989049325,0.319617913980413,12,19
4441,just_relax,0.5,48,94,-46,8.26733074692612,-0.3334503885866656,41,72
4442,just_relax,0.5,173,194,-21,2.816416267084413,-0.1759778695242267,59,115
4443,just_relax,0.5,5,6,-1,2.340567547832727,0.0452789402598773,32,37
4444,just_relax,0.5,1,2,-1,10.6630603812022,-0.149850297655066,20,20
4445,just_relax,0.5,21,26,-5,0.0694234904785702,-0.0372786647116819,12,31
4446,just_relax,0.5,0,0,0,0.0,-0.0667425077839207,10,10
4447,just_relax,0.5,0,0,0,0.0,0.1809044748243485,20,21
4448,just_relax,0.5,23,31,-8,2.2949695430945667,0.2351355373477401,39,52
4449,just_relax,0.5,412,397,15,1.568947734099055,0.075253808211974,42,109
4450,just_relax,0.5,1,1,0,-0.5625779140972753,0.2469916568526435,25,28
4451,just_relax,0.5,225,305,-80,5.570816351647181,-0.1555441195674951,56,106
4452,just_relax,0.5,457,767,-310,6.2687848092281655,-0.0384895626675469,87,189
4453,just_relax,0.5,67,58,9,-1.2254511994977904,-0.2473213675910452,56,82
4454,just_relax,0.5,1,1,0,11.801233362618248,0.0910888701942879,13,15
4455,just_relax,0.5,109,118,-9,0.1455710260283851,-0.1538081106562745,36,63
4456,just_relax,0.5,0,2,-2,-77.07706381641074,-0.2726307547642351,16,15
4457,just_relax,0.5,0,0,0,0.0,-0.0741258877394909,67,66
4458,just_relax,0.5,13,15,-2,9.811812090421355,-0.1698214196432919,42,60
4459,just_relax,0.5,0,4,-4,-65.75406089811604,0.416974977234942,39,38
4460,just_relax,0.5,16,13,3,11.593368786326645,0.105648003857378,20,36
4461,just_relax,0.5,0,0,0,0.0,-0.2188695402180199,10,9
4462,just_relax,0.5,1,0,1,77.15956187686535,0.0662471444636106,13,15
4463,just_relax,0.5,9,8,1,-9.981973702659708,0.136414224144251,34,41
4464,just_relax,0.5,7,3,4,-26.91111216322064,0.0753251657550836,37,42
4465,just_relax,0.5,20,29,-9,-3.308689631249834,-0.0993333455975532,18,29
4466,just_relax,0.5,0,0,0,0.0,-0.1190865721055366,23,22
4467,just_relax,0.5,0,0,0,0.0,0.0517368834426714,13,12
4468,just_relax,0.5,0,1,-1,-65.30518311326112,-0.1369984372002818,15,14
4469,just_relax,0.5,0,0,0,0.0,-0.1703170094281143,69,68
4470,just_relax,0.5,1,0,1,31.44732839686916,0.2430893763931391,40,39
4471,just_relax,0.5,1,7,-6,18.70115265382948,-0.0985529674402658,89,93
4472,just_relax,0.5,12,17,-5,8.799149155024118,0.037638890266492,20,32
4473,just_relax,0.5,3,5,-2,0.4266173393692583,0.0053519016595959,69,83
4474,just_relax,0.5,1,1,0,4.513381052837744,-0.0295124882692255,12,15
4475,just_relax,0.5,1,1,0,-1.9416525855949656,-0.1187050542427178,15,14
4476,just_relax,0.5,1,1,0,-8.363006135000902,-0.268830649643767,23,26
4477,just_relax,0.5,3,2,1,-10.039693728320373,-0.0830562216443016,12,20
4478,just_relax,0.5,235,240,-5,-0.0288799642206072,-0.17633162425608,64,122
4479,just_relax,0.5,22,10,12,17.494574544210572,-0.1497541744701466,58,71
4480,just_relax,0.5,0,3,-3,-64.25452242213653,-0.1288333920486761,20,19
4481,just_relax,0.5,335,437,-102,3.904099660852452,-0.1625228510756504,100,191
4482,just_relax,0.5,30,35,-5,19.9893326252682,-0.0649570719058345,41,61
4483,just_relax,0.5,35,35,0,17.52338906839538,-0.0118198042770963,13,31
4484,just_relax,0.5,5,4,1,24.689435508419805,-0.2645842880107117,10,15
4485,just_relax,0.5,21,14,7,-7.496704637764438,0.0239160628543046,37,47
4486,just_relax,0.5,0,1,-1,-88.61423365685371,0.036885474966394,21,21
4487,just_relax,0.5,0,0,0,0.0,-0.1879636806942852,11,10
4488,just_relax,0.5,60,47,13,2.1610435340521974,0.4014568692325218,44,80
4489,just_relax,0.5,2,2,0,2.3725523364369394,0.1376763557333306,12,21
4490,just_relax,0.5,0,3,-3,-68.91972418107355,-0.2454732649485421,37,43
4491,just_relax,0.5,7,7,0,2.955212119851808,0.22393997192248,41,52
4492,just_relax,0.5,2,2,0,18.16350128700134,0.0161255138466714,90,89
4493,just_relax,0.5,1,0,1,78.37190754966878,-0.0210532392779924,22,21
4494,just_relax,0.5,5,5,0,17.839888910716766,-0.3343902576908928,37,43
4495,just_relax,0.5,6,4,2,36.43491336153515,0.0562721445039033,47,47
4496,just_relax,0.5,5,4,1,-15.666648497322171,0.1373824252782345,12,20
4497,just_relax,0.5,104,159,-55,3.2682949476358445,-0.1859169394984573,84,124
4498,just_relax,0.5,0,2,-2,-69.10097013669568,-0.0094047500908611,88,92
4499,just_relax,0.5,358,365,-7,4.531632358148713,-0.0630280942755302,59,122
4500,just_relax,0.5,8,2,6,-7.407463853024758,-0.3717307159295415,26,31
4501,just_relax,0.5,0,0,0,0.0,-0.0785834911699842,28,27
4502,just_relax,0.5,2,5,-3,14.326395357487089,0.0734105552391948,18,26
4503,just_relax,0.5,1,1,0,24.890707817373865,0.6018194011132005,23,26
4504,just_relax,0.5,3,0,3,73.7787607262057,-0.2031119275944809,43,43
4505,just_relax,0.5,1,5,-4,17.699928005787072,-0.4057860002801632,22,26
4506,just_relax,0.5,0,0,0,0.0,0.1018141800253662,15,14
4507,just_relax,0.5,14,16,-2,-0.5117234539035493,-0.0228028942234365,36,48
4508,just_relax,0.5,6,15,-9,13.884192382497377,0.0179485367541167,30,37
4509,just_relax,0.5,3,2,1,0.1258386805623246,0.0557268383480036,10,13
4510,just_relax,0.5,1,0,1,71.68848463610627,-0.1290567093129689,12,11
4511,just_relax,0.5,198,214,-16,2.3087069982147312,0.1945916702147229,55,105
4512,just_relax,0.5,0,1,-1,-87.0207157802465,-0.1703684335879997,13,17
4513,just_relax,0.5,3,0,3,75.32303436877889,0.0362953080769512,30,29
4514,just_relax,0.5,3,2,1,-8.604923102819711,0.1947185212234642,36,43
4515,just_relax,0.5,18,20,-2,15.742281611573198,-0.1674949463674835,40,60
4516,just_relax,0.5,0,0,0,0.0,0.0045788614236211,13,17
4517,just_relax,0.5,6,15,-9,-0.6320921975978067,0.3533507331586779,23,30
4518,just_relax,0.5,2,2,0,-12.6702187749966,-0.1100751549666501,12,16
4519,just_relax,0.5,0,0,0,0.0,0.1939866772159093,26,26
4520,just_relax,0.5,4,3,1,7.708661456154346,0.194872231053837,22,31
4521,just_relax,0.5,1,2,-1,-15.621198107336395,0.1743062188173547,68,68
4522,just_relax,0.5,0,0,0,0.0,0.0056305370126582,23,22
4523,just_relax,0.5,0,5,-5,-57.72517289902645,0.1049374529463631,43,42
4524,just_relax,0.5,0,0,0,0.0,0.2731774799061865,18,17
4525,just_relax,0.5,13,9,4,5.810872567188312,-0.4109844955981399,28,42
4526,just_relax,0.5,43,43,0,4.576336699293805,-0.1249000867120621,21,44
4527,just_relax,0.5,2,0,2,82.39360390093299,-0.1986662994691633,36,37
4528,just_relax,0.5,0,0,0,0.0,-0.1037039223665782,15,14
4529,just_relax,0.5,1,0,1,81.9458635025449,0.2078151923858524,14,16
4530,just_relax,0.5,203,207,-4,0.5921218827583061,-0.2067336568952412,61,119
4531,just_relax,0.5,0,0,0,0.0,-0.0576455897550016,19,20
4532,just_relax,0.5,0,4,-4,-39.45067131194714,-0.1357605523155836,22,22
4533,just_relax,0.5,4,18,-14,2.1830977762769948,-0.0876260078176408,54,58
4534,just_relax,0.5,511,673,-162,6.772198082457486,-0.0878432678987872,65,135
4535,just_relax,0.5,1,2,-1,-1.392861913276903,0.0329323198675147,16,18
4536,just_relax,0.5,11,7,4,1.7956648456179352,-0.1053986260096166,17,27
4537,just_relax,0.5,14,18,-4,1.7120374739907476,0.2393692288209249,54,71
4538,just_relax,0.5,0,1,-1,-60.9878169116314,0.1604419744059673,23,22
4539,just_relax,0.5,1,5,-4,2.086015476856716,0.0021347883656095,13,16
4540,just_relax,0.5,177,276,-99,1.860607796579579,0.1137152195071393,85,131
4541,just_relax,0.5,49,36,13,1.4835889194341334,0.2311925319250235,28,55
4542,just_relax,0.5,1,6,-5,-30.28620258845765,-0.2116282541726043,18,24
4543,just_relax,0.5,2,2,0,-16.361258057802004,-0.0523917075211718,19,22
4544,just_relax,0.5,3,1,2,-11.609669503812045,0.171010151057303,47,46
4545,just_relax,0.5,45,80,-35,8.825794161778092,0.3558823449706216,39,64
4546,just_relax,0.5,1,2,-1,13.324394117336162,-0.1233009905663621,17,18
4547,just_relax,0.5,1,1,0,10.11054029320151,0.3431245989996004,23,24
4548,just_relax,0.5,2,2,0,-8.823395344959792,0.1664105934338441,13,16
4549,just_relax,0.5,67,27,40,-2.32506873630814,0.0185372989958901,40,56
4550,just_relax,0.5,0,0,0,0.0,0.0483291567661277,10,15
4551,just_relax,0.5,0,0,0,0.0,-0.3987425505281837,21,20
4552,just_relax,0.5,5,2,3,-7.944283552701123,-0.1946336956837839,30,35
4553,just_relax,0.5,2,18,-16,-28.811790130808923,0.1011081787598831,71,77
4554,relax_and_recompute,0.55,0,0,0,0.0,0.0940058813850147,17,18
4555,relax_and_recompute,0.55,8,4,4,0.3059116265950763,0.1615689915729402,43,48
4556,relax_and_recompute,0.55,14,8,6,0.6601360560545544,-0.1737594518194724,38,45
4557,relax_and_recompute,0.55,2,0,2,53.376801286252686,0.1664716303531499,12,12
4558,relax_and_recompute,0.55,12,7,5,1.109084448576013,0.0312161323223275,23,38
4559,relax_and_recompute,0.55,1,0,1,68.22220493522443,-0.1529264428956385,19,22
4560,relax_and_recompute,0.55,849,874,-25,1.146643346141353,0.0842083841453475,35,143
4561,relax_and_recompute,0.55,4,1,3,-23.96331635281324,0.0571006292490214,92,91
4562,relax_and_recompute,0.55,2,8,-6,-3.219324491505809,0.0340231867790234,43,51
4563,relax_and_recompute,0.55,3,0,3,77.76120971522015,0.0947481904354354,35,36
4564,relax_and_recompute,0.55,1,2,-1,7.103779083191128,-0.5515024837744664,11,13
4565,relax_and_recompute,0.55,18,20,-2,0.7477357286582276,-0.1106480210484849,10,25
4566,relax_and_recompute,0.55,31,24,7,4.708712722955752,-0.2899924031309322,86,136
4567,relax_and_recompute,0.55,0,0,0,0.0,0.4572195449916821,10,12
4568,relax_and_recompute,0.55,0,0,0,0.0,0.0777719633151602,32,31
4569,relax_and_recompute,0.55,4,4,0,2.030212274284139,0.2099900260560102,20,26
4570,relax_and_recompute,0.55,0,0,0,0.0,0.1765147742268079,11,11
4571,relax_and_recompute,0.55,9,2,7,18.26076935735079,-0.119586322559666,34,42
4572,relax_and_recompute,0.55,12,13,-1,2.248671144844849,-0.2408571845235664,14,25
4573,relax_and_recompute,0.55,6,7,-1,8.869735288711695,0.1957492274143856,31,46
4574,relax_and_recompute,0.55,8,0,8,70.45882160980383,-0.2587640524677221,42,45
4575,relax_and_recompute,0.55,1053,1154,-101,1.4189553560790813,0.3246542128855001,39,173
4576,relax_and_recompute,0.55,14,8,6,-1.8416059275887164,0.3798782014942097,14,24
4577,relax_and_recompute,0.55,0,1,-1,-63.87873734877362,0.2127758947579638,24,25
4578,relax_and_recompute,0.55,1,1,0,15.068280083625467,0.1117659231453011,12,19
4579,relax_and_recompute,0.55,58,61,-3,6.170641188188441,-0.0951035837930649,41,72
4580,relax_and_recompute,0.55,216,185,31,-2.3549482866878435,0.0251441713598823,59,115
4581,relax_and_recompute,0.55,6,7,-1,6.011141676928105,-0.1775608949440082,32,37
4582,relax_and_recompute,0.55,0,0,0,0.0,0.2802822321057642,20,20
4583,relax_and_recompute,0.55,23,26,-3,4.244739758914719,0.0629689458142831,12,31
4584,relax_and_recompute,0.55,1,0,1,87.91094881489026,0.0366803776373854,10,10
4585,relax_and_recompute,0.55,0,0,0,0.0,0.0731478898166833,20,21
4586,relax_and_recompute,0.55,19,20,-1,-0.8441582840419173,0.1420763626093824,39,52
4587,relax_and_recompute,0.55,326,302,24,-1.3758718469854756,0.4192152020124534,42,109
4588,relax_and_recompute,0.55,3,1,2,-20.89881567449896,0.1834138085729162,25,28
4589,relax_and_recompute,0.55,208,165,43,0.4765592341915123,-0.1712850674295059,56,106
4590,relax_and_recompute,0.55,397,435,-38,-4.341788227591714,-0.0578129808895122,87,189
4591,relax_and_recompute,0.55,52,41,11,-6.176723285307823,0.0927312365384447,56,82
4592,relax_and_recompute,0.55,0,1,-1,-70.60304203012835,0.0886972641048158,13,15
4593,relax_and_recompute,0.55,91,87,4,5.291883056693422,-0.135605910312703,36,63
4594,relax_and_recompute,0.55,0,1,-1,-67.24648906952208,-0.3932080107428265,16,15
4595,relax_and_recompute,0.55,0,0,0,0.0,-0.0595509955781187,67,66
4596,relax_and_recompute,0.55,22,13,9,-10.924002182893013,-0.0982245422227621,42,60
4597,relax_and_recompute,0.55,0,0,0,0.0,0.1453783409857406,39,38
4598,relax_and_recompute,0.55,12,16,-4,-9.509944071649372,-0.1063828538893865,20,36
4599,relax_and_recompute,0.55,0,0,0,0.0,-0.111636884113508,10,9
4600,relax_and_recompute,0.55,1,0,1,72.55682746288612,-0.040568191159486,13,15
4601,relax_and_recompute,0.55,10,12,-2,4.273809976359068,0.3071768962758606,34,41
4602,relax_and_recompute,0.55,1,4,-3,-2.830193831672048,-0.0651401783901222,37,42
4603,relax_and_recompute,0.55,22,22,0,-1.5200113699832656,-0.2182999770357677,18,29
4604,relax_and_recompute,0.55,0,0,0,0.0,0.2902367928247594,23,22
4605,relax_and_recompute,0.55,0,0,0,0.0,0.0475104802185709,13,12
4606,relax_and_recompute,0.55,0,0,0,0.0,0.025798776150625,15,14
4607,relax_and_recompute,0.55,1,0,1,62.958711470605806,-0.2886778360065104,69,68
4608,relax_and_recompute,0.55,0,0,0,0.0,-0.3384339017010176,40,39
4609,relax_and_recompute,0.55,0,0,0,0.0,-0.2080731122471822,89,93
4610,relax_and_recompute,0.55,11,7,4,8.417502045202312,0.019854617757863,20,32
4611,relax_and_recompute,0.55,16,7,9,-9.483764911798673,0.1389067058968319,69,83
4612,relax_and_recompute,0.55,1,2,-1,0.1113207768078581,0.0853951257642203,12,15
4613,relax_and_recompute,0.55,0,0,0,0.0,0.0537658155469678,15,14
4614,relax_and_recompute,0.55,2,3,-1,25.66927621354377,-0.0127076017692709,23,26
4615,relax_and_recompute,0.55,2,4,-2,7.352824398035068,0.0369473310550064,12,20
4616,relax_and_recompute,0.55,199,267,-68,-0.5109725376256549,0.0157084606673638,64,122
4617,relax_and_recompute,0.55,17,9,8,-10.262705105296211,-0.0980115633834048,58,71
4618,relax_and_recompute,0.55,0,0,0,0.0,0.0104671037291789,20,19
4619,relax_and_recompute,0.55,328,383,-55,0.6703250610984668,0.3207600828548622,100,191
4620,relax_and_recompute,0.55,27,30,-3,-0.0828080881877184,-0.1784885027004589,41,61
4621,relax_and_recompute,0.55,24,29,-5,2.0044242547561524,-0.1656902073875829,13,31
4622,relax_and_recompute,0.55,6,5,1,-7.38293159603262,0.2840857695120741,10,15
4623,relax_and_recompute,0.55,22,4,18,-15.597129520176855,0.1158431105163316,37,47
4624,relax_and_recompute,0.55,1,0,1,86.47356680069866,-0.1516828952485447,21,21
4625,relax_and_recompute,0.55,0,0,0,0.0,0.0700576900972745,11,10
4626,relax_and_recompute,0.55,60,45,15,0.5631248359860024,0.1500578708291504,44,80
4627,relax_and_recompute,0.55,2,2,0,5.725633923784642,0.2791072567099177,12,21
4628,relax_and_recompute,0.55,11,2,9,29.121275386730275,0.3836205707694137,37,43
4629,relax_and_recompute,0.55,10,22,-12,-1.196844619602274,-0.0262468682284368,41,52
4630,relax_and_recompute,0.55,4,0,4,71.66217353216675,0.2792681228079464,90,89
4631,relax_and_recompute,0.55,0,0,0,0.0,0.0634216513916346,22,21
4632,relax_and_recompute,0.55,2,2,0,1.3643663236999046,0.0787867606965124,37,43
4633,relax_and_recompute,0.55,2,0,2,86.48622232653503,-0.1385138925206791,47,47
4634,relax_and_recompute,0.55,5,4,1,4.217930466759711,-0.1711213751044659,12,20
4635,relax_and_recompute,0.55,169,114,55,0.2972820482027174,-0.1399738705015675,84,124
4636,relax_and_recompute,0.55,7,6,1,7.841064496709968,-0.3803093074781758,88,92
4637,relax_and_recompute,0.55,450,369,81,-1.283467183727133,0.0741169374050129,59,122
4638,relax_and_recompute,0.55,16,7,9,-10.276589360378216,0.0669452139230939,26,31
4639,relax_and_recompute,0.55,0,0,0,0.0,0.1253898919554891,28,27
4640,relax_and_recompute,0.55,11,11,0,27.341698770195435,0.455419227862895,18,26
4641,relax_and_recompute,0.55,1,8,-7,15.46073395296942,0.1712469509535104,23,26
4642,relax_and_recompute,0.55,0,1,-1,-84.54417303299556,0.1483417325040511,43,43
4643,relax_and_recompute,0.55,6,2,4,3.178436786527428,0.0782762460359185,22,26
4644,relax_and_recompute,0.55,0,0,0,0.0,0.2316082396549547,15,14
4645,relax_and_recompute,0.55,13,10,3,1.381336162901512,0.1476813266931564,36,48
4646,relax_and_recompute,0.55,7,7,0,5.132168520165038,0.112144440563812,30,37
4647,relax_and_recompute,0.55,2,1,1,-3.5576798967655208,0.2408680637001734,10,13
4648,relax_and_recompute,0.55,0,1,-1,-72.88430656440661,0.391999553403371,12,11
4649,relax_and_recompute,0.55,219,170,49,-1.1993950282029644,-0.2519684584987065,55,105
4650,relax_and_recompute,0.55,3,2,1,-2.4595997673308005,-0.2107345104910313,13,17
4651,relax_and_recompute,0.55,0,0,0,0.0,-0.2345354431997642,30,29
4652,relax_and_recompute,0.55,6,2,4,3.214666397312108,0.2284439184615658,36,43
4653,relax_and_recompute,0.55,28,15,13,-2.1401265865462307,0.3259708141094376,40,60
4654,relax_and_recompute,0.55,1,1,0,26.263506455040712,0.0324588793693602,13,17
4655,relax_and_recompute,0.55,8,7,1,15.324295268224551,-0.059474910523917,23,30
4656,relax_and_recompute,0.55,3,1,2,39.54823876449073,-0.0634243583601706,12,16
4657,relax_and_recompute,0.55,2,0,2,73.34069643091723,0.0749143397030136,26,26
4658,relax_and_recompute,0.55,1,1,0,-33.84790834083806,0.2626828187206388,22,31
4659,relax_and_recompute,0.55,0,1,-1,-84.4924468221512,0.0139635577193334,68,68
4660,relax_and_recompute,0.55,0,0,0,0.0,0.0248377138256348,23,22
4661,relax_and_recompute,0.55,0,0,0,0.0,-0.1841612270551931,43,42
4662,relax_and_recompute,0.55,0,0,0,0.0,0.1256637358127796,18,17
4663,relax_and_recompute,0.55,27,3,24,-0.859446060566313,0.3170869732307749,28,42
4664,relax_and_recompute,0.55,40,44,-4,3.930284343242676,-0.0383687168653573,21,44
4665,relax_and_recompute,0.55,2,0,2,81.30422589702007,-0.147013297862611,36,37
4666,relax_and_recompute,0.55,0,0,0,0.0,0.0282773474014937,15,14
4667,relax_and_recompute,0.55,1,2,-1,9.419076526513578,-0.0082003427776007,14,16
4668,relax_and_recompute,0.55,192,195,-3,-2.216477025007848,0.0357095005556952,61,119
4669,relax_and_recompute,0.55,1,0,1,78.10999629818853,-0.0074072503559512,19,20
4670,relax_and_recompute,0.55,0,1,-1,-54.978392744422365,0.0243043131880432,22,22
4671,relax_and_recompute,0.55,3,1,2,3.563052466488827,0.1173606073746094,54,58
4672,relax_and_recompute,0.55,444,445,-1,1.3274734469077245,0.3233128940560109,65,135
4673,relax_and_recompute,0.55,3,1,2,-25.80816170597943,-0.1093758001765512,16,18
4674,relax_and_recompute,0.55,10,8,2,1.6360841298803024,0.2042521411801369,17,27
4675,relax_and_recompute,0.55,19,11,8,-7.049922775316084,0.1791275205782658,54,71
4676,relax_and_recompute,0.55,0,0,0,0.0,0.120470670702715,23,22
4677,relax_and_recompute,0.55,1,0,1,85.45613718448331,-0.1096932914047464,13,16
4678,relax_and_recompute,0.55,188,132,56,6.253307580458483,0.3305812265067853,85,131
4679,relax_and_recompute,0.55,60,65,-5,5.326682566130764,-0.0275704189550897,28,55
4680,relax_and_recompute,0.55,1,3,-2,8.236490430152102,0.1574269968433543,18,24
4681,relax_and_recompute,0.55,2,0,2,75.62017349122375,-0.1164706209953873,19,22
4682,relax_and_recompute,0.55,0,0,0,0.0,-0.0826322200710225,47,46
4683,relax_and_recompute,0.55,33,18,15,1.9878280607861285,-0.0712562510087396,39,64
4684,relax_and_recompute,0.55,1,0,1,85.53349517965916,0.1115583782221518,17,18
4685,relax_and_recompute,0.55,4,3,1,0.7679035070071336,-0.058548788027274,23,24
4686,relax_and_recompute,0.55,2,1,1,-24.02470178433821,0.0984010427975992,13,16
4687,relax_and_recompute,0.55,29,13,16,4.381912287968092,-0.1193818898638295,40,56
4688,relax_and_recompute,0.55,1,1,0,-1.9307403335443207,-0.0945486659241625,10,15
4689,relax_and_recompute,0.55,0,0,0,0.0,0.1750907982071724,21,20
4690,relax_and_recompute,0.55,4,6,-2,0.9666249579975386,0.4618388612285,30,35
4691,relax_and_recompute,0.55,9,4,5,11.933055797693989,0.011352204850859,71,77
4692,relax_one,0.55,0,1,-1,-65.99859335765206,-0.2065072507570845,17,18
4693,relax_one,0.55,6,2,4,9.704125215272375,0.2970903666359744,43,48
4694,relax_one,0.55,20,12,8,-3.28853729432236,0.0448061948966015,38,45
4695,relax_one,0.55,2,0,2,64.8244350083118,-0.2016687143669332,12,12
4696,relax_one,0.55,9,7,2,-3.530491336797269,-0.0456150750672189,23,38
4697,relax_one,0.55,1,1,0,26.89609532572439,-0.3537500459844395,19,22
4698,relax_one,0.55,715,755,-40,-1.063819551489047,0.0689926496564388,35,143
4699,relax_one,0.55,6,2,4,6.925935165891218,-0.0772104042131504,92,91
4700,relax_one,0.55,2,4,-2,21.1955855927641,-0.0432571099710542,43,51
4701,relax_one,0.55,6,0,6,67.23799342667407,0.0807622157469011,35,36
4702,relax_one,0.55,1,0,1,87.65262764243562,-0.0039792410942097,11,13
4703,relax_one,0.55,24,15,9,0.0095998400062597,0.1328193108838333,10,25
4704,relax_one,0.55,30,15,15,-1.4938775116832232,-0.1254067454444809,86,136
4705,relax_one,0.55,1,0,1,59.41065404997052,0.112477586210296,10,12
4706,relax_one,0.55,0,0,0,0.0,0.0024436178070609,32,31
4707,relax_one,0.55,4,2,2,8.083376824466143,-0.0366706535113688,20,26
4708,relax_one,0.55,0,0,0,0.0,-0.654407892839671,11,11
4709,relax_one,0.55,7,4,3,-2.35381847116188,-0.0359131429666994,34,42
4710,relax_one,0.55,11,9,2,-2.353178788705577,0.0240856894480841,14,25
4711,relax_one,0.55,4,7,-3,12.74336315007919,0.0428443545616129,31,46
4712,relax_one,0.55,0,1,-1,-86.55953735569179,-0.0635432069052559,42,45
4713,relax_one,0.55,1106,1127,-21,1.324792562511341,0.0543453191675592,39,173
4714,relax_one,0.55,10,14,-4,-3.8980076873728535,0.1373542143789424,14,24
4715,relax_one,0.55,2,2,0,22.64477990326541,0.1370650839479424,24,25
4716,relax_one,0.55,2,1,1,-9.053773649842595,-0.5718489471753226,12,19
4717,relax_one,0.55,84,73,11,-4.282063265414877,0.0242686729208457,41,72
4718,relax_one,0.55,166,163,3,-1.1880932281593246,0.0478960767856462,59,115
4719,relax_one,0.55,9,3,6,4.354697196572545,-0.0044251062235211,32,37
4720,relax_one,0.55,2,0,2,88.616078851141,-0.0544764827869237,20,20
4721,relax_one,0.55,27,30,-3,-0.1483359780761617,0.16245707034566,12,31
4722,relax_one,0.55,1,0,1,79.30901679805928,0.4019363708689095,10,10
4723,relax_one,0.55,0,0,0,0.0,-0.1352140308530456,20,21
4724,relax_one,0.55,17,29,-12,4.0359090776530735,0.3810269063627766,39,52
4725,relax_one,0.55,325,336,-11,0.5799109717078181,-0.0333638245545199,42,109
4726,relax_one,0.55,1,3,-2,24.921861032599928,-0.2441870430100801,25,28
4727,relax_one,0.55,198,185,13,-1.5531631371970391,0.1919997985501407,56,106
4728,relax_one,0.55,463,424,39,0.6348736696909469,0.2944123452298871,87,189
4729,relax_one,0.55,37,38,-1,5.023151715937182,-0.0498526401687487,56,82
4730,relax_one,0.55,2,0,2,63.39881575494773,0.1665542793663655,13,15
4731,relax_one,0.55,90,59,31,-6.02121091664074,-0.1812329668751573,36,63
4732,relax_one,0.55,0,0,0,0.0,-0.271713325315563,16,15
4733,relax_one,0.55,0,0,0,0.0,-0.1509510317590167,67,66
4734,relax_one,0.55,26,17,9,-3.046292867736213,-0.321437611521692,42,60
4735,relax_one,0.55,0,0,0,0.0,-0.1424114151979574,39,38
4736,relax_one,0.55,9,11,-2,19.07710260475909,0.2448664646507682,20,36
4737,relax_one,0.55,1,0,1,85.2244970975485,-0.192701062027027,10,9
4738,relax_one,0.55,1,0,1,89.37270968016203,-0.2760492842116667,13,15
4739,relax_one,0.55,11,12,-1,5.937670960781794,0.3476651270004741,34,41
4740,relax_one,0.55,5,3,2,-16.330816821618,-0.3277323828291014,37,42
4741,relax_one,0.55,25,34,-9,-0.3548108375465659,-0.2218313887080173,18,29
4742,relax_one,0.55,0,1,-1,-72.95943079696495,0.0754403171271111,23,22
4743,relax_one,0.55,0,0,0,0.0,-0.2774136613690752,13,12
4744,relax_one,0.55,0,0,0,0.0,0.1908415095323744,15,14
4745,relax_one,0.55,0,0,0,0.0,0.1595094524980268,69,68
4746,relax_one,0.55,0,0,0,0.0,-0.1391762790110632,40,39
4747,relax_one,0.55,1,1,0,-3.579635640077015,-0.0702642181936045,89,93
4748,relax_one,0.55,11,14,-3,-9.07522024100296,0.186027455983063,20,32
4749,relax_one,0.55,5,3,2,3.989500308100802,0.276962551161094,69,83
4750,relax_one,0.55,1,1,0,-1.811099380317856,-0.1424359408281735,12,15
4751,relax_one,0.55,0,0,0,0.0,-0.203873444220972,15,14
4752,relax_one,0.55,0,4,-4,-71.83669086113063,0.3920086909065382,23,26
4753,relax_one,0.55,2,2,0,15.404084823286423,0.286670872147595,12,20
4754,relax_one,0.55,229,179,50,3.655332371853546,0.2788427865960347,64,122
4755,relax_one,0.55,5,20,-15,7.267397662883532,-0.0295245960713519,58,71
4756,relax_one,0.55,1,0,1,70.86344499498286,0.1921766930785476,20,19
4757,relax_one,0.55,354,280,74,3.632467254971054,0.1437444981687474,100,191
4758,relax_one,0.55,33,27,6,1.2121229218109733,0.33198368821616,41,61
4759,relax_one,0.55,20,21,-1,4.462985688560906,0.1026018927609514,13,31
4760,relax_one,0.55,5,4,1,5.370699877425167,0.3681349518978624,10,15
4761,relax_one,0.55,4,9,-5,-16.579685407720902,0.1592473141043666,37,47
4762,relax_one,0.55,0,1,-1,-68.32503201917919,-0.3444839698022639,21,21
4763,relax_one,0.55,0,0,0,0.0,-0.2458050085039238,11,10
4764,relax_one,0.55,44,68,-24,5.308394382261596,0.0582264617945363,44,80
4765,relax_one,0.55,5,3,2,-11.993032237313365,0.1165344075903037,12,21
4766,relax_one,0.55,5,0,5,67.64187879274141,0.0448565415802688,37,43
4767,relax_one,0.55,15,10,5,-14.30131696402234,0.0579895997072531,41,52
4768,relax_one,0.55,3,0,3,69.20982117667073,-0.1331315909470347,90,89
4769,relax_one,0.55,0,0,0,0.0,0.4948030625485965,22,21
4770,relax_one,0.55,2,5,-3,27.8429313687719,0.0942025599894402,37,43
4771,relax_one,0.55,0,0,0,0.0,-0.0696261570269464,47,47
4772,relax_one,0.55,4,5,-1,9.256593655931937,0.2743522329404984,12,20
4773,relax_one,0.55,116,103,13,1.7110526003580515,0.2881555350258844,84,124
4774,relax_one,0.55,13,5,8,-21.09813725141416,0.1710026762187017,88,92
4775,relax_one,0.55,479,338,141,-4.494779963300537,-0.1615221572552717,59,122
4776,relax_one,0.55,6,3,3,-22.997975408709102,-0.3519779708510371,26,31
4777,relax_one,0.55,0,0,0,0.0,0.0270013866294194,28,27
4778,relax_one,0.55,0,2,-2,-60.80256567513121,0.2589354959399204,18,26
4779,relax_one,0.55,2,1,1,-20.659908616492352,-0.0335239815155827,23,26
4780,relax_one,0.55,1,0,1,81.03524691215934,-0.2886232928985552,43,43
4781,relax_one,0.55,1,1,0,47.92721545903568,0.3153312173151696,22,26
4782,relax_one,0.55,0,0,0,0.0,0.1385814842351226,15,14
4783,relax_one,0.55,50,13,37,-13.227619255294307,0.1480009788793442,36,48
4784,relax_one,0.55,5,10,-5,4.946694330660691,-0.4319264914820959,30,37
4785,relax_one,0.55,1,1,0,6.300551211323878,0.0867636379110511,10,13
4786,relax_one,0.55,0,0,0,0.0,-0.0955572150879269,12,11
4787,relax_one,0.55,229,174,55,1.266611688051256,-0.0958805421351127,55,105
4788,relax_one,0.55,1,1,0,-33.71227079760424,0.0940631469540371,13,17
4789,relax_one,0.55,1,4,-3,-7.29549850935431,0.0613864948927194,30,29
4790,relax_one,0.55,18,4,14,9.172126821303223,-0.0296864318365086,36,43
4791,relax_one,0.55,21,19,2,-7.089303682461157,0.2610322350392071,40,60
4792,relax_one,0.55,0,1,-1,-75.0061377541227,0.3650386138988696,13,17
4793,relax_one,0.55,11,7,4,-1.306874321172785,-0.1705835335505333,23,30
4794,relax_one,0.55,2,2,0,17.234845748256106,0.1605182068950357,12,16
4795,relax_one,0.55,1,5,-4,15.55818791542817,0.2875124897848128,26,26
4796,relax_one,0.55,0,0,0,0.0,-0.0011802984926262,22,31
4797,relax_one,0.55,1,1,0,-6.275527032001904,-0.0245125130485925,68,68
4798,relax_one,0.55,0,0,0,0.0,0.0140511039917433,23,22
4799,relax_one,0.55,2,0,2,66.63235626585706,0.2334971639468012,43,42
4800,relax_one,0.55,0,0,0,0.0,0.2145230124871933,18,17
4801,relax_one,0.55,15,14,1,4.2241197400068415,0.4762486614452154,28,42
4802,relax_one,0.55,52,48,4,-1.068985046770834,-0.1679533954266299,21,44
4803,relax_one,0.55,1,0,1,54.56464387374838,-0.0364546401186952,36,37
4804,relax_one,0.55,0,0,0,0.0,-0.107185688302049,15,14
4805,relax_one,0.55,2,1,1,8.55364284147123,0.1802764856871508,14,16
4806,relax_one,0.55,225,209,16,3.077482709451949,0.0259117480504879,61,119
4807,relax_one,0.55,1,0,1,79.93698560748413,0.0641538863685786,19,20
4808,relax_one,0.55,1,1,0,-11.529419924232627,0.1762941628647555,22,22
4809,relax_one,0.55,1,3,-2,-0.3781191445682594,-0.0158523334960376,54,58
4810,relax_one,0.55,442,427,15,-0.8666338251943912,0.1773671487319119,65,135
4811,relax_one,0.55,1,3,-2,7.591299428847748,0.4069199146042566,16,18
4812,relax_one,0.55,7,9,-2,21.78262449818552,0.0842702694972272,17,27
4813,relax_one,0.55,16,9,7,-3.679400610222231,0.0807945245995601,54,71
4814,relax_one,0.55,0,2,-2,-65.43028209200267,0.0855967685971831,23,22
4815,relax_one,0.55,0,1,-1,-64.46877485354136,-0.1199330073850915,13,16
4816,relax_one,0.55,160,123,37,0.4627714160737355,0.2202066328705525,85,131
4817,relax_one,0.55,57,45,12,1.008151447844824,0.0392439005094624,28,55
4818,relax_one,0.55,2,6,-4,3.017854566596256,-0.0164567618518923,18,24
4819,relax_one,0.55,0,1,-1,-34.15800635387189,0.0463542389604262,19,22
4820,relax_one,0.55,1,2,-1,12.644695326840178,0.0990981705559217,47,46
4821,relax_one,0.55,27,36,-9,-1.8458095636997167,-0.2710168646719025,39,64
4822,relax_one,0.55,2,0,2,41.554541681453,-0.2243631741141325,17,18
4823,relax_one,0.55,1,1,0,-0.3328101628403601,-0.0688663881252235,23,24
4824,relax_one,0.55,5,1,4,1.5741323102118514,0.5307991537945429,13,16
4825,relax_one,0.55,38,14,24,2.54224027310832,-0.0834722379440362,40,56
4826,relax_one,0.55,0,0,0,0.0,0.3331414187547367,10,15
4827,relax_one,0.55,0,0,0,0.0,0.0198202993528966,21,20
4828,relax_one,0.55,12,3,9,11.780103860727372,0.0744228208915592,30,35
4829,relax_one,0.55,3,4,-1,7.372809362531015,0.0770208262919222,71,77
4830,just_relax,0.55,3,0,3,60.968417807056944,0.6474263588991649,17,18
4831,just_relax,0.55,17,10,7,-1.6397473795594308,0.0704883525295678,43,48
4832,just_relax,0.55,5,6,-1,-33.514776206465875,0.2476617915172339,38,45
4833,just_relax,0.55,0,0,0,0.0,0.0078291974866009,12,12
4834,just_relax,0.55,40,17,23,2.979967368107808,0.1216382382734435,23,38
4835,just_relax,0.55,0,0,0,0.0,0.090084953463947,19,22
4836,just_relax,0.55,781,809,-28,-0.9087446057194342,0.1508359037766762,35,143
4837,just_relax,0.55,2,6,-4,8.507605984270384,0.0289485930013786,92,91
4838,just_relax,0.55,11,32,-21,10.225045451543023,0.1371183928080228,43,51
4839,just_relax,0.55,2,5,-3,1.0508781583615914,-0.0781956967216953,35,36
4840,just_relax,0.55,0,1,-1,-30.68674041285833,-0.3156439711498507,11,13
4841,just_relax,0.55,30,28,2,-1.5882948639773249,-0.1051592427020173,10,25
4842,just_relax,0.55,20,44,-24,9.330602999249365,-0.1893819046548478,86,136
4843,just_relax,0.55,0,0,0,0.0,-0.3141356578917659,10,12
4844,just_relax,0.55,0,0,0,0.0,0.0597827709705157,32,31
4845,just_relax,0.55,6,4,2,-5.6145436375950055,-0.1874129545111932,20,26
4846,just_relax,0.55,0,0,0,0.0,-0.0703908193695005,11,11
4847,just_relax,0.55,5,6,-1,3.902821178434728,-0.0009178271345733,34,42
4848,just_relax,0.55,11,17,-6,-4.831898895285896,-0.4070722834454363,14,25
4849,just_relax,0.55,9,9,0,4.306290586967052,-0.1215648332064142,31,46
4850,just_relax,0.55,1,20,-19,20.06499452409014,0.133326276032071,42,45
4851,just_relax,0.55,1033,1075,-42,-0.3247933634632147,-0.1546828856643775,39,173
4852,just_relax,0.55,10,10,0,-0.9929606571749474,0.0514036250865597,14,24
4853,just_relax,0.55,0,1,-1,-42.53122660519284,-0.0034022866901626,24,25
4854,just_relax,0.55,4,1,3,2.8670649429218003,0.0557200260379042,12,19
4855,just_relax,0.55,59,58,1,0.552279714535274,-0.0606504291502767,41,72
4856,just_relax,0.55,222,212,10,7.1265467556664746,0.1787567769576998,59,115
4857,just_relax,0.55,4,10,-6,-3.8631929832108938,-0.2159492819872625,32,37
4858,just_relax,0.55,2,0,2,77.07967521464064,0.0920206488664999,20,20
4859,just_relax,0.55,28,23,5,-2.385516606796287,0.0354851743707658,12,31
4860,just_relax,0.55,0,0,0,0.0,-0.2979185325902898,10,10
4861,just_relax,0.55,2,0,2,78.35126754316047,-0.1775317789985364,20,21
4862,just_relax,0.55,36,40,-4,5.307498828165485,0.1902196867744522,39,52
4863,just_relax,0.55,422,344,78,0.1130915429318619,-0.348067234781603,42,109
4864,just_relax,0.55,2,2,0,-1.1336173703177792,0.1032731880250986,25,28
4865,just_relax,0.55,283,249,34,2.903580480562219,0.0862865918217471,56,106
4866,just_relax,0.55,415,701,-286,10.056242898763664,-0.2850892499048434,87,189
4867,just_relax,0.55,36,34,2,-3.230180383983793,-0.3618340621282979,56,82
4868,just_relax,0.55,2,1,1,-19.443170152685084,-0.2167414145785039,13,15
4869,just_relax,0.55,75,95,-20,1.2098721903119838,-0.3549020892685415,36,63
4870,just_relax,0.55,0,3,-3,-66.63604341390077,-0.0317066186739075,16,15
4871,just_relax,0.55,0,0,0,0.0,-0.0536669256326727,67,66
4872,just_relax,0.55,15,12,3,-1.6275621572376195,-0.1513441646149537,42,60
4873,just_relax,0.55,2,0,2,74.50757987759305,-0.2240906859416491,39,38
4874,just_relax,0.55,8,11,-3,12.343125485508368,0.1884562131261584,20,36
4875,just_relax,0.55,1,0,1,74.35031079334782,-0.1166193409519845,10,9
4876,just_relax,0.55,2,0,2,64.24441616467405,-0.2377186889241691,13,15
4877,just_relax,0.55,11,7,4,-6.195860248354471,-0.2613174700576052,34,41
4878,just_relax,0.55,4,3,1,-7.875227155535981,-0.1813702568346542,37,42
4879,just_relax,0.55,32,15,17,10.455286184099728,-0.1848209718163386,18,29
4880,just_relax,0.55,0,0,0,0.0,0.0564022737718505,23,22
4881,just_relax,0.55,0,0,0,0.0,0.059363715415389,13,12
4882,just_relax,0.55,0,0,0,0.0,0.0235038461406056,15,14
4883,just_relax,0.55,0,1,-1,-57.67999902815045,-0.1097352819490857,69,68
4884,just_relax,0.55,0,0,0,0.0,0.090507152089024,40,39
4885,just_relax,0.55,0,5,-5,-61.40082545817306,-0.3890123738982429,89,93
4886,just_relax,0.55,10,15,-5,12.915458323103865,-0.0990448143993845,20,32
4887,just_relax,0.55,4,3,1,-22.039646425272625,-0.1698402450823474,69,83
4888,just_relax,0.55,2,2,0,-8.930828025129529,0.2388952939254452,12,15
4889,just_relax,0.55,0,0,0,0.0,0.3246524727470354,15,14
4890,just_relax,0.55,12,1,11,-15.424388364774025,0.2219535626452045,23,26
4891,just_relax,0.55,2,2,0,-3.2443834371352693,0.0220434660273803,12,20
4892,just_relax,0.55,200,267,-67,4.716672815141024,-0.2385527552493648,64,122
4893,just_relax,0.55,2,8,-6,-5.828043799459579,-0.1918809745374681,58,71
4894,just_relax,0.55,0,1,-1,-55.60560040282058,0.0067953909844971,20,19
4895,just_relax,0.55,319,364,-45,-3.830136144777782,0.0676751246175855,100,191
4896,just_relax,0.55,52,75,-23,5.783563417431154,-0.0392187017377467,41,61
4897,just_relax,0.55,22,35,-13,7.895042918835685,-0.0356046588966082,13,31
4898,just_relax,0.55,3,3,0,-0.8463419667192085,0.1266370612185132,10,15
4899,just_relax,0.55,15,9,6,3.0397624963275973,-0.2854224590637855,37,47
4900,just_relax,0.55,1,3,-2,-7.992860260267818,-0.1365164919418572,21,21
4901,just_relax,0.55,0,0,0,0.0,-0.1795351820196342,11,10
4902,just_relax,0.55,59,43,16,-3.3284812308188663,0.3148331046524437,44,80
4903,just_relax,0.55,2,4,-2,-0.855626104648735,-0.2997250046400286,12,21
4904,just_relax,0.55,1,8,-7,8.823111109648607,0.1435689484888554,37,43
4905,just_relax,0.55,9,19,-10,8.862795873319776,-0.2857066075615022,41,52
4906,just_relax,0.55,0,1,-1,-88.47263934493188,-0.3006271086461998,90,89
4907,just_relax,0.55,0,0,0,0.0,-0.0106476968623133,22,21
4908,just_relax,0.55,1,27,-26,16.604597962781256,0.0990288561848079,37,43
4909,just_relax,0.55,1,14,-13,21.718832178573592,-0.009094475081291,47,47
4910,just_relax,0.55,7,4,3,-15.586732402753649,-0.4005566291439679,12,20
4911,just_relax,0.55,145,152,-7,3.4677758738315774,0.1499863867229524,84,124
4912,just_relax,0.55,1,7,-6,-48.08709604922841,-0.0459111318264517,88,92
4913,just_relax,0.55,332,296,36,1.868476562422721,-0.1045512136507776,59,122
4914,just_relax,0.55,3,2,1,10.214351968190885,0.1604600073587553,26,31
4915,just_relax,0.55,0,0,0,0.0,-0.2678880831386877,28,27
4916,just_relax,0.55,6,2,4,6.754495540783907,0.1295221976826557,18,26
4917,just_relax,0.55,5,1,4,-5.950817015241228,0.0952426300609303,23,26
4918,just_relax,0.55,2,1,1,-3.978986787000665,0.0972944225943085,43,43
4919,just_relax,0.55,2,3,-1,-1.7496383498909296,-0.1542985604538937,22,26
4920,just_relax,0.55,0,0,0,0.0,0.4101036158343136,15,14
4921,just_relax,0.55,16,16,0,5.323612649269407,0.0644774869775746,36,48
4922,just_relax,0.55,8,6,2,4.934868755517655,-0.0502726065439221,30,37
4923,just_relax,0.55,1,5,-4,2.7776745331991464,0.2092585553640827,10,13
4924,just_relax,0.55,1,0,1,76.94560948543995,0.0296333550187631,12,11
4925,just_relax,0.55,187,239,-52,1.8013333217397332,-0.0341157260018758,55,105
4926,just_relax,0.55,1,2,-1,-11.663044714947674,0.2344892035454769,13,17
4927,just_relax,0.55,1,9,-8,2.4001813499243525,-0.1469130496453231,30,29
4928,just_relax,0.55,12,6,6,-4.114662942433412,-0.0710296107134872,36,43
4929,just_relax,0.55,32,66,-34,7.615547725961555,-0.0140765989652943,40,60
4930,just_relax,0.55,0,0,0,0.0,-0.1070629967708223,13,17
4931,just_relax,0.55,13,8,5,-4.49682725042279,0.2183486294348189,23,30
4932,just_relax,0.55,1,2,-1,-6.784604972917876,0.1223318325605464,12,16
4933,just_relax,0.55,5,0,5,54.17557154294358,0.3573783033733831,26,26
4934,just_relax,0.55,3,1,2,29.2252826957822,0.2119969750397505,22,31
4935,just_relax,0.55,2,1,1,-18.11419391462768,0.0526287188304785,68,68
4936,just_relax,0.55,0,0,0,0.0,-0.0317307227318951,23,22
4937,just_relax,0.55,0,4,-4,-39.61901641229841,-0.1841326286454688,43,42
4938,just_relax,0.55,1,0,1,85.7772107283604,-0.1022090227601218,18,17
4939,just_relax,0.55,6,8,-2,11.413319507760733,-0.2267587143852231,28,42
4940,just_relax,0.55,42,55,-13,2.6650235543486502,-0.0884554680591543,21,44
4941,just_relax,0.55,0,0,0,0.0,0.1548259340389177,36,37
4942,just_relax,0.55,0,0,0,0.0,-0.098820504040395,15,14
4943,just_relax,0.55,1,0,1,65.75136627951488,0.2278006365647379,14,16
4944,just_relax,0.55,274,290,-16,-2.1650447342082515,-0.0087620603688942,61,119
4945,just_relax,0.55,0,0,0,0.0,0.0217338044229141,19,20
4946,just_relax,0.55,2,0,2,83.30801550352916,-0.1450963847814071,22,22
4947,just_relax,0.55,3,16,-13,-14.12623768009614,0.0078327150578997,54,58
4948,just_relax,0.55,456,782,-326,7.577734125301369,-0.1908172551647419,65,135
4949,just_relax,0.55,0,1,-1,-87.24042231994179,0.0015300669999047,16,18
4950,just_relax,0.55,8,6,2,8.912057508009717,-0.0452392258234211,17,27
4951,just_relax,0.55,14,12,2,0.8898782991965319,0.028091237186606,54,71
4952,just_relax,0.55,0,0,0,0.0,-0.4974200067639364,23,22
4953,just_relax,0.55,0,1,-1,-17.049113774532298,-0.0090831229827192,13,16
4954,just_relax,0.55,144,278,-134,3.249652962027781,-0.0426604252114733,85,131
4955,just_relax,0.55,58,37,21,2.266906419848695,-0.3303296373980897,28,55
4956,just_relax,0.55,2,7,-5,9.452599681701102,0.1132463300771599,18,24
4957,just_relax,0.55,0,0,0,0.0,0.2430905077403313,19,22
4958,just_relax,0.55,4,2,2,7.445361035609267,-0.010824382068259,47,46
4959,just_relax,0.55,33,61,-28,6.167291363504056,0.1315011776068594,39,64
4960,just_relax,0.55,0,1,-1,-44.9769540337664,-0.2941792825878362,17,18
4961,just_relax,0.55,3,2,1,-7.661799387148164,0.3202975426694781,23,24
4962,just_relax,0.55,3,2,1,10.969789617142212,0.0950562612473211,13,16
4963,just_relax,0.55,19,25,-6,-3.022039425794361,0.2095529357902101,40,56
4964,just_relax,0.55,1,1,0,13.561336017934437,-0.0106615647368285,10,15
4965,just_relax,0.55,0,0,0,0.0,-0.0070286690408671,21,20
4966,just_relax,0.55,5,1,4,-24.5479252542288,0.0738164240068252,30,35
4967,just_relax,0.55,1,0,1,11.407325425982007,-0.2745987465611339,71,77
4968,relax_and_recompute,0.6000000000000001,0,0,0,0.0,-0.5437302298455975,17,18
4969,relax_and_recompute,0.6000000000000001,12,11,1,1.6751681181027394,0.32687104742622,43,48
4970,relax_and_recompute,0.6000000000000001,0,6,-6,-65.62739278627124,0.0864352428297091,38,45
4971,relax_and_recompute,0.6000000000000001,0,0,0,0.0,0.2200046862469662,12,12
4972,relax_and_recompute,0.6000000000000001,16,3,13,-15.73954300253385,0.2418329156487947,23,38
4973,relax_and_recompute,0.6000000000000001,1,1,0,9.572618473549936,0.136052218276712,19,22
4974,relax_and_recompute,0.6000000000000001,955,874,81,0.350781650786665,-0.039971227677179,35,143
4975,relax_and_recompute,0.6000000000000001,1,3,-2,25.239543443682145,0.2210892472697379,92,91
4976,relax_and_recompute,0.6000000000000001,6,3,3,6.2903936771704565,-0.1231143021140293,43,51
4977,relax_and_recompute,0.6000000000000001,1,0,1,70.51792263688752,0.4345279134960402,35,36
4978,relax_and_recompute,0.6000000000000001,0,0,0,0.0,-0.4948137596606551,11,13
4979,relax_and_recompute,0.6000000000000001,28,21,7,-2.890939090910777,0.0447275683562448,10,25
4980,relax_and_recompute,0.6000000000000001,25,15,10,-3.698237907909373,0.1720083457255815,86,136
4981,relax_and_recompute,0.6000000000000001,0,0,0,0.0,-0.2244927351624612,10,12
4982,relax_and_recompute,0.6000000000000001,0,0,0,0.0,-0.0529974090859642,32,31
4983,relax_and_recompute,0.6000000000000001,3,3,0,12.88419421501159,0.1797676472536332,20,26
4984,relax_and_recompute,0.6000000000000001,1,0,1,85.48527348019913,-0.2020348728849791,11,11
4985,relax_and_recompute,0.6000000000000001,0,4,-4,-61.19553488421083,-0.2960928208911573,34,42
4986,relax_and_recompute,0.6000000000000001,14,16,-2,7.1627615167977154,0.3084378553459629,14,25
4987,relax_and_recompute,0.6000000000000001,5,8,-3,2.8320959043365974,-0.1244663030277366,31,46
4988,relax_and_recompute,0.6000000000000001,5,0,5,72.84146483225837,0.0847055829040844,42,45
4989,relax_and_recompute,0.6000000000000001,1194,1053,141,-0.5028343530290513,-0.1158390162509092,39,173
4990,relax_and_recompute,0.6000000000000001,9,12,-3,-0.6384129667387555,0.1491777028971017,14,24
4991,relax_and_recompute,0.6000000000000001,0,1,-1,-57.99639703773304,0.4224132892502797,24,25
4992,relax_and_recompute,0.6000000000000001,2,3,-1,5.958260727829071,-0.3844163920359785,12,19
4993,relax_and_recompute,0.6000000000000001,74,61,13,0.2457232344040676,0.1997779174369411,41,72
4994,relax_and_recompute,0.6000000000000001,224,183,41,-4.310787157122469,-0.0038232259668168,59,115
4995,relax_and_recompute,0.6000000000000001,22,11,11,-4.430910658917725,-0.1224824982731729,32,37
4996,relax_and_recompute,0.6000000000000001,1,3,-2,-2.700219335688999,-0.3033082449659855,20,20
4997,relax_and_recompute,0.6000000000000001,25,23,2,4.067504722396819,-0.0129962403171162,12,31
4998,relax_and_recompute,0.6000000000000001,0,0,0,0.0,0.4383776258398082,10,10
4999,relax_and_recompute,0.6000000000000001,0,1,-1,-64.23837522220063,0.2895157378902664,20,21
5000,relax_and_recompute,0.6000000000000001,39,28,11,10.52103550078126,-0.0520533333554699,39,52
5001,relax_and_recompute,0.6000000000000001,407,329,78,-0.1600247929916562,0.5827467666106705,42,109
5002,relax_and_recompute,0.6000000000000001,4,3,1,14.53868715954652,-0.0863806615315565,25,28
5003,relax_and_recompute,0.6000000000000001,185,177,8,0.6614499834160767,0.1104655689338962,56,106
5004,relax_and_recompute,0.6000000000000001,430,409,21,1.466823218601462,-0.3411209079713024,87,189
5005,relax_and_recompute,0.6000000000000001,50,41,9,1.4338765375782287,-0.1458482821561829,56,82
5006,relax_and_recompute,0.6000000000000001,0,1,-1,-84.9873936921156,-0.1242816574557157,13,15
5007,relax_and_recompute,0.6000000000000001,108,80,28,-1.5858765706965343,0.0431443945162276,36,63
5008,relax_and_recompute,0.6000000000000001,3,0,3,59.23895911520933,0.1836306354250911,16,15
5009,relax_and_recompute,0.6000000000000001,0,0,0,0.0,0.0269645621901585,67,66
5010,relax_and_recompute,0.6000000000000001,20,17,3,-4.855770330897592,0.3465283658447987,42,60
5011,relax_and_recompute,0.6000000000000001,0,0,0,0.0,-0.0803524735457562,39,38
5012,relax_and_recompute,0.6000000000000001,11,12,-1,1.2593103539862796,-0.4070652086760553,20,36
5013,relax_and_recompute,0.6000000000000001,0,0,0,0.0,0.2640699450262387,10,9
5014,relax_and_recompute,0.6000000000000001,0,0,0,0.0,0.0025600139622448,13,15
5015,relax_and_recompute,0.6000000000000001,10,9,1,-1.1625839691914877,0.1130409122906139,34,41
5016,relax_and_recompute,0.6000000000000001,7,10,-3,-4.159487831650452,-0.2037601033272992,37,42
5017,relax_and_recompute,0.6000000000000001,26,17,9,4.982137687055115,0.1949274141149595,18,29
5018,relax_and_recompute,0.6000000000000001,0,0,0,0.0,0.1286564128102257,23,22
5019,relax_and_recompute,0.6000000000000001,0,0,0,0.0,-0.1329273162327771,13,12
5020,relax_and_recompute,0.6000000000000001,1,0,1,49.42823286270669,0.0722521375104625,15,14
5021,relax_and_recompute,0.6000000000000001,0,0,0,0.0,0.0478851481790501,69,68
5022,relax_and_recompute,0.6000000000000001,0,0,0,0.0,-0.4006227876141174,40,39
5023,relax_and_recompute,0.6000000000000001,14,0,14,59.79962325407431,-0.166539825117385,89,93
5024,relax_and_recompute,0.6000000000000001,9,14,-5,14.139041578063017,0.0321167459032106,20,32
5025,relax_and_recompute,0.6000000000000001,5,4,1,4.643977969397099,-0.1562478303319907,69,83
5026,relax_and_recompute,0.6000000000000001,1,1,0,-16.776548076670302,0.4350563976067338,12,15
5027,relax_and_recompute,0.6000000000000001,0,0,0,0.0,0.1439726557257689,15,14
5028,relax_and_recompute,0.6000000000000001,4,5,-1,13.309754920360902,-0.088506173965015,23,26
5029,relax_and_recompute,0.6000000000000001,2,2,0,2.8564018660218977,-0.0476803211116015,12,20
5030,relax_and_recompute,0.6000000000000001,244,172,72,0.3340915241212059,0.0594155118832971,64,122
5031,relax_and_recompute,0.6000000000000001,15,9,6,-0.8354141242857196,0.2599942813943022,58,71
5032,relax_and_recompute,0.6000000000000001,0,0,0,0.0,0.1648375079619572,20,19
5033,relax_and_recompute,0.6000000000000001,294,302,-8,-0.7769099718976307,0.2639402345007116,100,191
5034,relax_and_recompute,0.6000000000000001,33,32,1,3.377105016336273,-0.2420131761647032,41,61
5035,relax_and_recompute,0.6000000000000001,40,20,20,-4.033237705114125,0.0658768595919618,13,31
5036,relax_and_recompute,0.6000000000000001,3,2,1,20.17495375744309,-0.0694090312166993,10,15
5037,relax_and_recompute,0.6000000000000001,14,15,-1,6.452223963219126,-0.1219336706444023,37,47
5038,relax_and_recompute,0.6000000000000001,0,1,-1,-88.64199770413057,-0.2479516937835454,21,21
5039,relax_and_recompute,0.6000000000000001,0,0,0,0.0,-0.0323668456186007,11,10
5040,relax_and_recompute,0.6000000000000001,47,58,-11,1.5516099110055066,-0.3330356370526197,44,80
5041,relax_and_recompute,0.6000000000000001,4,3,1,2.0442526419205223,0.0003733267283031,12,21
5042,relax_and_recompute,0.6000000000000001,1,3,-2,-40.80049583017449,-0.039268185126146,37,43
5043,relax_and_recompute,0.6000000000000001,17,20,-3,-8.523093317182287,-0.2762383418024118,41,52
5044,relax_and_recompute,0.6000000000000001,2,0,2,76.3610876887623,-0.234397046167445,90,89
5045,relax_and_recompute,0.6000000000000001,0,0,0,0.0,-0.2339442005643316,22,21
5046,relax_and_recompute,0.6000000000000001,2,4,-2,19.528774828958973,0.092170472068677,37,43
5047,relax_and_recompute,0.6000000000000001,1,0,1,75.60808979727894,-0.1605819075501984,47,47
5048,relax_and_recompute,0.6000000000000001,4,5,-1,16.1769393117913,0.0856438893699438,12,20
5049,relax_and_recompute,0.6000000000000001,141,114,27,-2.956395305236853,0.1229538460573339,84,124
5050,relax_and_recompute,0.6000000000000001,0,1,-1,-72.81706003663204,0.0031805003802464,88,92
5051,relax_and_recompute,0.6000000000000001,374,370,4,-5.439719981307079,-0.0029063046723822,59,122
5052,relax_and_recompute,0.6000000000000001,6,3,3,-17.54161135401025,0.1912648693720789,26,31
5053,relax_and_recompute,0.6000000000000001,0,0,0,0.0,-0.1669457335205879,28,27
5054,relax_and_recompute,0.6000000000000001,25,7,18,2.5064477861112806,0.008437505559029,18,26
5055,relax_and_recompute,0.6000000000000001,1,4,-3,10.922565093090384,-0.0193355075024389,23,26
5056,relax_and_recompute,0.6000000000000001,0,0,0,0.0,-0.0165647480411822,43,43
5057,relax_and_recompute,0.6000000000000001,1,1,0,24.325334965815145,0.0195589038440022,22,26
5058,relax_and_recompute,0.6000000000000001,0,0,0,0.0,0.0662512661731322,15,14
5059,relax_and_recompute,0.6000000000000001,33,15,18,-2.772513240973552,0.3830877378738324,36,48
5060,relax_and_recompute,0.6000000000000001,7,7,0,-8.454710190015426,-0.1212935868232704,30,37
5061,relax_and_recompute,0.6000000000000001,2,2,0,-6.766345222979524,0.086746698086238,10,13
5062,relax_and_recompute,0.6000000000000001,1,0,1,76.7290922396087,-0.0502461179997431,12,11
5063,relax_and_recompute,0.6000000000000001,223,156,67,-2.6507000498568445,0.097360394771612,55,105
5064,relax_and_recompute,0.6000000000000001,0,0,0,0.0,0.0050499851263136,13,17
5065,relax_and_recompute,0.6000000000000001,0,1,-1,-45.96914680438263,-0.0120156966153124,30,29
5066,relax_and_recompute,0.6000000000000001,0,2,-2,-62.71286423154979,0.5172523687438695,36,43
5067,relax_and_recompute,0.6000000000000001,34,22,12,6.974085814797064,-0.1767383682636766,40,60
5068,relax_and_recompute,0.6000000000000001,1,4,-3,-1.0006057749529944,-0.0622881345509737,13,17
5069,relax_and_recompute,0.6000000000000001,20,7,13,-5.562290921372572,0.1970603125335855,23,30
5070,relax_and_recompute,0.6000000000000001,0,1,-1,-30.18171149337644,0.0080687197557339,12,16
5071,relax_and_recompute,0.6000000000000001,0,0,0,0.0,-0.2676935279906918,26,26
5072,relax_and_recompute,0.6000000000000001,1,2,-1,-41.72873676513899,0.0477942302419681,22,31
5073,relax_and_recompute,0.6000000000000001,0,0,0,0.0,0.0713265253146396,68,68
5074,relax_and_recompute,0.6000000000000001,0,0,0,0.0,-0.0623006676314027,23,22
5075,relax_and_recompute,0.6000000000000001,0,0,0,0.0,0.0373968425335848,43,42
5076,relax_and_recompute,0.6000000000000001,0,0,0,0.0,-0.5086614592984925,18,17
5077,relax_and_recompute,0.6000000000000001,9,13,-4,2.0457096157377777,0.0263638160304781,28,42
5078,relax_and_recompute,0.6000000000000001,54,44,10,3.77805565262274,-0.1187173362519098,21,44
5079,relax_and_recompute,0.6000000000000001,0,1,-1,-73.56225536496525,0.1479104328275742,36,37
5080,relax_and_recompute,0.6000000000000001,0,0,0,0.0,-0.1586716417078497,15,14
5081,relax_and_recompute,0.6000000000000001,2,2,0,-13.68152838481118,-0.625333198300386,14,16
5082,relax_and_recompute,0.6000000000000001,219,167,52,-0.5708974052773073,-0.0045964356789216,61,119
5083,relax_and_recompute,0.6000000000000001,2,0,2,63.863252442996334,0.1117721065058761,19,20
5084,relax_and_recompute,0.6000000000000001,2,0,2,76.54127250738696,0.4009428706721172,22,22
5085,relax_and_recompute,0.6000000000000001,2,4,-2,4.763599487874089,0.1365083910668596,54,58
5086,relax_and_recompute,0.6000000000000001,433,444,-11,-0.2508004986480188,-0.0098368548647357,65,135
5087,relax_and_recompute,0.6000000000000001,2,0,2,66.77208377464251,-0.1762191247595597,16,18
5088,relax_and_recompute,0.6000000000000001,8,11,-3,-2.708899869031825,0.1148734746018859,17,27
5089,relax_and_recompute,0.6000000000000001,9,14,-5,2.513200363489915,0.187148288855023,54,71
5090,relax_and_recompute,0.6000000000000001,3,0,3,75.02160657688847,0.1527983485477068,23,22
5091,relax_and_recompute,0.6000000000000001,2,2,0,5.801861965170978,0.0447552733671618,13,16
5092,relax_and_recompute,0.6000000000000001,155,111,44,-0.0609688622367912,0.0627564400322363,85,131
5093,relax_and_recompute,0.6000000000000001,46,44,2,3.376865591729313,0.0460949925752126,28,55
5094,relax_and_recompute,0.6000000000000001,1,3,-2,20.930933087781035,-0.3511132765929953,18,24
5095,relax_and_recompute,0.6000000000000001,1,7,-6,-9.686581743287093,0.044911152789657,19,22
5096,relax_and_recompute,0.6000000000000001,0,0,0,0.0,-0.0516561218912798,47,46
5097,relax_and_recompute,0.6000000000000001,73,36,37,3.4758695574961607,-0.1647242900590758,39,64
5098,relax_and_recompute,0.6000000000000001,0,0,0,0.0,0.2002488879303271,17,18
5099,relax_and_recompute,0.6000000000000001,4,1,3,-14.924164563036342,-0.3318645759104934,23,24
5100,relax_and_recompute,0.6000000000000001,1,1,0,-22.28400847660481,-0.3738867520098185,13,16
5101,relax_and_recompute,0.6000000000000001,16,16,0,4.665228928060927,0.1187988730763087,40,56
5102,relax_and_recompute,0.6000000000000001,0,1,-1,-54.66681119704283,-0.2434932471863993,10,15
5103,relax_and_recompute,0.6000000000000001,0,0,0,0.0,0.2724630473052665,21,20
5104,relax_and_recompute,0.6000000000000001,1,8,-7,-7.9578303426923185,-0.1985030919396558,30,35
5105,relax_and_recompute,0.6000000000000001,10,3,7,15.251178988952944,0.0291725753059205,71,77
5106,relax_one,0.6000000000000001,0,1,-1,-78.97533291637423,-0.0422557718826493,17,18
5107,relax_one,0.6000000000000001,4,2,2,17.286129438380243,-0.2907584346455139,43,48
5108,relax_one,0.6000000000000001,5,7,-2,8.822038539112548,-0.205177455348163,38,45
5109,relax_one,0.6000000000000001,1,2,-1,-9.640878864640229,-0.3094678394449526,12,12
5110,relax_one,0.6000000000000001,4,18,-14,24.6999870750308,-0.1554675460512108,23,38
5111,relax_one,0.6000000000000001,1,1,0,-4.201275855663496,-0.3222931661317544,19,22
5112,relax_one,0.6000000000000001,939,899,40,-0.0582030732032308,-0.0439622186634443,35,143
5113,relax_one,0.6000000000000001,4,2,2,-21.542624582104715,0.0923985067074008,92,91
5114,relax_one,0.6000000000000001,7,4,3,3.137423411865349,-0.0267680280461862,43,51
5115,relax_one,0.6000000000000001,9,1,8,5.65908091199131,0.0329257620057956,35,36
5116,relax_one,0.6000000000000001,0,0,0,0.0,-0.2089080698765436,11,13
5117,relax_one,0.6000000000000001,18,12,6,-0.0227441022366292,-0.1033965935174593,10,25
5118,relax_one,0.6000000000000001,14,31,-17,4.791635141028927,-0.2231307094427285,86,136
5119,relax_one,0.6000000000000001,0,0,0,0.0,-0.4113533698565283,10,12
5120,relax_one,0.6000000000000001,0,0,0,0.0,0.0292290271441945,32,31
5121,relax_one,0.6000000000000001,9,2,7,1.7285616381855815,-0.038999202264047,20,26
5122,relax_one,0.6000000000000001,1,0,1,69.13511811953119,0.0140847907717842,11,11
5123,relax_one,0.6000000000000001,8,3,5,27.566304095483005,0.3872551745302439,34,42
5124,relax_one,0.6000000000000001,11,12,-1,0.343610931663818,-0.1276432973172345,14,25
5125,relax_one,0.6000000000000001,10,8,2,7.713194416538677,-0.0486325147806427,31,46
5126,relax_one,0.6000000000000001,0,0,0,0.0,0.0600962985481248,42,45
5127,relax_one,0.6000000000000001,1065,1189,-124,-0.1164430348379426,0.0155243560570887,39,173
5128,relax_one,0.6000000000000001,10,9,1,0.5241982324082528,-0.0531816286434647,14,24
5129,relax_one,0.6000000000000001,0,0,0,0.0,0.0298894130362048,24,25
5130,relax_one,0.6000000000000001,1,1,0,9.669720607363388,-0.0642942173051506,12,19
5131,relax_one,0.6000000000000001,87,73,14,2.2724715254753107,0.031072544002784,41,72
5132,relax_one,0.6000000000000001,229,172,57,1.0733807675526066,-0.0909219620377976,59,115
5133,relax_one,0.6000000000000001,8,7,1,-4.001784083630369,-0.0217748349856713,32,37
5134,relax_one,0.6000000000000001,0,0,0,0.0,-0.3874226562886856,20,20
5135,relax_one,0.6000000000000001,25,19,6,-1.8598081789525625,0.0624943746795259,12,31
5136,relax_one,0.6000000000000001,0,0,0,0.0,0.0868149328605695,10,10
5137,relax_one,0.6000000000000001,1,0,1,87.22597706555888,-0.0633662150685283,20,21
5138,relax_one,0.6000000000000001,13,25,-12,6.053830929504713,0.0106638084409872,39,52
5139,relax_one,0.6000000000000001,416,324,92,-0.6910268158217647,-0.2935793033796756,42,109
5140,relax_one,0.6000000000000001,1,7,-6,-3.0440861967376094,0.049312398311954,25,28
5141,relax_one,0.6000000000000001,186,157,29,-1.739078705368577,-0.3670889307582117,56,106
5142,relax_one,0.6000000000000001,575,483,92,0.1280972017384058,0.1768590513282992,87,189
5143,relax_one,0.6000000000000001,32,32,0,3.1067310895287505,-0.2027251163719008,56,82
5144,relax_one,0.6000000000000001,1,1,0,3.762833182743549,-0.1180184024868039,13,15
5145,relax_one,0.6000000000000001,97,73,24,-1.6029700263599125,-0.029175370185015,36,63
5146,relax_one,0.6000000000000001,1,0,1,83.98446028633721,0.2149914879575277,16,15
5147,relax_one,0.6000000000000001,0,0,0,0.0,-0.0873649790723667,67,66
5148,relax_one,0.6000000000000001,17,22,-5,4.019031068015877,-0.0954985558475345,42,60
5149,relax_one,0.6000000000000001,1,1,0,7.35241216357457,0.0833170317780418,39,38
5150,relax_one,0.6000000000000001,10,11,-1,-6.159736008107323,-0.0286841899442918,20,36
5151,relax_one,0.6000000000000001,0,0,0,0.0,0.2420237471849585,10,9
5152,relax_one,0.6000000000000001,0,1,-1,-76.08894358555,0.0706688579011609,13,15
5153,relax_one,0.6000000000000001,5,4,1,8.42654624045663,-0.0572934228424261,34,41
5154,relax_one,0.6000000000000001,5,4,1,-37.67920350221878,0.3077324340246795,37,42
5155,relax_one,0.6000000000000001,33,22,11,0.1445965586728164,0.2850181899659447,18,29
5156,relax_one,0.6000000000000001,1,0,1,89.2581810050475,0.3052553108392105,23,22
5157,relax_one,0.6000000000000001,0,0,0,0.0,0.108523386361418,13,12
5158,relax_one,0.6000000000000001,0,0,0,0.0,0.1993750054141289,15,14
5159,relax_one,0.6000000000000001,0,0,0,0.0,-0.1762666919782007,69,68
5160,relax_one,0.6000000000000001,0,0,0,0.0,0.1520930023863496,40,39
5161,relax_one,0.6000000000000001,1,1,0,-59.191671434342,-0.1625987114277918,89,93
5162,relax_one,0.6000000000000001,16,10,6,-16.2084558620937,-0.0682009695505774,20,32
5163,relax_one,0.6000000000000001,4,7,-3,-2.729698741636512,0.1165560312815985,69,83
5164,relax_one,0.6000000000000001,3,1,2,-15.48721751870108,0.133041925794043,12,15
5165,relax_one,0.6000000000000001,1,1,0,-6.752249955292598,-0.0524842749694948,15,14
5166,relax_one,0.6000000000000001,0,4,-4,-75.95979823698633,-0.1036985668320844,23,26
5167,relax_one,0.6000000000000001,2,2,0,-10.74785088077084,-0.0509622528337171,12,20
5168,relax_one,0.6000000000000001,200,198,2,1.1433807280344936,0.0358635876148768,64,122
5169,relax_one,0.6000000000000001,11,12,-1,6.727624066580724,0.1570313514067679,58,71
5170,relax_one,0.6000000000000001,0,0,0,0.0,0.1625488112165021,20,19
5171,relax_one,0.6000000000000001,345,365,-20,2.6943011306693805,-0.0317086191480395,100,191
5172,relax_one,0.6000000000000001,66,26,40,-1.32255059097605,-0.0526436808845317,41,61
5173,relax_one,0.6000000000000001,34,27,7,-2.111284027182066,-0.1296559589285283,13,31
5174,relax_one,0.6000000000000001,3,4,-1,-6.681981115093379,-0.0139405692732734,10,15
5175,relax_one,0.6000000000000001,6,5,1,6.949907833849608,0.2634027522285174,37,47
5176,relax_one,0.6000000000000001,1,1,0,-8.991105058779766,0.027096426224124,21,21
5177,relax_one,0.6000000000000001,0,1,-1,-62.04857770655127,0.1960313781874042,11,10
5178,relax_one,0.6000000000000001,41,72,-31,2.8711169176535805,-0.5214486377461569,44,80
5179,relax_one,0.6000000000000001,4,3,1,1.664633635000186,0.2202379219240405,12,21
5180,relax_one,0.6000000000000001,10,4,6,10.90369758365231,0.0892361681292779,37,43
5181,relax_one,0.6000000000000001,13,13,0,1.041258288527807,-0.0973217699956404,41,52
5182,relax_one,0.6000000000000001,0,1,-1,-77.4759266568054,-0.2453276490898076,90,89
5183,relax_one,0.6000000000000001,0,0,0,0.0,-0.188558602274818,22,21
5184,relax_one,0.6000000000000001,4,8,-4,-29.24819765175461,-0.1369606561247679,37,43
5185,relax_one,0.6000000000000001,2,1,1,-7.3487540779300815,0.0025171142039159,47,47
5186,relax_one,0.6000000000000001,9,5,4,13.763142769811893,0.1725006905476533,12,20
5187,relax_one,0.6000000000000001,160,114,46,-2.076634521332238,0.0940986332630214,84,124
5188,relax_one,0.6000000000000001,8,6,2,6.013753159374922,0.2108327542815824,88,92
5189,relax_one,0.6000000000000001,479,364,115,-1.1609389852052203,0.1997619722009559,59,122
5190,relax_one,0.6000000000000001,5,3,2,9.20963000696581,-0.2878959867457298,26,31
5191,relax_one,0.6000000000000001,0,0,0,0.0,-0.3982742653448057,28,27
5192,relax_one,0.6000000000000001,4,3,1,-0.2044280774859714,-0.160590788235838,18,26
5193,relax_one,0.6000000000000001,1,6,-5,-5.271883746340947,-0.0578350449338642,23,26
5194,relax_one,0.6000000000000001,1,0,1,73.61827226979189,0.181558275212655,43,43
5195,relax_one,0.6000000000000001,4,1,3,7.937478396801794,0.0565124923288642,22,26
5196,relax_one,0.6000000000000001,0,0,0,0.0,0.3917461206908776,15,14
5197,relax_one,0.6000000000000001,12,21,-9,1.1866879987318484,0.0162487445233745,36,48
5198,relax_one,0.6000000000000001,9,9,0,1.3546638039653658,0.3530151182923179,30,37
5199,relax_one,0.6000000000000001,1,2,-1,4.353780257894286,-0.0118099409310958,10,13
5200,relax_one,0.6000000000000001,0,1,-1,-82.12558360309275,-0.0589357168644002,12,11
5201,relax_one,0.6000000000000001,222,190,32,0.2486217818112024,-0.234574794623472,55,105
5202,relax_one,0.6000000000000001,2,2,0,-1.1472209077934394,-0.3556994918260313,13,17
5203,relax_one,0.6000000000000001,1,0,1,76.79308867524844,0.1866794461353568,30,29
5204,relax_one,0.6000000000000001,7,7,0,0.1970302717217862,0.1900567883723535,36,43
5205,relax_one,0.6000000000000001,33,32,1,-2.182242542731629,-0.2802948805169949,40,60
5206,relax_one,0.6000000000000001,0,1,-1,-51.21811066787704,0.0294586290649578,13,17
5207,relax_one,0.6000000000000001,10,5,5,-5.7814106670013246,0.3645078922811098,23,30
5208,relax_one,0.6000000000000001,0,3,-3,-77.73328904205376,0.0440672608873843,12,16
5209,relax_one,0.6000000000000001,1,0,1,60.78710449179745,0.0982467384599705,26,26
5210,relax_one,0.6000000000000001,1,1,0,40.40583306713752,0.1387905298341298,22,31
5211,relax_one,0.6000000000000001,0,0,0,0.0,0.0905452759885522,68,68
5212,relax_one,0.6000000000000001,0,0,0,0.0,-0.0153486019480402,23,22
5213,relax_one,0.6000000000000001,0,0,0,0.0,0.1553993468662673,43,42
5214,relax_one,0.6000000000000001,0,0,0,0.0,0.0116912329782665,18,17
5215,relax_one,0.6000000000000001,6,4,2,-5.084747757599189,-0.0419233881646194,28,42
5216,relax_one,0.6000000000000001,44,43,1,-0.6255285685307115,0.037756474402034,21,44
5217,relax_one,0.6000000000000001,6,0,6,60.1523354117517,0.0923703494557939,36,37
5218,relax_one,0.6000000000000001,0,0,0,0.0,0.2187497401082849,15,14
5219,relax_one,0.6000000000000001,0,1,-1,-68.00298785888737,-0.253728244426029,14,16
5220,relax_one,0.6000000000000001,195,238,-43,2.0094661796817874,0.0777528253039556,61,119
5221,relax_one,0.6000000000000001,0,0,0,0.0,-0.3971660596651413,19,20
5222,relax_one,0.6000000000000001,0,0,0,0.0,-0.3913468149941886,22,22
5223,relax_one,0.6000000000000001,0,0,0,0.0,-0.5063788354388623,54,58
5224,relax_one,0.6000000000000001,501,465,36,1.5830159043707752,-0.1406155870430954,65,135
5225,relax_one,0.6000000000000001,1,2,-1,-12.305331209514051,0.0049290196365944,16,18
5226,relax_one,0.6000000000000001,10,7,3,-7.4061262338961455,-0.038833770920344,17,27
5227,relax_one,0.6000000000000001,35,11,24,5.877425836021246,0.3225944880618682,54,71
5228,relax_one,0.6000000000000001,0,2,-2,-39.118048679478,-0.3731532717279558,23,22
5229,relax_one,0.6000000000000001,2,0,2,50.314732530546834,-0.0243949462527646,13,16
5230,relax_one,0.6000000000000001,173,126,47,1.167293232305461,-0.1952810158585308,85,131
5231,relax_one,0.6000000000000001,44,49,-5,-1.477939186597261,-0.1839411616287949,28,55
5232,relax_one,0.6000000000000001,5,3,2,16.777040333146893,0.4366880250289568,18,24
5233,relax_one,0.6000000000000001,2,1,1,35.40258150958454,-0.2659329111960165,19,22
5234,relax_one,0.6000000000000001,1,0,1,79.21651429688661,-0.0356600891072081,47,46
5235,relax_one,0.6000000000000001,42,27,15,4.282265493811252,0.0071766012251973,39,64
5236,relax_one,0.6000000000000001,0,1,-1,-76.31120196957619,0.0926503676248272,17,18
5237,relax_one,0.6000000000000001,2,1,1,6.628490833830853,0.0598456856657625,23,24
5238,relax_one,0.6000000000000001,1,0,1,66.41098814028688,0.1937574801544908,13,16
5239,relax_one,0.6000000000000001,25,17,8,6.125044775242479,-0.0039933671669696,40,56
5240,relax_one,0.6000000000000001,0,1,-1,-66.63338740053369,-0.1621996678047463,10,15
5241,relax_one,0.6000000000000001,0,0,0,0.0,-0.1036773913012889,21,20
5242,relax_one,0.6000000000000001,5,3,2,-0.0468728926947505,-0.2228046490585817,30,35
5243,relax_one,0.6000000000000001,0,2,-2,-39.0895806737036,-0.0038162176240637,71,77
5244,just_relax,0.6000000000000001,0,0,0,0.0,-0.1496389081516438,17,18
5245,just_relax,0.6000000000000001,15,8,7,-2.772701686721888,0.1692510920095657,43,48
5246,just_relax,0.6000000000000001,7,4,3,-18.741554809379863,-0.0774393539719953,38,45
5247,just_relax,0.6000000000000001,1,0,1,63.67719408132706,-0.4527778750985365,12,12
5248,just_relax,0.6000000000000001,11,27,-16,5.198651965562711,0.1975450181482525,23,38
5249,just_relax,0.6000000000000001,1,1,0,-11.101678613329897,0.0248409925990557,19,22
5250,just_relax,0.6000000000000001,765,793,-28,-0.1098009283903636,0.0674680926461561,35,143
5251,just_relax,0.6000000000000001,4,4,0,16.65270125137956,-0.0065169392793648,92,91
5252,just_relax,0.6000000000000001,2,14,-12,13.361812672650046,-0.2554527995627706,43,51
5253,just_relax,0.6000000000000001,6,5,1,29.064723383799468,-0.1230150933037077,35,36
5254,just_relax,0.6000000000000001,1,0,1,80.70714355904994,0.4422900963089898,11,13
5255,just_relax,0.6000000000000001,26,24,2,10.556227899023668,-0.0814347189075019,10,25
5256,just_relax,0.6000000000000001,26,27,-1,15.602514406915304,-0.2894922179559217,86,136
5257,just_relax,0.6000000000000001,2,0,2,80.85558925575702,0.2725234540150641,10,12
5258,just_relax,0.6000000000000001,0,0,0,0.0,-0.0488962130334879,32,31
5259,just_relax,0.6000000000000001,6,7,-1,16.41359977728078,-0.2336514150612576,20,26
5260,just_relax,0.6000000000000001,0,0,0,0.0,0.0905013784764743,11,11
5261,just_relax,0.6000000000000001,5,15,-10,8.140136459583069,-0.2123356330031496,34,42
5262,just_relax,0.6000000000000001,13,17,-4,11.45762191937689,-0.1238661515559457,14,25
5263,just_relax,0.6000000000000001,14,6,8,-9.307477310483604,-0.0141784932997112,31,46
5264,just_relax,0.6000000000000001,1,8,-7,24.54387863510061,-0.0343085062911768,42,45
5265,just_relax,0.6000000000000001,1127,1015,112,-1.7977185266073974,-0.0375336806547539,39,173
5266,just_relax,0.6000000000000001,8,11,-3,4.046623509156774,0.0424414166650113,14,24
5267,just_relax,0.6000000000000001,0,1,-1,-87.63590343686431,-0.1821166658732333,24,25
5268,just_relax,0.6000000000000001,1,2,-1,19.94868558955153,0.4307592084364782,12,19
5269,just_relax,0.6000000000000001,54,80,-26,8.976891917827437,0.2468116633014317,41,72
5270,just_relax,0.6000000000000001,193,226,-33,2.259365304544154,0.0546312403692699,59,115
5271,just_relax,0.6000000000000001,3,11,-8,-8.096015564641135,0.0807092995157499,32,37
5272,just_relax,0.6000000000000001,0,2,-2,-66.36546991572284,-0.2482804136504348,20,20
5273,just_relax,0.6000000000000001,25,23,2,-2.283565326783531,-0.1343068507333364,12,31
5274,just_relax,0.6000000000000001,0,1,-1,-82.69806834091585,0.1610445239114004,10,10
5275,just_relax,0.6000000000000001,4,0,4,79.09827494069489,0.2116196175961445,20,21
5276,just_relax,0.6000000000000001,20,33,-13,-1.584236510392799,0.1176079214680064,39,52
5277,just_relax,0.6000000000000001,355,371,-16,0.6152617730082284,0.0858870090110681,42,109
5278,just_relax,0.6000000000000001,6,0,6,72.47379803878623,-0.2256525302365148,25,28
5279,just_relax,0.6000000000000001,201,265,-64,3.361127443506589,-0.0419342532914979,56,106
5280,just_relax,0.6000000000000001,413,624,-211,13.137771131761632,0.0969193831497243,87,189
5281,just_relax,0.6000000000000001,39,58,-19,13.590777198994026,-0.0091844054355783,56,82
5282,just_relax,0.6000000000000001,1,1,0,28.957707686996173,-0.1289590553223932,13,15
5283,just_relax,0.6000000000000001,97,75,22,5.078423824836591,0.117305328309232,36,63
5284,just_relax,0.6000000000000001,0,1,-1,-64.9495024292822,-0.0445975773647674,16,15
5285,just_relax,0.6000000000000001,0,0,0,0.0,0.14839693088306,67,66
5286,just_relax,0.6000000000000001,16,20,-4,-0.4305368973588201,0.1897496749124193,42,60
5287,just_relax,0.6000000000000001,10,1,9,-20.36003185903625,0.0293746459895499,39,38
5288,just_relax,0.6000000000000001,10,9,1,-7.615419318777469,-0.5643310097370628,20,36
5289,just_relax,0.6000000000000001,0,0,0,0.0,-0.0576347937151665,10,9
5290,just_relax,0.6000000000000001,1,0,1,69.29749051434368,-0.1926056770949777,13,15
5291,just_relax,0.6000000000000001,13,12,1,-2.47277923396053,-0.038202716268449,34,41
5292,just_relax,0.6000000000000001,4,6,-2,9.372457144237243,0.1281576187650813,37,42
5293,just_relax,0.6000000000000001,35,18,17,-15.58795430588927,0.1214710612168203,18,29
5294,just_relax,0.6000000000000001,0,0,0,0.0,0.4612766118046558,23,22
5295,just_relax,0.6000000000000001,0,0,0,0.0,-0.099839816463298,13,12
5296,just_relax,0.6000000000000001,0,0,0,0.0,0.0682972689520302,15,14
5297,just_relax,0.6000000000000001,0,0,0,0.0,-0.3040234242456446,69,68
5298,just_relax,0.6000000000000001,2,0,2,55.27078796399934,0.0980746587480849,40,39
5299,just_relax,0.6000000000000001,2,5,-3,-0.1180992279201404,-0.0856272160532661,89,93
5300,just_relax,0.6000000000000001,10,20,-10,-0.2004708799651098,0.1032629004120693,20,32
5301,just_relax,0.6000000000000001,8,4,4,-2.436325887930167,0.3424587280744994,69,83
5302,just_relax,0.6000000000000001,1,2,-1,8.802264590191605,0.4706229875934644,12,15
5303,just_relax,0.6000000000000001,1,1,0,2.550226776387732,0.2428167603829901,15,14
5304,just_relax,0.6000000000000001,6,0,6,63.90879648464116,0.1507977676029108,23,26
5305,just_relax,0.6000000000000001,3,2,1,-19.63665883137319,0.0323712507155982,12,20
5306,just_relax,0.6000000000000001,196,176,20,2.158386406151955,-0.2018190685011961,64,122
5307,just_relax,0.6000000000000001,16,9,7,25.390023899853453,-0.0166542388268992,58,71
5308,just_relax,0.6000000000000001,0,0,0,0.0,-0.0306840791876508,20,19
5309,just_relax,0.6000000000000001,342,296,46,2.161403239098931,-0.0519565607385211,100,191
5310,just_relax,0.6000000000000001,60,61,-1,-1.7990989506591504,0.2297821212293501,41,61
5311,just_relax,0.6000000000000001,22,46,-24,5.754272629843783,-0.179037660364147,13,31
5312,just_relax,0.6000000000000001,4,5,-1,13.15632960843297,-0.0553115560632576,10,15
5313,just_relax,0.6000000000000001,11,6,5,-8.18370843140815,0.2563034838899108,37,47
5314,just_relax,0.6000000000000001,1,3,-2,-10.063270556017557,-0.0631224492874533,21,21
5315,just_relax,0.6000000000000001,0,0,0,0.0,0.1627555710146172,11,10
5316,just_relax,0.6000000000000001,46,48,-2,-0.1877155677817938,-0.0653348553591345,44,80
5317,just_relax,0.6000000000000001,4,2,2,-10.619462112155633,-0.5815638102572644,12,21
5318,just_relax,0.6000000000000001,2,4,-2,26.906844858153768,-0.1508580478232237,37,43
5319,just_relax,0.6000000000000001,13,16,-3,-8.847955449841905,0.198571814495934,41,52
5320,just_relax,0.6000000000000001,0,5,-5,-69.63252750210896,0.0948581585381347,90,89
5321,just_relax,0.6000000000000001,0,0,0,0.0,0.1193586867356513,22,21
5322,just_relax,0.6000000000000001,2,4,-2,-11.836425911646913,-0.1874505799272625,37,43
5323,just_relax,0.6000000000000001,0,6,-6,-52.30760869867917,-0.1874605156822179,47,47
5324,just_relax,0.6000000000000001,4,4,0,-3.280310925892437,-0.3177400128244338,12,20
5325,just_relax,0.6000000000000001,146,149,-3,-1.612021666318782,-0.1689800574812867,84,124
5326,just_relax,0.6000000000000001,1,5,-4,-47.89007018399236,0.0753120380514698,88,92
5327,just_relax,0.6000000000000001,321,367,-46,1.1765392643217467,-0.1176888373708274,59,122
5328,just_relax,0.6000000000000001,2,2,0,-0.1814520125624454,-0.0118006650496679,26,31
5329,just_relax,0.6000000000000001,0,0,0,0.0,-0.2737693943159084,28,27
5330,just_relax,0.6000000000000001,9,2,7,25.77821955005522,0.3207604813002123,18,26
5331,just_relax,0.6000000000000001,4,1,3,-12.85414235550232,0.0138050310263748,23,26
5332,just_relax,0.6000000000000001,1,0,1,74.70363394019104,0.0689913642992644,43,43
5333,just_relax,0.6000000000000001,2,7,-5,0.6480449008880527,0.1497558245944349,22,26
5334,just_relax,0.6000000000000001,0,0,0,0.0,0.3460107596065064,15,14
5335,just_relax,0.6000000000000001,22,26,-4,5.706006123963462,-0.0258828709195926,36,48
5336,just_relax,0.6000000000000001,7,9,-2,9.570593316527706,-0.3648902712725873,30,37
5337,just_relax,0.6000000000000001,1,1,0,0.9585029567162168,-0.0919168222226836,10,13
5338,just_relax,0.6000000000000001,0,0,0,0.0,0.2642075294225614,12,11
5339,just_relax,0.6000000000000001,213,231,-18,-1.6074369341667705,-0.0005775093549788,55,105
5340,just_relax,0.6000000000000001,1,1,0,-25.65054919121836,0.2071725873586973,13,17
5341,just_relax,0.6000000000000001,0,1,-1,-28.599894202524265,0.0399908007689632,30,29
5342,just_relax,0.6000000000000001,7,3,4,7.134653661856063,0.0850652080789673,36,43
5343,just_relax,0.6000000000000001,24,26,-2,7.858899637452318,0.2764173388894969,40,60
5344,just_relax,0.6000000000000001,2,1,1,24.896032617826226,-0.3377589691881606,13,17
5345,just_relax,0.6000000000000001,3,9,-6,-14.10823702879025,0.5483119241002369,23,30
5346,just_relax,0.6000000000000001,2,1,1,13.342975469052448,-0.0525254982497277,12,16
5347,just_relax,0.6000000000000001,1,0,1,81.12640441349839,-0.515388868332578,26,26
5348,just_relax,0.6000000000000001,0,1,-1,-38.13604559624397,0.0679195827663151,22,31
5349,just_relax,0.6000000000000001,0,19,-19,-69.69880305592949,-0.1736162253048011,68,68
5350,just_relax,0.6000000000000001,0,0,0,0.0,-0.0286439435971711,23,22
5351,just_relax,0.6000000000000001,1,9,-8,-12.179570608493693,0.2078976350175649,43,42
5352,just_relax,0.6000000000000001,0,1,-1,-76.11973567465779,-0.0671783130836,18,17
5353,just_relax,0.6000000000000001,6,10,-4,6.38888460480797,0.0085108940456503,28,42
5354,just_relax,0.6000000000000001,39,48,-9,3.170319550926827,-0.2493373265838776,21,44
5355,just_relax,0.6000000000000001,1,3,-2,17.46383781009598,-0.1529950539309348,36,37
5356,just_relax,0.6000000000000001,0,0,0,0.0,-0.206852403931616,15,14
5357,just_relax,0.6000000000000001,1,0,1,83.23806581645563,-0.1619025654313384,14,16
5358,just_relax,0.6000000000000001,293,242,51,-0.640335018339556,0.08430897417844,61,119
5359,just_relax,0.6000000000000001,0,0,0,0.0,0.2707915564278986,19,20
5360,just_relax,0.6000000000000001,0,1,-1,-76.58044978376185,-0.3379029106844678,22,22
5361,just_relax,0.6000000000000001,5,3,2,20.99518059727407,-0.167297232487503,54,58
5362,just_relax,0.6000000000000001,459,941,-482,5.456227540833424,-0.1470085403199967,65,135
5363,just_relax,0.6000000000000001,1,1,0,-1.2263219824125855,0.0542065093474335,16,18
5364,just_relax,0.6000000000000001,10,7,3,4.245404384921812,-0.1966211514272731,17,27
5365,just_relax,0.6000000000000001,25,10,15,-6.505307303572948,0.2689448781423842,54,71
5366,just_relax,0.6000000000000001,1,4,-3,-0.3583070389777703,0.068172121481869,23,22
5367,just_relax,0.6000000000000001,3,1,2,-8.50648865828424,-0.2953417488045009,13,16
5368,just_relax,0.6000000000000001,179,215,-36,1.971936523797872,-0.07660670219218,85,131
5369,just_relax,0.6000000000000001,29,40,-11,-3.729822065070437,-0.1910679434932807,28,55
5370,just_relax,0.6000000000000001,14,10,4,22.93822488784061,-0.1540777478942554,18,24
5371,just_relax,0.6000000000000001,1,3,-2,-5.24861942389991,-0.1273209143182994,19,22
5372,just_relax,0.6000000000000001,2,0,2,79.35126985809534,0.2741538565995953,47,46
5373,just_relax,0.6000000000000001,77,74,3,9.125357055685498,0.2640552305538549,39,64
5374,just_relax,0.6000000000000001,1,1,0,-3.9950274530717,-0.405774833191045,17,18
5375,just_relax,0.6000000000000001,4,3,1,-20.5537215147756,0.3606634823638636,23,24
5376,just_relax,0.6000000000000001,1,1,0,-9.58474133806,-0.2365281554362966,13,16
5377,just_relax,0.6000000000000001,20,59,-39,-0.1760987104095832,-0.2867126451682812,40,56
5378,just_relax,0.6000000000000001,1,1,0,1.7927275864391137,-0.3474560047506334,10,15
5379,just_relax,0.6000000000000001,2,3,-1,6.397409282567182,0.0244621640995674,21,20
5380,just_relax,0.6000000000000001,6,4,2,7.342859116546471,0.2311460878495261,30,35
5381,just_relax,0.6000000000000001,3,7,-4,-18.71804912982764,-0.0317498122022533,71,77
5382,relax_and_recompute,0.65,1,2,-1,11.202926438932336,-0.4037003644386754,17,18
5383,relax_and_recompute,0.65,6,8,-2,-16.711921715055958,0.2173985811476291,43,48
5384,relax_and_recompute,0.65,7,9,-2,5.050636192623912,-0.0366290896392941,38,45
5385,relax_and_recompute,0.65,0,2,-2,-74.99831309075785,-0.2362915258669823,12,12
5386,relax_and_recompute,0.65,13,16,-3,0.2618908831613211,0.0794073274809186,23,38
5387,relax_and_recompute,0.65,2,2,0,26.14935546214525,0.1537001731514115,19,22
5388,relax_and_recompute,0.65,874,822,52,0.5760155043311883,0.0750980763637524,35,143
5389,relax_and_recompute,0.65,4,1,3,16.245269835338163,-0.102988113145065,92,91
5390,relax_and_recompute,0.65,2,4,-2,-11.451680479547186,-0.1653663602425625,43,51
5391,relax_and_recompute,0.65,3,0,3,70.07553224959514,0.5796851479592922,35,36
5392,relax_and_recompute,0.65,0,0,0,0.0,0.0405357341560687,11,13
5393,relax_and_recompute,0.65,34,19,15,-0.3824591541548159,-0.1953198837743728,10,25
5394,relax_and_recompute,0.65,16,27,-11,3.0515382313180908,-0.0635598296853395,86,136
5395,relax_and_recompute,0.65,0,0,0,0.0,-0.2018957200231793,10,12
5396,relax_and_recompute,0.65,0,0,0,0.0,-0.0234401722438244,32,31
5397,relax_and_recompute,0.65,2,3,-1,-12.852455751273837,0.0409505615544837,20,26
5398,relax_and_recompute,0.65,0,1,-1,-73.36662485381687,0.347262191899866,11,11
5399,relax_and_recompute,0.65,14,5,9,-0.2443183505153143,-0.0928751547652809,34,42
5400,relax_and_recompute,0.65,12,10,2,-3.479984020820851,-0.4135035088869599,14,25
5401,relax_and_recompute,0.65,6,5,1,-5.306235251169532,-0.0113406865227209,31,46
5402,relax_and_recompute,0.65,0,0,0,0.0,0.1734234857959834,42,45
5403,relax_and_recompute,0.65,1103,1090,13,0.4843587007953118,0.1087909663214133,39,173
5404,relax_and_recompute,0.65,14,11,3,-5.034806213365499,-0.1687983504125384,14,24
5405,relax_and_recompute,0.65,2,0,2,74.2916556231734,-0.1705740730271155,24,25
5406,relax_and_recompute,0.65,1,1,0,9.180274351173338,-0.0310154912226824,12,19
5407,relax_and_recompute,0.65,49,73,-24,-1.7551748398772844,0.0102289869020549,41,72
5408,relax_and_recompute,0.65,237,193,44,2.4160103013434764,0.0409133702300811,59,115
5409,relax_and_recompute,0.65,4,3,1,0.6847283001677482,0.0015019278823901,32,37
5410,relax_and_recompute,0.65,0,0,0,0.0,0.2943556267666896,20,20
5411,relax_and_recompute,0.65,32,21,11,2.8270468342265502,0.0637736407856062,12,31
5412,relax_and_recompute,0.65,0,0,0,0.0,0.0901779513950665,10,10
5413,relax_and_recompute,0.65,2,2,0,-4.467908125654006,0.5579375101881505,20,21
5414,relax_and_recompute,0.65,21,21,0,-4.987839808592462,0.1580567638027844,39,52
5415,relax_and_recompute,0.65,512,363,149,0.189363310447959,-0.1734166163882091,42,109
5416,relax_and_recompute,0.65,1,2,-1,7.335787284129452,0.0031463397480566,25,28
5417,relax_and_recompute,0.65,182,207,-25,0.111718503304921,0.1079437413891448,56,106
5418,relax_and_recompute,0.65,454,441,13,-0.269586641639826,0.2721694625320385,87,189
5419,relax_and_recompute,0.65,56,44,12,4.584677940024335,-0.1111292619647014,56,82
5420,relax_and_recompute,0.65,2,2,0,-12.629152949891193,-0.3134906965793508,13,15
5421,relax_and_recompute,0.65,82,75,7,-0.5489749459790829,0.3292772370513548,36,63
5422,relax_and_recompute,0.65,1,0,1,76.72779306160317,0.183668906867094,16,15
5423,relax_and_recompute,0.65,0,0,0,0.0,-0.2115623354393697,67,66
5424,relax_and_recompute,0.65,19,11,8,-5.856598841347044,0.1637765414218419,42,60
5425,relax_and_recompute,0.65,0,0,0,0.0,-0.0549880225203793,39,38
5426,relax_and_recompute,0.65,9,10,-1,-3.797074775830751,-0.2778890663235296,20,36
5427,relax_and_recompute,0.65,1,0,1,86.58786896921261,0.3113168792887534,10,9
5428,relax_and_recompute,0.65,0,0,0,0.0,0.3439886095887243,13,15
5429,relax_and_recompute,0.65,8,10,-2,6.760794669015027,0.029407894970269,34,41
5430,relax_and_recompute,0.65,4,4,0,6.466646237693439,0.0546999748445234,37,42
5431,relax_and_recompute,0.65,16,26,-10,0.8367607722204582,-0.0289427919621829,18,29
5432,relax_and_recompute,0.65,1,0,1,76.77377785823663,0.1365541294385022,23,22
5433,relax_and_recompute,0.65,0,0,0,0.0,0.0449555781473275,13,12
5434,relax_and_recompute,0.65,0,0,0,0.0,-0.0293207463078788,15,14
5435,relax_and_recompute,0.65,0,0,0,0.0,0.0168593090751135,69,68
5436,relax_and_recompute,0.65,0,0,0,0.0,-0.3507836352440695,40,39
5437,relax_and_recompute,0.65,0,0,0,0.0,0.2384130627611252,89,93
5438,relax_and_recompute,0.65,9,13,-4,-1.7819900044588195,0.0998755776546904,20,32
5439,relax_and_recompute,0.65,7,5,2,1.901368930475656,0.1478393761057103,69,83
5440,relax_and_recompute,0.65,2,2,0,-10.659478786612638,0.0960749526053241,12,15
5441,relax_and_recompute,0.65,0,1,-1,-68.61172581829364,-0.3445030599068364,15,14
5442,relax_and_recompute,0.65,2,2,0,15.477491010997454,0.0631522496229715,23,26
5443,relax_and_recompute,0.65,6,2,4,-9.400894152570402,0.3708201881873095,12,20
5444,relax_and_recompute,0.65,225,193,32,-0.8045281655324672,0.0338941785498625,64,122
5445,relax_and_recompute,0.65,15,13,2,-7.537161414245759,-0.2281674135412238,58,71
5446,relax_and_recompute,0.65,0,0,0,0.0,-0.0616568413412108,20,19
5447,relax_and_recompute,0.65,396,293,103,-0.3622536774742499,-0.0609735121847697,100,191
5448,relax_and_recompute,0.65,23,32,-9,12.18245628935984,0.0927810998926071,41,61
5449,relax_and_recompute,0.65,19,15,4,-1.859797808217948,0.0389020214602423,13,31
5450,relax_and_recompute,0.65,4,3,1,9.475142634848552,0.4908111472400561,10,15
5451,relax_and_recompute,0.65,10,18,-8,-18.375938134243043,0.0149450062251866,37,47
5452,relax_and_recompute,0.65,0,0,0,0.0,0.0813971693706459,21,21
5453,relax_and_recompute,0.65,0,0,0,0.0,0.138276003462773,11,10
5454,relax_and_recompute,0.65,60,65,-5,8.319450537300604,-0.159279130776463,44,80
5455,relax_and_recompute,0.65,2,2,0,-9.103045923777586,0.424778157820509,12,21
5456,relax_and_recompute,0.65,2,1,1,12.667118898030388,-0.1914726774797372,37,43
5457,relax_and_recompute,0.65,20,36,-16,5.970321648650888,-0.1047095674783539,41,52
5458,relax_and_recompute,0.65,0,0,0,0.0,0.2284080654474155,90,89
5459,relax_and_recompute,0.65,2,0,2,67.74804145463281,0.0572690204947526,22,21
5460,relax_and_recompute,0.65,6,3,3,-6.839820795638175,-0.0811036349827182,37,43
5461,relax_and_recompute,0.65,4,0,4,53.881783521557225,0.219102487245559,47,47
5462,relax_and_recompute,0.65,7,6,1,-0.6117069757236209,-0.3812868044184603,12,20
5463,relax_and_recompute,0.65,114,123,-9,-0.2573775170168204,0.0969164783127727,84,124
5464,relax_and_recompute,0.65,17,5,12,-4.635002081336182,0.3135688937122548,88,92
5465,relax_and_recompute,0.65,357,418,-61,-1.3727170008796463,0.0951627266681899,59,122
5466,relax_and_recompute,0.65,4,3,1,-0.2691670139817006,0.0264904250499034,26,31
5467,relax_and_recompute,0.65,0,0,0,0.0,0.3560805755861542,28,27
5468,relax_and_recompute,0.65,8,1,7,-21.483461532895305,0.0613519655600968,18,26
5469,relax_and_recompute,0.65,4,4,0,13.522638378837328,-0.1791546839544231,23,26
5470,relax_and_recompute,0.65,3,1,2,-6.035013129372373,0.2211832104866382,43,43
5471,relax_and_recompute,0.65,6,1,5,6.8526443962983805,0.1952370031743676,22,26
5472,relax_and_recompute,0.65,0,0,0,0.0,-0.3096098514811498,15,14
5473,relax_and_recompute,0.65,14,11,3,-5.343609176967092,0.0253807093295199,36,48
5474,relax_and_recompute,0.65,9,9,0,-11.373752446147272,0.0450577790095855,30,37
5475,relax_and_recompute,0.65,2,7,-5,6.711147064098853,-0.3622083089597233,10,13
5476,relax_and_recompute,0.65,0,0,0,0.0,0.0825108750992198,12,11
5477,relax_and_recompute,0.65,209,170,39,-2.038753387718941,-0.2309692995030913,55,105
5478,relax_and_recompute,0.65,3,0,3,67.94197595488468,-0.1523075289416776,13,17
5479,relax_and_recompute,0.65,0,1,-1,-74.29298616632572,-0.1024260920262261,30,29
5480,relax_and_recompute,0.65,18,1,17,-8.260461941578342,-0.267911726976992,36,43
5481,relax_and_recompute,0.65,21,8,13,4.985945322177408,0.3661261029386019,40,60
5482,relax_and_recompute,0.65,1,1,0,-45.19745017253012,-0.1507384133747855,13,17
5483,relax_and_recompute,0.65,5,10,-5,7.682303916195089,-0.1268837810704891,23,30
5484,relax_and_recompute,0.65,2,1,1,41.99510072824634,-0.0915724928514228,12,16
5485,relax_and_recompute,0.65,0,0,0,0.0,-0.0070962737072634,26,26
5486,relax_and_recompute,0.65,2,1,1,17.244635272468365,0.0626134153877944,22,31
5487,relax_and_recompute,0.65,0,1,-1,-76.8371256631895,-0.1055736341519881,68,68
5488,relax_and_recompute,0.65,0,0,0,0.0,0.0668759769703847,23,22
5489,relax_and_recompute,0.65,0,0,0,0.0,-0.2454923819229627,43,42
5490,relax_and_recompute,0.65,0,0,0,0.0,0.2640479486552736,18,17
5491,relax_and_recompute,0.65,14,3,11,-3.915230370620037,0.0011696830000142,28,42
5492,relax_and_recompute,0.65,41,35,6,-0.7378641259789731,0.0748333300360704,21,44
5493,relax_and_recompute,0.65,0,0,0,0.0,-0.0679830458841911,36,37
5494,relax_and_recompute,0.65,0,0,0,0.0,0.1382474238688211,15,14
5495,relax_and_recompute,0.65,1,1,0,-8.938061491490188,-0.4277505846036967,14,16
5496,relax_and_recompute,0.65,331,197,134,0.3057575160615471,0.0507591907838704,61,119
5497,relax_and_recompute,0.65,0,0,0,0.0,0.4568791249805312,19,20
5498,relax_and_recompute,0.65,0,0,0,0.0,-0.1926996858136331,22,22
5499,relax_and_recompute,0.65,2,0,2,76.49724939513794,0.0451056036607132,54,58
5500,relax_and_recompute,0.65,686,439,247,-1.5754003222531168,0.0503843726829307,65,135
5501,relax_and_recompute,0.65,0,1,-1,-68.18800151851663,-0.0069382290417847,16,18
5502,relax_and_recompute,0.65,7,7,0,-2.0956533343455632,0.1952147266291071,17,27
5503,relax_and_recompute,0.65,17,12,5,-15.96877546955212,0.2242057181277892,54,71
5504,relax_and_recompute,0.65,0,0,0,0.0,0.115406596092707,23,22
5505,relax_and_recompute,0.65,1,1,0,-14.846670331059514,0.2205586366651711,13,16
5506,relax_and_recompute,0.65,185,136,49,-0.357322768847645,0.0483711070083376,85,131
5507,relax_and_recompute,0.65,32,36,-4,-7.218097573563412,0.2760012610945532,28,55
5508,relax_and_recompute,0.65,0,3,-3,-65.27428073598487,0.3569695175400177,18,24
5509,relax_and_recompute,0.65,2,2,0,-5.693065255177245,-0.4901067485432634,19,22
5510,relax_and_recompute,0.65,1,1,0,-17.44921900117383,-0.0296861478706254,47,46
5511,relax_and_recompute,0.65,40,27,13,-5.322285674290164,0.0876150557073901,39,64
5512,relax_and_recompute,0.65,0,0,0,0.0,0.0251272394958415,17,18
5513,relax_and_recompute,0.65,1,1,0,-11.092988531616768,-0.3877212721489432,23,24
5514,relax_and_recompute,0.65,1,1,0,-7.324111576119535,-0.3013051968202697,13,16
5515,relax_and_recompute,0.65,12,32,-20,7.021312014701778,0.1036604750499988,40,56
5516,relax_and_recompute,0.65,0,1,-1,-83.12088043705685,-0.1514017234823128,10,15
5517,relax_and_recompute,0.65,0,0,0,0.0,0.4946983686413938,21,20
5518,relax_and_recompute,0.65,1,4,-3,2.3433097705672807,0.0498206634506026,30,35
5519,relax_and_recompute,0.65,9,3,6,19.964610708582008,-0.1307234619247965,71,77
5520,relax_one,0.65,0,1,-1,-77.52757306735819,0.108710706374526,17,18
5521,relax_one,0.65,5,4,1,-0.8484054113448352,0.1973233886902177,43,48
5522,relax_one,0.65,7,13,-6,-0.7913590898696867,-0.0945848745126377,38,45
5523,relax_one,0.65,0,1,-1,-88.48288238279626,-0.0759388966294281,12,12
5524,relax_one,0.65,15,7,8,-3.6662837040835967,-0.035553776264416,23,38
5525,relax_one,0.65,1,3,-2,2.00693071822532,0.2175419836273611,19,22
5526,relax_one,0.65,822,797,25,2.3033433941484347,0.0868046680802923,35,143
5527,relax_one,0.65,2,1,1,-12.846988401386284,-0.1291877686917556,92,91
5528,relax_one,0.65,3,13,-10,3.594720860380121,0.1957872199492403,43,51
5529,relax_one,0.65,7,0,7,64.09824152775066,0.0575755181215912,35,36
5530,relax_one,0.65,0,1,-1,-86.5501631284925,-0.1609257228186155,11,13
5531,relax_one,0.65,27,23,4,2.173501890317965,-0.1085438795459841,10,25
5532,relax_one,0.65,47,22,25,-2.0747097627410014,-0.0002238819246549,86,136
5533,relax_one,0.65,0,0,0,0.0,0.2267099233908396,10,12
5534,relax_one,0.65,0,0,0,0.0,0.0397068028342142,32,31
5535,relax_one,0.65,2,2,0,6.694222507019376,0.0669742554143519,20,26
5536,relax_one,0.65,0,0,0,0.0,0.4821893009850666,11,11
5537,relax_one,0.65,8,7,1,-5.694101936052888,-0.2151226688794502,34,42
5538,relax_one,0.65,12,11,1,-0.2633100996296207,0.4224303488313952,14,25
5539,relax_one,0.65,12,11,1,-1.5017804616400952,0.0619629879702229,31,46
5540,relax_one,0.65,0,4,-4,-64.09876207095041,-0.2945559037379566,42,45
5541,relax_one,0.65,1227,1076,151,-0.6982640654827392,-0.0490106983904916,39,173
5542,relax_one,0.65,11,11,0,0.5599728420787926,0.438326619279262,14,24
5543,relax_one,0.65,1,3,-2,32.84857209964594,-0.1005353009804219,24,25
5544,relax_one,0.65,2,1,1,6.907938120801404,0.1802050990190085,12,19
5545,relax_one,0.65,48,66,-18,-5.194309771015576,0.1384473482868939,41,72
5546,relax_one,0.65,250,159,91,0.1466683095059338,-0.0249228188221931,59,115
5547,relax_one,0.65,6,4,2,-15.75350851295655,0.0146884265031199,32,37
5548,relax_one,0.65,0,1,-1,-59.52445604491079,0.2848314028351748,20,20
5549,relax_one,0.65,26,25,1,0.7456158055835544,-0.0746593923996069,12,31
5550,relax_one,0.65,2,0,2,76.30704316586639,0.3748370769578102,10,10
5551,relax_one,0.65,0,0,0,0.0,-0.172348363109877,20,21
5552,relax_one,0.65,53,32,21,-1.2763777786136146,0.2326534958930581,39,52
5553,relax_one,0.65,327,324,3,2.643916041300713,-0.0092077248466082,42,109
5554,relax_one,0.65,0,1,-1,-58.747692819353446,0.222008324685753,25,28
5555,relax_one,0.65,209,162,47,-3.830084102952505,0.2691058961870766,56,106
5556,relax_one,0.65,475,435,40,-0.4905196817713388,0.3608025440919381,87,189
5557,relax_one,0.65,35,46,-11,2.7711717747893942,0.2233379850658156,56,82
5558,relax_one,0.65,1,1,0,-2.6704135087609586,0.0334458586500822,13,15
5559,relax_one,0.65,78,72,6,-0.6303747059967293,-0.4734442703363868,36,63
5560,relax_one,0.65,0,1,-1,-89.10162811128507,0.019942911900171,16,15
5561,relax_one,0.65,0,0,0,0.0,0.382229901291949,67,66
5562,relax_one,0.65,18,28,-10,-5.415867616955033,0.0594878791176125,42,60
5563,relax_one,0.65,1,0,1,66.39687625481028,0.1161012307956274,39,38
5564,relax_one,0.65,8,11,-3,10.886891303299135,-0.1241987884666649,20,36
5565,relax_one,0.65,0,0,0,0.0,-0.1342792671813797,10,9
5566,relax_one,0.65,2,1,1,36.08738121441127,0.1846063338299858,13,15
5567,relax_one,0.65,13,10,3,1.5235869530980324,0.0765850575084388,34,41
5568,relax_one,0.65,1,6,-5,12.232390895050202,-0.0500387448809906,37,42
5569,relax_one,0.65,31,33,-2,-2.6821322661506315,0.3167631306255367,18,29
5570,relax_one,0.65,2,0,2,80.09076250577249,0.1926805591549992,23,22
5571,relax_one,0.65,0,0,0,0.0,0.4080612050013565,13,12
5572,relax_one,0.65,0,0,0,0.0,0.2183419160836903,15,14
5573,relax_one,0.65,6,0,6,58.68942276001663,0.0927616486562296,69,68
5574,relax_one,0.65,0,0,0,0.0,0.2248374489078751,40,39
5575,relax_one,0.65,0,0,0,0.0,-0.3248767057340983,89,93
5576,relax_one,0.65,11,9,2,-0.805643065979794,-0.0141321544484456,20,32
5577,relax_one,0.65,5,3,2,-6.281300522272431,0.0296770228706104,69,83
5578,relax_one,0.65,1,2,-1,-2.9375775882943884,0.2253691114692034,12,15
5579,relax_one,0.65,1,0,1,76.1118128621419,-0.1662696539164381,15,14
5580,relax_one,0.65,3,0,3,64.36240036171243,-0.147143420057968,23,26
5581,relax_one,0.65,4,2,2,-4.045009018494312,-0.0091618188529279,12,20
5582,relax_one,0.65,271,190,81,3.006478178593703,0.0529795152631186,64,122
5583,relax_one,0.65,17,15,2,3.676671341382644,-0.2152013361514954,58,71
5584,relax_one,0.65,0,0,0,0.0,0.1854667517569818,20,19
5585,relax_one,0.65,379,284,95,-1.820911138171852,-0.1431134023086088,100,191
5586,relax_one,0.65,41,32,9,2.505204923277724,-0.1462207908739531,41,61
5587,relax_one,0.65,21,18,3,-1.133713348136368,-0.0091931283702957,13,31
5588,relax_one,0.65,3,3,0,-14.786201051753068,-0.3710106901410667,10,15
5589,relax_one,0.65,21,7,14,3.3313625414873016,0.0690441915603895,37,47
5590,relax_one,0.65,1,1,0,15.041105470411168,0.0985901880553332,21,21
5591,relax_one,0.65,0,0,0,0.0,-0.067710770923282,11,10
5592,relax_one,0.65,103,52,51,-2.734156016439627,0.1667008417881155,44,80
5593,relax_one,0.65,6,3,3,-4.034820836374649,-0.3674181093182604,12,21
5594,relax_one,0.65,4,2,2,5.409657187289596,0.1436116516790057,37,43
5595,relax_one,0.65,6,3,3,-13.408983262751754,-0.1615155095693917,41,52
5596,relax_one,0.65,0,1,-1,-59.92736585286695,0.3519607235066182,90,89
5597,relax_one,0.65,0,0,0,0.0,0.4003523771083038,22,21
5598,relax_one,0.65,11,1,10,25.99293645241238,0.3011197306822232,37,43
5599,relax_one,0.65,5,0,5,76.35780934229827,-0.1458939553153447,47,47
5600,relax_one,0.65,4,9,-5,-13.40958779589917,0.2047147583334452,12,20
5601,relax_one,0.65,139,112,27,-0.1111977123179102,0.1982913477568777,84,124
5602,relax_one,0.65,6,0,6,69.113243387696,-0.1514153876852071,88,92
5603,relax_one,0.65,413,337,76,-3.833249924464404,0.2315575311624276,59,122
5604,relax_one,0.65,11,6,5,-3.94219947835009,0.1521706038626069,26,31
5605,relax_one,0.65,1,0,1,81.64655020447066,0.2149140151068271,28,27
5606,relax_one,0.65,7,3,4,-4.859499792239703,0.2112538802840428,18,26
5607,relax_one,0.65,5,2,3,3.625932371671908,-0.0714682977536291,23,26
5608,relax_one,0.65,2,0,2,74.01792332204965,-0.0813472159794842,43,43
5609,relax_one,0.65,2,2,0,-4.802513077082196,-0.3661527833421049,22,26
5610,relax_one,0.65,0,0,0,0.0,0.0863796720649588,15,14
5611,relax_one,0.65,20,7,13,-13.643603528906894,0.0911496054428218,36,48
5612,relax_one,0.65,12,7,5,0.961486372509654,0.3708656773988471,30,37
5613,relax_one,0.65,2,2,0,-14.23192709442857,0.0981378964176075,10,13
5614,relax_one,0.65,0,0,0,0.0,0.1701132506569457,12,11
5615,relax_one,0.65,164,183,-19,0.7116569577417096,0.0837922043545968,55,105
5616,relax_one,0.65,0,1,-1,-76.92699181310341,-0.1593264617959459,13,17
5617,relax_one,0.65,1,1,0,-9.809655808187884,0.1397356716519024,30,29
5618,relax_one,0.65,15,17,-2,-10.011586367257811,-0.1570974288604709,36,43
5619,relax_one,0.65,31,23,8,6.383910716276112,0.2840886672408496,40,60
5620,relax_one,0.65,0,2,-2,-49.0944087253693,-0.0957918645590705,13,17
5621,relax_one,0.65,8,6,2,-3.5057239681216217,0.0222611748523373,23,30
5622,relax_one,0.65,1,1,0,16.933514344552698,-0.0088558224279123,12,16
5623,relax_one,0.65,0,4,-4,-71.17246577494683,-0.1378734843048046,26,26
5624,relax_one,0.65,1,0,1,89.59058852758885,0.1194892636086817,22,31
5625,relax_one,0.65,0,0,0,0.0,-0.2664537473630243,68,68
5626,relax_one,0.65,0,0,0,0.0,0.074429359674633,23,22
5627,relax_one,0.65,0,0,0,0.0,0.0275051632524551,43,42
5628,relax_one,0.65,1,1,0,33.55373601329788,0.1687117900048113,18,17
5629,relax_one,0.65,22,8,14,1.618452402009389,0.0110188238847774,28,42
5630,relax_one,0.65,46,43,3,-1.6836148135579665,-0.1450468027846345,21,44
5631,relax_one,0.65,1,0,1,73.54292546442072,0.1146749587394676,36,37
5632,relax_one,0.65,0,0,0,0.0,0.066080867017304,15,14
5633,relax_one,0.65,5,0,5,66.16375239406617,-0.0952650283820605,14,16
5634,relax_one,0.65,234,213,21,1.5503396589488505,-0.1719179632578503,61,119
5635,relax_one,0.65,2,0,2,73.45279376531275,0.0159773669711879,19,20
5636,relax_one,0.65,0,1,-1,-75.07368917230929,0.0605518318672602,22,22
5637,relax_one,0.65,4,0,4,67.0775705615283,0.0925998508830373,54,58
5638,relax_one,0.65,544,465,79,-0.4394311644249811,-0.0167818152891967,65,135
5639,relax_one,0.65,1,1,0,-0.7065495380575868,-0.4290609452879669,16,18
5640,relax_one,0.65,5,7,-2,-4.456168819368727,-0.0474133301427414,17,27
5641,relax_one,0.65,15,6,9,-1.5245598238438731,0.1828964822760533,54,71
5642,relax_one,0.65,1,0,1,68.5231430057444,-0.0187295563544916,23,22
5643,relax_one,0.65,2,3,-1,4.990352603743517,0.0274812132403892,13,16
5644,relax_one,0.65,171,146,25,4.645140307220906,0.016344832138733,85,131
5645,relax_one,0.65,53,32,21,3.535848252550032,-0.1885892879586549,28,55
5646,relax_one,0.65,9,5,4,7.054367700423725,-0.4939136214500345,18,24
5647,relax_one,0.65,2,5,-3,8.56262220029096,0.4306118795775929,19,22
5648,relax_one,0.65,1,0,1,79.87126635333232,0.2736446169958177,47,46
5649,relax_one,0.65,58,56,2,9.355472883193832,0.0968109336890643,39,64
5650,relax_one,0.65,1,1,0,-0.0130780105586296,-0.3331479052319162,17,18
5651,relax_one,0.65,1,1,0,23.00244103097772,-0.0403501714594248,23,24
5652,relax_one,0.65,1,0,1,89.81881004426178,0.1777067657951682,13,16
5653,relax_one,0.65,35,13,22,-15.346476877502989,0.0393847015487768,40,56
5654,relax_one,0.65,2,1,1,-18.122195502299263,-0.1071593695892212,10,15
5655,relax_one,0.65,0,0,0,0.0,-0.0256568871404885,21,20
5656,relax_one,0.65,2,3,-1,37.63129933438093,-0.401323721364788,30,35
5657,relax_one,0.65,8,6,2,22.542199805399072,-0.0462073509340978,71,77
5658,just_relax,0.65,0,0,0,0.0,0.2543189217169547,17,18
5659,just_relax,0.65,7,4,3,21.91955968502876,-0.1898274245438463,43,48
5660,just_relax,0.65,4,7,-3,-5.242137232022856,-0.376556959506485,38,45
5661,just_relax,0.65,0,0,0,0.0,-0.4312890746329751,12,12
5662,just_relax,0.65,7,25,-18,16.715156677635264,-0.0209346589584494,23,38
5663,just_relax,0.65,0,3,-3,-77.30416264378498,0.5534641764616813,19,22
5664,just_relax,0.65,914,868,46,0.8921792247783173,-0.0887891083882547,35,143
5665,just_relax,0.65,9,10,-1,3.3754921419334067,-0.0460471230937207,92,91
5666,just_relax,0.65,2,31,-29,-1.9636295425587988,-0.2526816444472963,43,51
5667,just_relax,0.65,1,0,1,71.2073687058511,-0.2064632874994323,35,36
5668,just_relax,0.65,0,0,0,0.0,-0.4730303749938594,11,13
5669,just_relax,0.65,18,23,-5,9.16828540760931,0.1004089399709565,10,25
5670,just_relax,0.65,31,24,7,5.063340724008853,0.3197545958491824,86,136
5671,just_relax,0.65,0,0,0,0.0,0.1260694468090902,10,12
5672,just_relax,0.65,0,0,0,0.0,-0.0402046948392084,32,31
5673,just_relax,0.65,4,4,0,1.333367669322925,-0.1159627962516208,20,26
5674,just_relax,0.65,0,1,-1,-83.84330609303233,-0.033367743014126,11,11
5675,just_relax,0.65,4,6,-2,-11.225954703082593,0.0807253882481874,34,42
5676,just_relax,0.65,11,14,-3,9.942509510375892,-0.374999400924544,14,25
5677,just_relax,0.65,12,13,-1,3.5924309439235955,-0.1234576963854798,31,46
5678,just_relax,0.65,0,11,-11,-60.64835407147265,0.2852816790399891,42,45
5679,just_relax,0.65,1151,1087,64,-0.1481062678318281,-0.0273165085859383,39,173
5680,just_relax,0.65,8,11,-3,9.297458905023229,-0.0106013762682201,14,24
5681,just_relax,0.65,5,0,5,70.4429106430421,-0.0532121082485416,24,25
5682,just_relax,0.65,2,2,0,11.898848341858285,0.4037577625024383,12,19
5683,just_relax,0.65,67,100,-33,-1.1330869993799553,0.108010493624053,41,72
5684,just_relax,0.65,195,177,18,5.382192439776752,-0.0039034183947935,59,115
5685,just_relax,0.65,6,5,1,21.35448071381621,0.0885397548588672,32,37
5686,just_relax,0.65,4,1,3,-7.105996045617374,0.0551546834631314,20,20
5687,just_relax,0.65,34,26,8,-10.629431061244134,-0.2480355781884231,12,31
5688,just_relax,0.65,0,0,0,0.0,0.375891668913329,10,10
5689,just_relax,0.65,0,1,-1,-68.03524711758931,0.2641960794414036,20,21
5690,just_relax,0.65,28,43,-15,-2.7189351521379166,0.0039517969145798,39,52
5691,just_relax,0.65,325,389,-64,1.8006844095475003,0.0156283209465147,42,109
5692,just_relax,0.65,2,0,2,74.26417210616543,-0.2152311000479899,25,28
5693,just_relax,0.65,286,308,-22,0.9055408229305256,-0.0017555744321506,56,106
5694,just_relax,0.65,465,672,-207,9.68315087196747,0.0667950367404397,87,189
5695,just_relax,0.65,30,38,-8,11.101131640738458,-0.1201699855830885,56,82
5696,just_relax,0.65,1,1,0,1.7466160258063184,0.1834383104429967,13,15
5697,just_relax,0.65,98,108,-10,3.654148979448472,0.0037842244156776,36,63
5698,just_relax,0.65,0,0,0,0.0,0.000391445559164,16,15
5699,just_relax,0.65,0,0,0,0.0,0.0966409392202182,67,66
5700,just_relax,0.65,29,32,-3,9.976081019070762,-0.3347267058455189,42,60
5701,just_relax,0.65,0,0,0,0.0,-0.1496474029300389,39,38
5702,just_relax,0.65,10,9,1,2.3097343292024988,-0.0202579871705873,20,36
5703,just_relax,0.65,1,0,1,89.33626909551793,-0.1475683902073655,10,9
5704,just_relax,0.65,2,0,2,80.95759381226192,-0.2435541142447653,13,15
5705,just_relax,0.65,12,17,-5,10.421055815484712,-0.1508216864853985,34,41
5706,just_relax,0.65,4,4,0,-18.03116005385909,0.0514915879676632,37,42
5707,just_relax,0.65,31,27,4,8.509372142861487,0.4778650950504134,18,29
5708,just_relax,0.65,1,0,1,70.20915197090707,-0.0188535519580629,23,22
5709,just_relax,0.65,0,0,0,0.0,-0.1961290625114998,13,12
5710,just_relax,0.65,1,0,1,80.15100964618767,0.2165554603895851,15,14
5711,just_relax,0.65,0,0,0,0.0,-0.5513874718648855,69,68
5712,just_relax,0.65,0,0,0,0.0,0.1592461553594674,40,39
5713,just_relax,0.65,1,5,-4,2.2951855310066094,-0.1825505835159583,89,93
5714,just_relax,0.65,11,17,-6,14.01816240842465,-0.0402685661299044,20,32
5715,just_relax,0.65,2,4,-2,24.459501370091296,-0.0637756887310502,69,83
5716,just_relax,0.65,0,1,-1,-61.54931705192278,-0.1540269931051714,12,15
5717,just_relax,0.65,0,0,0,0.0,0.3105099145524659,15,14
5718,just_relax,0.65,0,0,0,0.0,-0.0711841190059521,23,26
5719,just_relax,0.65,2,2,0,4.96216813193837,0.0340546457386372,12,20
5720,just_relax,0.65,175,200,-25,1.249800945720061,0.2934415634354416,64,122
5721,just_relax,0.65,13,6,7,3.070033150766797,-0.1401799173964086,58,71
5722,just_relax,0.65,0,1,-1,-81.44976155200905,0.0250392197176104,20,19
5723,just_relax,0.65,360,342,18,4.023195161044107,-0.2308671158060711,100,191
5724,just_relax,0.65,24,61,-37,12.672007809806182,0.0080136835875748,41,61
5725,just_relax,0.65,25,44,-19,7.430259590681274,0.1073408431863031,13,31
5726,just_relax,0.65,4,2,2,14.665607654213616,-0.1394448493500164,10,15
5727,just_relax,0.65,22,9,13,-4.006329279763577,-0.3217464556531701,37,47
5728,just_relax,0.65,0,2,-2,-79.36586946811207,0.1378024874930319,21,21
5729,just_relax,0.65,0,0,0,0.0,0.4348326820539064,11,10
5730,just_relax,0.65,73,45,28,-10.547418359749066,0.065796153803127,44,80
5731,just_relax,0.65,3,2,1,13.15069892350536,-0.5223573871020316,12,21
5732,just_relax,0.65,1,0,1,33.184483115685644,0.0599923898460756,37,43
5733,just_relax,0.65,21,12,9,-13.161203737290052,-0.3890180338829768,41,52
5734,just_relax,0.65,0,2,-2,-68.18665298170004,0.0833211682355488,90,89
5735,just_relax,0.65,0,0,0,0.0,-0.1021831932499131,22,21
5736,just_relax,0.65,0,1,-1,-69.295473349188,0.2885292152525072,37,43
5737,just_relax,0.65,3,14,-11,17.25545734122069,-0.1654196011632234,47,47
5738,just_relax,0.65,4,4,0,-1.2866371367458245,0.1362134966412672,12,20
5739,just_relax,0.65,114,138,-24,2.464480357254672,0.0997923281152467,84,124
5740,just_relax,0.65,1,1,0,1.0268812359012005,-0.4415337062475237,88,92
5741,just_relax,0.65,476,371,105,-1.170105233094617,-0.1113793430665848,59,122
5742,just_relax,0.65,5,4,1,1.9837666879344908,0.0358604422218716,26,31
5743,just_relax,0.65,0,0,0,0.0,-0.2931043577857989,28,27
5744,just_relax,0.65,9,2,7,16.03211365219066,0.0252583619383498,18,26
5745,just_relax,0.65,1,1,0,9.048690021848728,-0.5239595809403947,23,26
5746,just_relax,0.65,3,1,2,-24.760303752880084,0.0516133020892115,43,43
5747,just_relax,0.65,1,3,-2,-1.7761434295185126,-0.0985362321856166,22,26
5748,just_relax,0.65,0,0,0,0.0,0.1060498094035508,15,14
5749,just_relax,0.65,6,20,-14,4.781038941297801,0.05409810807433,36,48
5750,just_relax,0.65,3,6,-3,27.503762236937497,-0.2649494029242348,30,37
5751,just_relax,0.65,1,1,0,-1.69382685287907,0.1041665883479245,10,13
5752,just_relax,0.65,0,0,0,0.0,-0.3725962846280634,12,11
5753,just_relax,0.65,179,214,-35,5.130656339120016,0.0839052902674519,55,105
5754,just_relax,0.65,2,4,-2,16.457955261275124,0.2754626598997037,13,17
5755,just_relax,0.65,1,0,1,79.35344643630395,-0.0616110090125051,30,29
5756,just_relax,0.65,3,5,-2,-4.173020705395359,0.0354675443863136,36,43
5757,just_relax,0.65,16,44,-28,6.485385436922506,-0.3211347607341988,40,60
5758,just_relax,0.65,1,1,0,-21.37253487058309,-0.2869072500330212,13,17
5759,just_relax,0.65,12,5,7,-8.110217399344393,0.4705325761163466,23,30
5760,just_relax,0.65,2,0,2,81.66574611640827,0.1575399131634369,12,16
5761,just_relax,0.65,0,0,0,0.0,0.0322304960985448,26,26
5762,just_relax,0.65,1,1,0,13.005606565733707,0.0430011577542965,22,31
5763,just_relax,0.65,3,3,0,11.245848896037153,-0.0274851451242086,68,68
5764,just_relax,0.65,0,0,0,0.0,-0.1600241773113632,23,22
5765,just_relax,0.65,0,1,-1,-81.93481797075131,0.0408192225204953,43,42
5766,just_relax,0.65,0,0,0,0.0,-0.2505399533057677,18,17
5767,just_relax,0.65,9,8,1,-1.6808004350825172,0.5184049041938732,28,42
5768,just_relax,0.65,39,49,-10,4.290021681110176,-0.1749310681891644,21,44
5769,just_relax,0.65,0,26,-26,-65.25300188543595,-0.1037322785006341,36,37
5770,just_relax,0.65,0,0,0,0.0,-0.2247575457426535,15,14
5771,just_relax,0.65,3,1,2,-14.608649817739654,0.4081772602719016,14,16
5772,just_relax,0.65,226,239,-13,1.181234037617287,0.08151720294251,61,119
5773,just_relax,0.65,0,2,-2,-70.06625483112789,-0.0768147924054587,19,20
5774,just_relax,0.65,2,1,1,13.01535016134872,0.1375407600384188,22,22
5775,just_relax,0.65,1,3,-2,51.07240716866305,0.1190144541679646,54,58
5776,just_relax,0.65,573,610,-37,7.506948562209637,-0.1461053920720819,65,135
5777,just_relax,0.65,1,4,-3,17.74503290898089,-0.0216669070817262,16,18
5778,just_relax,0.65,7,6,1,-9.20886467472247,0.1781017434603725,17,27
5779,just_relax,0.65,8,15,-7,6.045578419956996,-0.0087381790745749,54,71
5780,just_relax,0.65,0,2,-2,-77.39735444418527,0.3032828109842562,23,22
5781,just_relax,0.65,2,0,2,73.05131048555765,-0.2909794311323651,13,16
5782,just_relax,0.65,141,279,-138,1.3652412701669547,0.0460331711993476,85,131
5783,just_relax,0.65,48,29,19,-3.633900761993488,-0.0691312218652618,28,55
5784,just_relax,0.65,7,1,6,9.025726050972231,0.06744915297334,18,24
5785,just_relax,0.65,0,6,-6,-69.58122983417054,-0.2005488956129654,19,22
5786,just_relax,0.65,1,0,1,87.930059760918,0.0718400561846986,47,46
5787,just_relax,0.65,68,40,28,6.3020238780923,0.100742921968626,39,64
5788,just_relax,0.65,0,1,-1,-84.6894928325197,-0.0191666082399016,17,18
5789,just_relax,0.65,2,1,1,7.217412536755717,0.0539060046725392,23,24
5790,just_relax,0.65,1,0,1,60.30076613143845,-0.201066110749768,13,16
5791,just_relax,0.65,22,57,-35,7.430670748524399,0.2939813228905518,40,56
5792,just_relax,0.65,2,0,2,74.54075549706243,0.0935484535284253,10,15
5793,just_relax,0.65,2,0,2,79.03935072027822,-0.0321082400829583,21,20
5794,just_relax,0.65,2,8,-6,12.227354313908265,-0.0670922026906446,30,35
5795,just_relax,0.65,1,10,-9,0.1144099519912202,-0.2240046965708013,71,77
5796,relax_and_recompute,0.7000000000000001,2,0,2,60.74740023804039,0.2851213578179322,17,18
5797,relax_and_recompute,0.7000000000000001,5,2,3,24.20158693665187,-0.1068224783939203,43,48
5798,relax_and_recompute,0.7000000000000001,12,8,4,0.6365080657741871,0.2651026512711326,38,45
5799,relax_and_recompute,0.7000000000000001,0,1,-1,-87.1674095824997,-0.2794917724560852,12,12
5800,relax_and_recompute,0.7000000000000001,6,6,0,1.4434715984878608,-0.2755299318006028,23,38
5801,relax_and_recompute,0.7000000000000001,1,1,0,-11.448016985647952,-0.3808631257636712,19,22
5802,relax_and_recompute,0.7000000000000001,955,889,66,1.2579793708506628,-0.0747539354983908,35,143
5803,relax_and_recompute,0.7000000000000001,8,1,7,-18.647804056523256,0.04803779669297,92,91
5804,relax_and_recompute,0.7000000000000001,8,6,2,3.345084680583099,0.0606588306927939,43,51
5805,relax_and_recompute,0.7000000000000001,0,2,-2,-83.88672015554124,-0.0976197486511983,35,36
5806,relax_and_recompute,0.7000000000000001,0,1,-1,-68.05783769378195,-0.3548265405398599,11,13
5807,relax_and_recompute,0.7000000000000001,18,23,-5,4.404627647475792,-0.1791744307332797,10,25
5808,relax_and_recompute,0.7000000000000001,59,23,36,-3.279562199234789,-0.2467709083000635,86,136
5809,relax_and_recompute,0.7000000000000001,0,1,-1,-44.23669244008972,-0.1164809292706242,10,12
5810,relax_and_recompute,0.7000000000000001,0,0,0,0.0,-0.0585557625433298,32,31
5811,relax_and_recompute,0.7000000000000001,3,4,-1,2.9670081556471715,-0.0234188917580572,20,26
5812,relax_and_recompute,0.7000000000000001,1,2,-1,-11.517626007395124,-0.4683209226844966,11,11
5813,relax_and_recompute,0.7000000000000001,4,3,1,18.25204039530893,0.0953071796427584,34,42
5814,relax_and_recompute,0.7000000000000001,12,11,1,-6.516083825173318,0.3286477205711869,14,25
5815,relax_and_recompute,0.7000000000000001,8,8,0,4.910524492816137,0.2004278105550757,31,46
5816,relax_and_recompute,0.7000000000000001,4,0,4,77.58905034220243,-0.0362991353780276,42,45
5817,relax_and_recompute,0.7000000000000001,1150,1130,20,-0.1551685231953854,-0.2212589489684694,39,173
5818,relax_and_recompute,0.7000000000000001,8,11,-3,0.1029834166327532,-0.3094838765921794,14,24
5819,relax_and_recompute,0.7000000000000001,4,0,4,58.716221627656665,-0.0994523480560082,24,25
5820,relax_and_recompute,0.7000000000000001,1,1,0,3.0026381870197554,0.2351608648142762,12,19
5821,relax_and_recompute,0.7000000000000001,106,61,45,-1.696479109358641,-0.165680336642273,41,72
5822,relax_and_recompute,0.7000000000000001,214,147,67,-0.3294387665058949,-0.1905614826583513,59,115
5823,relax_and_recompute,0.7000000000000001,9,4,5,11.544871563129403,-0.2519658257693786,32,37
5824,relax_and_recompute,0.7000000000000001,0,0,0,0.0,-0.0837407224829652,20,20
5825,relax_and_recompute,0.7000000000000001,33,24,9,-2.0319339499540945,-0.1906064026602272,12,31
5826,relax_and_recompute,0.7000000000000001,0,1,-1,-74.43634088017305,-0.2558000629647304,10,10
5827,relax_and_recompute,0.7000000000000001,1,0,1,82.2632723095518,0.6223294377914307,20,21
5828,relax_and_recompute,0.7000000000000001,21,17,4,-4.610397182281702,-0.1711240716866867,39,52
5829,relax_and_recompute,0.7000000000000001,352,354,-2,1.1863065076045416,-0.1212391622580668,42,109
5830,relax_and_recompute,0.7000000000000001,5,1,4,-27.23039241426561,0.0362779361040505,25,28
5831,relax_and_recompute,0.7000000000000001,151,218,-67,0.8023372950048469,-0.0424761460438899,56,106
5832,relax_and_recompute,0.7000000000000001,385,374,11,1.3310314657764195,-0.2561799239338599,87,189
5833,relax_and_recompute,0.7000000000000001,53,39,14,-2.446900173720266,0.2577641037962588,56,82
5834,relax_and_recompute,0.7000000000000001,2,1,1,-29.680441800802846,-0.2770949446815067,13,15
5835,relax_and_recompute,0.7000000000000001,78,69,9,-5.240052159092599,0.129702897201679,36,63
5836,relax_and_recompute,0.7000000000000001,0,0,0,0.0,-0.0080804149688411,16,15
5837,relax_and_recompute,0.7000000000000001,0,0,0,0.0,0.0909827600308569,67,66
5838,relax_and_recompute,0.7000000000000001,12,16,-4,-3.541328854599378,-0.0558502311537555,42,60
5839,relax_and_recompute,0.7000000000000001,0,4,-4,-72.352053786856,-0.0810559197984369,39,38
5840,relax_and_recompute,0.7000000000000001,10,19,-9,5.812839932333276,-0.1686639062328723,20,36
5841,relax_and_recompute,0.7000000000000001,0,0,0,0.0,0.2411005265359359,10,9
5842,relax_and_recompute,0.7000000000000001,1,2,-1,-2.9409401493016816,0.383769304607329,13,15
5843,relax_and_recompute,0.7000000000000001,5,3,2,-1.828284857049568,-0.1868937287118016,34,41
5844,relax_and_recompute,0.7000000000000001,3,7,-4,17.76733276729263,0.257722321569074,37,42
5845,relax_and_recompute,0.7000000000000001,31,23,8,-4.746283353447097,0.1104769879672259,18,29
5846,relax_and_recompute,0.7000000000000001,1,0,1,82.10181444067506,-0.0620269533400507,23,22
5847,relax_and_recompute,0.7000000000000001,0,0,0,0.0,0.2391510838918014,13,12
5848,relax_and_recompute,0.7000000000000001,4,0,4,67.0250922850094,-0.0442274536207302,15,14
5849,relax_and_recompute,0.7000000000000001,0,0,0,0.0,0.0496433539898498,69,68
5850,relax_and_recompute,0.7000000000000001,0,0,0,0.0,-0.0876839617322989,40,39
5851,relax_and_recompute,0.7000000000000001,2,1,1,-5.231897160809108,-0.4254581991612638,89,93
5852,relax_and_recompute,0.7000000000000001,11,10,1,-11.556435795588484,-0.0865469204350374,20,32
5853,relax_and_recompute,0.7000000000000001,5,0,5,78.17128446439916,-0.0835247897717198,69,83
5854,relax_and_recompute,0.7000000000000001,4,0,4,71.75100769846895,0.0997805646102931,12,15
5855,relax_and_recompute,0.7000000000000001,0,0,0,0.0,-0.3990899933435792,15,14
5856,relax_and_recompute,0.7000000000000001,2,2,0,-18.707169226854106,0.0922199244136144,23,26
5857,relax_and_recompute,0.7000000000000001,7,9,-2,-6.328231686167328,-0.0405164809900594,12,20
5858,relax_and_recompute,0.7000000000000001,196,213,-17,-0.368540535784092,0.1311277365783784,64,122
5859,relax_and_recompute,0.7000000000000001,4,4,0,-4.255501135083804,0.2219548060041308,58,71
5860,relax_and_recompute,0.7000000000000001,1,0,1,71.61170110922536,-0.2844686063611639,20,19
5861,relax_and_recompute,0.7000000000000001,329,366,-37,-0.1315635001448996,0.236406868397992,100,191
5862,relax_and_recompute,0.7000000000000001,46,32,14,9.43336173024845,0.2464888111565196,41,61
5863,relax_and_recompute,0.7000000000000001,15,13,2,7.67472183724837,0.0943706493963071,13,31
5864,relax_and_recompute,0.7000000000000001,3,3,0,11.073540489987847,-0.0924383804386903,10,15
5865,relax_and_recompute,0.7000000000000001,7,13,-6,12.064391899458585,-0.1691238872839939,37,47
5866,relax_and_recompute,0.7000000000000001,0,0,0,0.0,-0.019736945615685,21,21
5867,relax_and_recompute,0.7000000000000001,0,0,0,0.0,-0.1263408438651337,11,10
5868,relax_and_recompute,0.7000000000000001,44,74,-30,-1.1346926670381947,0.1884712794582311,44,80
5869,relax_and_recompute,0.7000000000000001,4,3,1,7.730772844564925,-0.2412451544631727,12,21
5870,relax_and_recompute,0.7000000000000001,6,1,5,-23.05825294261799,-0.0883862661139468,37,43
5871,relax_and_recompute,0.7000000000000001,18,20,-2,-13.294115246312892,0.0432573780196121,41,52
5872,relax_and_recompute,0.7000000000000001,2,1,1,-33.094286720062414,0.05623112028109,90,89
5873,relax_and_recompute,0.7000000000000001,0,0,0,0.0,-0.3558450808098273,22,21
5874,relax_and_recompute,0.7000000000000001,15,2,13,17.478692189397805,0.1251103641025204,37,43
5875,relax_and_recompute,0.7000000000000001,1,2,-1,-2.8067015347915003,0.3643064054660703,47,47
5876,relax_and_recompute,0.7000000000000001,5,4,1,-16.18929310086226,-0.1884746003486258,12,20
5877,relax_and_recompute,0.7000000000000001,101,105,-4,-3.0999414508987044,-0.1882024914388105,84,124
5878,relax_and_recompute,0.7000000000000001,3,0,3,67.51702245040994,0.2341165845925179,88,92
5879,relax_and_recompute,0.7000000000000001,306,466,-160,0.156382692494077,-0.0755711769179899,59,122
5880,relax_and_recompute,0.7000000000000001,3,6,-3,19.2602987939595,-0.0959863134289163,26,31
5881,relax_and_recompute,0.7000000000000001,0,0,0,0.0,0.181872282584888,28,27
5882,relax_and_recompute,0.7000000000000001,1,2,-1,-40.5539332994357,0.4443918818474232,18,26
5883,relax_and_recompute,0.7000000000000001,6,6,0,-15.832357655030664,0.151207806539843,23,26
5884,relax_and_recompute,0.7000000000000001,3,1,2,-17.589917501806923,0.0786146038961032,43,43
5885,relax_and_recompute,0.7000000000000001,3,2,1,-10.969249277793187,-0.184035966968857,22,26
5886,relax_and_recompute,0.7000000000000001,0,0,0,0.0,0.0323771994720725,15,14
5887,relax_and_recompute,0.7000000000000001,11,7,4,4.414752771060662,-0.124528031092604,36,48
5888,relax_and_recompute,0.7000000000000001,11,7,4,-8.789100887028404,0.1755307988473546,30,37
5889,relax_and_recompute,0.7000000000000001,2,2,0,7.769829498186446,0.2488923804304165,10,13
5890,relax_and_recompute,0.7000000000000001,0,0,0,0.0,-0.0215787220474703,12,11
5891,relax_and_recompute,0.7000000000000001,201,237,-36,1.355474797670297,0.1895452426160406,55,105
5892,relax_and_recompute,0.7000000000000001,2,0,2,67.30530043187198,0.0980909216952007,13,17
5893,relax_and_recompute,0.7000000000000001,3,2,1,-27.004743205342407,0.1523549271068798,30,29
5894,relax_and_recompute,0.7000000000000001,3,1,2,10.418636119223407,0.1317310208373864,36,43
5895,relax_and_recompute,0.7000000000000001,28,10,18,-2.215894456551148,-0.2102389996463161,40,60
5896,relax_and_recompute,0.7000000000000001,0,0,0,0.0,-0.0119121233383897,13,17
5897,relax_and_recompute,0.7000000000000001,13,4,9,7.3289671949805,-0.266627619667792,23,30
5898,relax_and_recompute,0.7000000000000001,1,1,0,34.04361372468432,-0.4184810208702439,12,16
5899,relax_and_recompute,0.7000000000000001,0,1,-1,-70.29160390937824,0.0481693932089344,26,26
5900,relax_and_recompute,0.7000000000000001,0,2,-2,-64.79094628664846,-0.0299300053014504,22,31
5901,relax_and_recompute,0.7000000000000001,0,0,0,0.0,0.0920737174530402,68,68
5902,relax_and_recompute,0.7000000000000001,0,0,0,0.0,0.0843359484722631,23,22
5903,relax_and_recompute,0.7000000000000001,0,0,0,0.0,-0.1892042745303358,43,42
5904,relax_and_recompute,0.7000000000000001,1,1,0,-6.962740314771679,-0.0053234055414257,18,17
5905,relax_and_recompute,0.7000000000000001,9,1,8,-13.553349513873158,-0.1648279636460718,28,42
5906,relax_and_recompute,0.7000000000000001,59,43,16,0.981318704167407,0.0725970658966268,21,44
5907,relax_and_recompute,0.7000000000000001,7,0,7,56.88900800759565,-0.0741147552091947,36,37
5908,relax_and_recompute,0.7000000000000001,0,0,0,0.0,-0.1160124913373347,15,14
5909,relax_and_recompute,0.7000000000000001,1,4,-3,-5.0768104972308095,-0.066788531148955,14,16
5910,relax_and_recompute,0.7000000000000001,305,175,130,-1.5020861995727444,0.1300667053184291,61,119
5911,relax_and_recompute,0.7000000000000001,0,0,0,0.0,-0.0679133779217333,19,20
5912,relax_and_recompute,0.7000000000000001,1,0,1,81.71138080514127,0.4908804850819076,22,22
5913,relax_and_recompute,0.7000000000000001,2,0,2,72.94074740283565,-0.075791911818918,54,58
5914,relax_and_recompute,0.7000000000000001,436,498,-62,0.0386701096931503,-0.0062409156598046,65,135
5915,relax_and_recompute,0.7000000000000001,1,3,-2,20.75709724569183,0.003851252722653,16,18
5916,relax_and_recompute,0.7000000000000001,7,6,1,-5.497188229755757,0.0240142382057856,17,27
5917,relax_and_recompute,0.7000000000000001,21,8,13,-8.647651251139436,0.0296944501011926,54,71
5918,relax_and_recompute,0.7000000000000001,0,0,0,0.0,0.2766913222975756,23,22
5919,relax_and_recompute,0.7000000000000001,0,0,0,0.0,-0.2333534469509312,13,16
5920,relax_and_recompute,0.7000000000000001,258,137,121,1.6113114460561846,0.0068558569043253,85,131
5921,relax_and_recompute,0.7000000000000001,50,36,14,-1.8107517332950849,-0.0961070870536889,28,55
5922,relax_and_recompute,0.7000000000000001,3,3,0,23.735475182810752,0.2469133034858734,18,24
5923,relax_and_recompute,0.7000000000000001,4,2,2,-33.90763871301465,-0.0501345824356406,19,22
5924,relax_and_recompute,0.7000000000000001,5,4,1,-3.2819529348152514,-0.0782126309719672,47,46
5925,relax_and_recompute,0.7000000000000001,53,43,10,-1.817396229095678,-0.0593334313554168,39,64
5926,relax_and_recompute,0.7000000000000001,2,0,2,60.637312759422045,0.0290091979524392,17,18
5927,relax_and_recompute,0.7000000000000001,3,3,0,-6.586755996998207,0.0139332106399588,23,24
5928,relax_and_recompute,0.7000000000000001,2,2,0,9.011907063726028,0.240527094832689,13,16
5929,relax_and_recompute,0.7000000000000001,17,23,-6,17.556735651703598,0.0151118251206765,40,56
5930,relax_and_recompute,0.7000000000000001,1,1,0,7.947157954693168,0.2802517254851845,10,15
5931,relax_and_recompute,0.7000000000000001,0,0,0,0.0,0.0608994452807198,21,20
5932,relax_and_recompute,0.7000000000000001,7,2,5,7.835648623642712,-0.0294278872237127,30,35
5933,relax_and_recompute,0.7000000000000001,0,2,-2,-37.58616511760391,0.4295949974101768,71,77
5934,relax_one,0.7000000000000001,1,0,1,88.55317971852809,0.020844410075117,17,18
5935,relax_one,0.7000000000000001,6,1,5,45.04074194397077,0.0256388107040564,43,48
5936,relax_one,0.7000000000000001,9,13,-4,-6.025295143949961,0.4312921395771227,38,45
5937,relax_one,0.7000000000000001,1,2,-1,10.233375945698173,0.1044624840216656,12,12
5938,relax_one,0.7000000000000001,17,16,1,0.5626684348513322,-0.1937582268303441,23,38
5939,relax_one,0.7000000000000001,1,1,0,2.155941346655567,-0.1397978064731856,19,22
5940,relax_one,0.7000000000000001,996,788,208,0.1035628018603844,0.0687809616499576,35,143
5941,relax_one,0.7000000000000001,3,2,1,-20.978621104829664,0.1770120272682872,92,91
5942,relax_one,0.7000000000000001,2,2,0,-2.061903493175329,-0.2875029870584596,43,51
5943,relax_one,0.7000000000000001,4,1,3,-8.387245221686143,0.1931855809432497,35,36
5944,relax_one,0.7000000000000001,0,0,0,0.0,-0.4660383084286559,11,13
5945,relax_one,0.7000000000000001,35,20,15,-4.7465232947727145,-0.1749886406549913,10,25
5946,relax_one,0.7000000000000001,30,14,16,-3.939012003867745,0.3827383906293705,86,136
5947,relax_one,0.7000000000000001,0,0,0,0.0,-0.112265631369927,10,12
5948,relax_one,0.7000000000000001,0,0,0,0.0,-0.1182132311804894,32,31
5949,relax_one,0.7000000000000001,1,3,-2,5.017170088585871,-0.2915578067667762,20,26
5950,relax_one,0.7000000000000001,0,1,-1,-78.34766631278826,0.2201719014720498,11,11
5951,relax_one,0.7000000000000001,5,1,4,23.29252798605905,0.0792683500737937,34,42
5952,relax_one,0.7000000000000001,15,17,-2,9.61329874205348,0.2052486482154502,14,25
5953,relax_one,0.7000000000000001,8,7,1,0.2161306916662653,-0.0106196297962368,31,46
5954,relax_one,0.7000000000000001,4,0,4,57.38195905410886,0.1537905421478863,42,45
5955,relax_one,0.7000000000000001,1096,1090,6,0.4438674348410245,0.0281730851113088,39,173
5956,relax_one,0.7000000000000001,13,10,3,-2.677199643528425,0.0250370258985124,14,24
5957,relax_one,0.7000000000000001,1,0,1,54.33958725740638,0.1807297069088143,24,25
5958,relax_one,0.7000000000000001,2,1,1,10.141536206113116,0.0906004182936985,12,19
5959,relax_one,0.7000000000000001,70,69,1,-0.2357750028506657,0.2475745730556624,41,72
5960,relax_one,0.7000000000000001,259,224,35,-0.5616076787381559,-0.0430940388217155,59,115
5961,relax_one,0.7000000000000001,9,5,4,-2.220176375937648,-0.1390205571921924,32,37
5962,relax_one,0.7000000000000001,0,0,0,0.0,-0.1473333988810889,20,20
5963,relax_one,0.7000000000000001,27,31,-4,-1.005086761119074,-0.0649978702399424,12,31
5964,relax_one,0.7000000000000001,1,0,1,86.98573944286105,0.0066869095423837,10,10
5965,relax_one,0.7000000000000001,0,0,0,0.0,0.0114377407279667,20,21
5966,relax_one,0.7000000000000001,21,20,1,1.056087372813593,0.0478952983762104,39,52
5967,relax_one,0.7000000000000001,384,351,33,0.4816537263430049,0.3067313700941448,42,109
5968,relax_one,0.7000000000000001,0,1,-1,-70.53707173459516,-0.1440320991320735,25,28
5969,relax_one,0.7000000000000001,223,184,39,-1.124424166973114,-0.0790506696139997,56,106
5970,relax_one,0.7000000000000001,409,395,14,-0.6169801474587331,0.3898157211042967,87,189
5971,relax_one,0.7000000000000001,60,54,6,3.335914482724924,0.1042065883051353,56,82
5972,relax_one,0.7000000000000001,0,2,-2,-71.36285985978103,-0.3345527939078263,13,15
5973,relax_one,0.7000000000000001,118,68,50,-0.2329041528019289,-0.2451731963661093,36,63
5974,relax_one,0.7000000000000001,2,0,2,80.37760109440468,0.1927859923873354,16,15
5975,relax_one,0.7000000000000001,0,0,0,0.0,0.437729094390263,67,66
5976,relax_one,0.7000000000000001,20,28,-8,0.0712074923855539,0.1403697986842945,42,60
5977,relax_one,0.7000000000000001,0,0,0,0.0,-0.1037026298212001,39,38
5978,relax_one,0.7000000000000001,16,14,2,0.925070328998956,-0.2745037424566973,20,36
5979,relax_one,0.7000000000000001,0,0,0,0.0,-0.1210648016556567,10,9
5980,relax_one,0.7000000000000001,2,0,2,77.23886004840246,-0.4014482810242294,13,15
5981,relax_one,0.7000000000000001,11,16,-5,15.415550882858804,0.0775257146404904,34,41
5982,relax_one,0.7000000000000001,1,6,-5,-5.3389137182575865,-0.1289525059763308,37,42
5983,relax_one,0.7000000000000001,22,21,1,-7.026380014287341,0.2942099669028926,18,29
5984,relax_one,0.7000000000000001,0,0,0,0.0,0.1088447852996277,23,22
5985,relax_one,0.7000000000000001,0,0,0,0.0,0.1990998783175639,13,12
5986,relax_one,0.7000000000000001,0,0,0,0.0,-0.3271086571270687,15,14
5987,relax_one,0.7000000000000001,0,0,0,0.0,0.3664749774803198,69,68
5988,relax_one,0.7000000000000001,1,0,1,55.67309853346292,-0.4288511820471063,40,39
5989,relax_one,0.7000000000000001,2,2,0,11.782745287884929,-0.1091444059117466,89,93
5990,relax_one,0.7000000000000001,11,13,-2,-22.95450440049932,-0.1539817538311175,20,32
5991,relax_one,0.7000000000000001,1,3,-2,-22.135113597736364,0.2096308908117148,69,83
5992,relax_one,0.7000000000000001,1,0,1,58.41910436550084,0.017443457863657,12,15
5993,relax_one,0.7000000000000001,0,2,-2,-49.41385544643265,0.1715861951933348,15,14
5994,relax_one,0.7000000000000001,14,4,10,4.79265713102501,0.286370475895347,23,26
5995,relax_one,0.7000000000000001,3,3,0,16.170400841796024,-0.1754162452373242,12,20
5996,relax_one,0.7000000000000001,225,183,42,-0.6055401298447904,0.3177122920798647,64,122
5997,relax_one,0.7000000000000001,5,4,1,6.576387290374825,-0.2063121605856268,58,71
5998,relax_one,0.7000000000000001,0,0,0,0.0,0.3130827772322393,20,19
5999,relax_one,0.7000000000000001,325,300,25,-3.1467960400595345,-0.0755299013862347,100,191
6000,relax_one,0.7000000000000001,52,41,11,-3.202018138670475,0.2046413327935992,41,61
6001,relax_one,0.7000000000000001,31,16,15,-2.1181824696681986,0.0024316628546331,13,31
6002,relax_one,0.7000000000000001,2,3,-1,-0.1705490828925349,-0.3509011737066834,10,15
6003,relax_one,0.7000000000000001,18,8,10,-5.349417271768139,-0.2268546403550631,37,47
6004,relax_one,0.7000000000000001,0,2,-2,-71.62580578389242,-0.3803257677005904,21,21
6005,relax_one,0.7000000000000001,0,1,-1,-88.48975292694807,-0.3401548754582876,11,10
6006,relax_one,0.7000000000000001,52,38,14,-1.8606116887814463,0.1052428882388665,44,80
6007,relax_one,0.7000000000000001,5,3,2,1.7602123273162107,-0.0984125027875777,12,21
6008,relax_one,0.7000000000000001,8,3,5,-1.3452129268060062,-0.3919997130363883,37,43
6009,relax_one,0.7000000000000001,19,17,2,-13.169744891485152,-0.2916804607728896,41,52
6010,relax_one,0.7000000000000001,5,0,5,58.523406123553286,-0.0530330320020343,90,89
6011,relax_one,0.7000000000000001,1,1,0,12.77442347286673,0.2091329448556957,22,21
6012,relax_one,0.7000000000000001,0,2,-2,-73.2978638454182,0.1896360775372852,37,43
6013,relax_one,0.7000000000000001,10,0,10,67.31215910560952,-0.2232160736384791,47,47
6014,relax_one,0.7000000000000001,4,4,0,1.9191546675515383,0.0109226790530394,12,20
6015,relax_one,0.7000000000000001,149,153,-4,-0.8320087453543294,-0.0188375857268791,84,124
6016,relax_one,0.7000000000000001,2,1,1,-37.76776001231867,-0.0168336883633588,88,92
6017,relax_one,0.7000000000000001,265,348,-83,1.61739540798105,-0.0308275964585321,59,122
6018,relax_one,0.7000000000000001,6,6,0,-10.40620336018062,-0.2111457805426805,26,31
6019,relax_one,0.7000000000000001,0,0,0,0.0,0.3273904869363302,28,27
6020,relax_one,0.7000000000000001,4,11,-7,-0.8269635120492254,-0.2449061285309185,18,26
6021,relax_one,0.7000000000000001,5,1,4,0.8932771800162982,-0.0440415690059587,23,26
6022,relax_one,0.7000000000000001,1,5,-4,14.54647062365146,0.3938591124935117,43,43
6023,relax_one,0.7000000000000001,0,5,-5,-63.63384211132832,0.049885394451862,22,26
6024,relax_one,0.7000000000000001,0,0,0,0.0,0.2768479153563109,15,14
6025,relax_one,0.7000000000000001,26,8,18,-0.9536772848013156,-0.0323010913819439,36,48
6026,relax_one,0.7000000000000001,11,12,-1,7.50560146694081,-0.0166952999747941,30,37
6027,relax_one,0.7000000000000001,5,2,3,10.797063218427304,-0.5235726554035711,10,13
6028,relax_one,0.7000000000000001,0,0,0,0.0,0.3074790436423741,12,11
6029,relax_one,0.7000000000000001,184,173,11,1.8617968571632413,0.1469624415756261,55,105
6030,relax_one,0.7000000000000001,0,1,-1,-65.2005284416378,-0.2206147555088239,13,17
6031,relax_one,0.7000000000000001,1,2,-1,1.264051986856984,0.0658421492237302,30,29
6032,relax_one,0.7000000000000001,4,1,3,-6.998258982375006,0.2781963177384587,36,43
6033,relax_one,0.7000000000000001,17,15,2,-7.371093895840957,0.2809849641159017,40,60
6034,relax_one,0.7000000000000001,0,0,0,0.0,-0.0025637367600157,13,17
6035,relax_one,0.7000000000000001,9,8,1,2.97999001766901,0.3140531466121523,23,30
6036,relax_one,0.7000000000000001,0,1,-1,-36.97304809856371,0.0616365934519091,12,16
6037,relax_one,0.7000000000000001,0,1,-1,-88.61362439987384,0.1247777753310829,26,26
6038,relax_one,0.7000000000000001,2,0,2,86.90161748959672,0.2987733816333547,22,31
6039,relax_one,0.7000000000000001,0,1,-1,-68.47815853068319,0.0455075074965528,68,68
6040,relax_one,0.7000000000000001,0,0,0,0.0,0.0319876791012706,23,22
6041,relax_one,0.7000000000000001,0,0,0,0.0,-0.0181146434420471,43,42
6042,relax_one,0.7000000000000001,0,2,-2,-82.90034290826884,-0.3429603603166761,18,17
6043,relax_one,0.7000000000000001,14,3,11,-6.947718853887778,0.1623039200181996,28,42
6044,relax_one,0.7000000000000001,46,42,4,0.1692894505910516,-0.1838059164739067,21,44
6045,relax_one,0.7000000000000001,8,0,8,63.8072383214707,-0.2364217718389195,36,37
6046,relax_one,0.7000000000000001,0,0,0,0.0,-0.0288279643295402,15,14
6047,relax_one,0.7000000000000001,0,0,0,0.0,0.3781838432359125,14,16
6048,relax_one,0.7000000000000001,276,208,68,-2.674143552869481,0.065977500683353,61,119
6049,relax_one,0.7000000000000001,0,0,0,0.0,-0.0834607096485884,19,20
6050,relax_one,0.7000000000000001,0,0,0,0.0,0.2390308928010132,22,22
6051,relax_one,0.7000000000000001,2,1,1,0.4755107745956337,0.0503545881694252,54,58
6052,relax_one,0.7000000000000001,527,461,66,-1.633685472711775,-0.0342779406667446,65,135
6053,relax_one,0.7000000000000001,4,0,4,75.83755420465862,0.0945633482665584,16,18
6054,relax_one,0.7000000000000001,11,7,4,0.6295852671828968,0.0496617052744715,17,27
6055,relax_one,0.7000000000000001,6,13,-7,-13.38328937270176,0.1025050511261655,54,71
6056,relax_one,0.7000000000000001,1,0,1,79.53558104459673,0.0973555351803681,23,22
6057,relax_one,0.7000000000000001,4,0,4,73.48915554108436,0.223349877533651,13,16
6058,relax_one,0.7000000000000001,156,118,38,1.2996204100100286,0.2498397821790328,85,131
6059,relax_one,0.7000000000000001,46,62,-16,0.2569258369497191,-0.1883106887123742,28,55
6060,relax_one,0.7000000000000001,1,2,-1,-21.131130764980508,0.2348226258191566,18,24
6061,relax_one,0.7000000000000001,3,3,0,3.340101767746276,-0.1341233905367246,19,22
6062,relax_one,0.7000000000000001,4,0,4,73.44408160334541,0.0520336112177914,47,46
6063,relax_one,0.7000000000000001,38,18,20,-8.262077993185457,0.2394281118225648,39,64
6064,relax_one,0.7000000000000001,1,1,0,-2.2747000048222645,0.0702400835243546,17,18
6065,relax_one,0.7000000000000001,2,1,1,9.482262586774723,0.0801015214474371,23,24
6066,relax_one,0.7000000000000001,1,1,0,-5.4291325819869485,-0.1105278763437086,13,16
6067,relax_one,0.7000000000000001,22,13,9,0.849619910813999,-0.1676740588153603,40,56
6068,relax_one,0.7000000000000001,1,1,0,13.076589337372964,0.0045145072061465,10,15
6069,relax_one,0.7000000000000001,2,0,2,78.73385091920797,0.008243355881968,21,20
6070,relax_one,0.7000000000000001,12,1,11,14.169766203475,-0.079952805855791,30,35
6071,relax_one,0.7000000000000001,1,8,-7,-13.589939657241942,-0.1568654115740159,71,77
6072,just_relax,0.7000000000000001,0,1,-1,-76.42903865344901,-0.4323328279080798,17,18
6073,just_relax,0.7000000000000001,12,6,6,6.740762648347868,-0.1982398396469954,43,48
6074,just_relax,0.7000000000000001,14,3,11,9.510269628238987,-0.0918704775766882,38,45
6075,just_relax,0.7000000000000001,0,0,0,0.0,-0.2020296317115455,12,12
6076,just_relax,0.7000000000000001,7,14,-7,8.145962951979818,-0.1227305633380944,23,38
6077,just_relax,0.7000000000000001,1,1,0,-16.745710313722583,0.2107329010827097,19,22
6078,just_relax,0.7000000000000001,784,976,-192,0.4700440600528139,-0.1938123495021053,35,143
6079,just_relax,0.7000000000000001,4,2,2,7.228872902117928,-0.1189214215320709,92,91
6080,just_relax,0.7000000000000001,2,19,-17,3.035028592465423,0.0024740681816346,43,51
6081,just_relax,0.7000000000000001,0,2,-2,-76.87384921514351,-0.367221282012022,35,36
6082,just_relax,0.7000000000000001,0,0,0,0.0,0.6209881295698143,11,13
6083,just_relax,0.7000000000000001,23,12,11,8.947325721212145,-0.1253906481794062,10,25
6084,just_relax,0.7000000000000001,14,40,-26,15.696383774041252,-0.0331305696239897,86,136
6085,just_relax,0.7000000000000001,0,0,0,0.0,-0.2229444623555734,10,12
6086,just_relax,0.7000000000000001,0,0,0,0.0,-0.0212520003894497,32,31
6087,just_relax,0.7000000000000001,2,7,-5,9.452993494912668,0.0525389060229882,20,26
6088,just_relax,0.7000000000000001,0,0,0,0.0,-0.1871893336321564,11,11
6089,just_relax,0.7000000000000001,2,15,-13,-25.66701736173944,-0.2711777052626621,34,42
6090,just_relax,0.7000000000000001,10,15,-5,19.03302626727956,0.0221710361549054,14,25
6091,just_relax,0.7000000000000001,8,8,0,3.193190809170148,-0.0872163016126973,31,46
6092,just_relax,0.7000000000000001,0,14,-14,-61.183006353111175,-0.1321250894948815,42,45
6093,just_relax,0.7000000000000001,1029,1076,-47,1.313869826918534,0.0210825458782419,39,173
6094,just_relax,0.7000000000000001,7,21,-14,7.427991073070558,0.1845871910309062,14,24
6095,just_relax,0.7000000000000001,0,1,-1,-85.83784590449778,0.1936417976567511,24,25
6096,just_relax,0.7000000000000001,3,2,1,-4.722130543159679,-0.040056952272146,12,19
6097,just_relax,0.7000000000000001,81,79,2,-1.6473312351129223,0.1185655074530956,41,72
6098,just_relax,0.7000000000000001,233,225,8,0.4570852231844426,-0.2956630724637226,59,115
6099,just_relax,0.7000000000000001,9,12,-3,10.273104465512276,-0.3407929085605821,32,37
6100,just_relax,0.7000000000000001,2,2,0,51.4591081734788,-0.169153495073794,20,20
6101,just_relax,0.7000000000000001,23,26,-3,3.7854143195258416,-0.2343069539601121,12,31
6102,just_relax,0.7000000000000001,2,0,2,68.79339580179192,-0.2002760319815814,10,10
6103,just_relax,0.7000000000000001,6,7,-1,-3.3485714630341192,-0.1929107212026064,20,21
6104,just_relax,0.7000000000000001,37,30,7,-1.036363906781162,0.0846528315851328,39,52
6105,just_relax,0.7000000000000001,360,317,43,4.053295728505503,-0.0620617233700946,42,109
6106,just_relax,0.7000000000000001,5,3,2,-16.61242712066246,0.1302976690452804,25,28
6107,just_relax,0.7000000000000001,192,266,-74,3.103382879913476,-0.1950883854116077,56,106
6108,just_relax,0.7000000000000001,440,651,-211,7.93380111570346,-0.2104162075731722,87,189
6109,just_relax,0.7000000000000001,42,46,-4,6.079505969132839,-0.3160802906537979,56,82
6110,just_relax,0.7000000000000001,2,1,1,-22.4097944815484,0.0339611528024701,13,15
6111,just_relax,0.7000000000000001,104,143,-39,5.38803070967456,-0.0789589110663485,36,63
6112,just_relax,0.7000000000000001,0,2,-2,-63.77248505735057,0.1722883058073471,16,15
6113,just_relax,0.7000000000000001,0,0,0,0.0,0.1750839934708203,67,66
6114,just_relax,0.7000000000000001,26,25,1,-1.2269426593785084,-0.4703866763828631,42,60
6115,just_relax,0.7000000000000001,10,0,10,64.32759872501626,0.1901012860818531,39,38
6116,just_relax,0.7000000000000001,9,9,0,9.22578545372474,0.2304657943831559,20,36
6117,just_relax,0.7000000000000001,0,0,0,0.0,-0.1629979745943924,10,9
6118,just_relax,0.7000000000000001,0,2,-2,-63.869578305819246,0.1512486146288932,13,15
6119,just_relax,0.7000000000000001,16,10,6,-0.4137019527221213,0.0948183727501084,34,41
6120,just_relax,0.7000000000000001,13,5,8,-3.290475012166567,0.1825768758351342,37,42
6121,just_relax,0.7000000000000001,20,20,0,1.7083314316451634,-0.1534999855026277,18,29
6122,just_relax,0.7000000000000001,0,0,0,0.0,0.0034843695276587,23,22
6123,just_relax,0.7000000000000001,0,0,0,0.0,-0.0044063681123369,13,12
6124,just_relax,0.7000000000000001,0,0,0,0.0,0.0381429254532518,15,14
6125,just_relax,0.7000000000000001,0,0,0,0.0,0.0241344210011801,69,68
6126,just_relax,0.7000000000000001,0,0,0,0.0,0.2247698257845957,40,39
6127,just_relax,0.7000000000000001,3,0,3,42.70586175255004,-0.1143405958746924,89,93
6128,just_relax,0.7000000000000001,8,13,-5,-7.244145768777543,-0.0388999152861631,20,32
6129,just_relax,0.7000000000000001,1,1,0,-12.137021079337416,-0.0619846661312254,69,83
6130,just_relax,0.7000000000000001,2,0,2,81.64731595484238,-0.2496969449816855,12,15
6131,just_relax,0.7000000000000001,0,0,0,0.0,-0.4623631036772037,15,14
6132,just_relax,0.7000000000000001,0,2,-2,-63.91085752002338,-0.2087363379398974,23,26
6133,just_relax,0.7000000000000001,8,2,6,-23.094478388791096,0.0598304303006724,12,20
6134,just_relax,0.7000000000000001,343,219,124,0.0246042654618747,0.2539296344520347,64,122
6135,just_relax,0.7000000000000001,4,17,-13,1.9822913726676887,-0.0355511180762857,58,71
6136,just_relax,0.7000000000000001,0,0,0,0.0,0.0430092545373205,20,19
6137,just_relax,0.7000000000000001,324,379,-55,3.5155467450487805,-0.0813860616468657,100,191
6138,just_relax,0.7000000000000001,45,67,-22,4.836608938529494,0.0953351485493344,41,61
6139,just_relax,0.7000000000000001,20,37,-17,6.060082759776606,-0.1351838664901123,13,31
6140,just_relax,0.7000000000000001,3,3,0,15.221661349702671,-0.0438443764843056,10,15
6141,just_relax,0.7000000000000001,26,7,19,2.843797617115129,-0.0869756168626447,37,47
6142,just_relax,0.7000000000000001,2,0,2,61.17752601963164,-0.0208965492805215,21,21
6143,just_relax,0.7000000000000001,0,0,0,0.0,-0.3463536464996569,11,10
6144,just_relax,0.7000000000000001,58,36,22,-1.945118085760157,-0.033560429475725,44,80
6145,just_relax,0.7000000000000001,3,3,0,2.953951948078398,0.035355438287473,12,21
6146,just_relax,0.7000000000000001,4,0,4,66.76903585953019,-0.0213501545898355,37,43
6147,just_relax,0.7000000000000001,11,9,2,14.940691310999604,0.029026797273281,41,52
6148,just_relax,0.7000000000000001,0,10,-10,-46.18647240708127,-0.0377735612874006,90,89
6149,just_relax,0.7000000000000001,0,12,-12,-50.77913407306408,-0.1721783747773457,22,21
6150,just_relax,0.7000000000000001,2,6,-4,3.276777026016056,-0.0346393161335819,37,43
6151,just_relax,0.7000000000000001,7,15,-8,22.980814965280743,-0.3421559657051946,47,47
6152,just_relax,0.7000000000000001,8,4,4,-4.1351751170516735,0.1405341751036577,12,20
6153,just_relax,0.7000000000000001,167,129,38,0.6148500324279595,0.0265812019279491,84,124
6154,just_relax,0.7000000000000001,0,4,-4,-73.8590789206081,-0.2419518384226828,88,92
6155,just_relax,0.7000000000000001,283,408,-125,5.366373445143985,-0.027849194632344,59,122
6156,just_relax,0.7000000000000001,4,5,-1,-3.5452606626090457,0.0930070094306781,26,31
6157,just_relax,0.7000000000000001,0,0,0,0.0,0.030988179282763,28,27
6158,just_relax,0.7000000000000001,3,2,1,3.443975119847664,0.1163056812245588,18,26
6159,just_relax,0.7000000000000001,1,2,-1,6.389585493584434,-0.4394439489698524,23,26
6160,just_relax,0.7000000000000001,2,4,-2,4.488852184878795,0.3491474632302155,43,43
6161,just_relax,0.7000000000000001,2,6,-4,25.25010903479337,0.1541857848571268,22,26
6162,just_relax,0.7000000000000001,1,0,1,52.23821578486836,0.2929069472787229,15,14
6163,just_relax,0.7000000000000001,19,18,1,11.062884701758236,-0.0378305837468355,36,48
6164,just_relax,0.7000000000000001,3,7,-4,2.1738753231927888,-0.0482634708016709,30,37
6165,just_relax,0.7000000000000001,2,2,0,-3.6007439415378,0.2353721652854332,10,13
6166,just_relax,0.7000000000000001,0,0,0,0.0,-0.6147317470845233,12,11
6167,just_relax,0.7000000000000001,242,169,73,0.3388210820552686,0.0637886767359434,55,105
6168,just_relax,0.7000000000000001,0,1,-1,-86.10894967835631,0.2118222018576738,13,17
6169,just_relax,0.7000000000000001,2,1,1,-11.0066920591656,-0.0552184496449389,30,29
6170,just_relax,0.7000000000000001,6,3,3,5.755556285229353,-0.2089445783616426,36,43
6171,just_relax,0.7000000000000001,27,30,-3,4.935773641623797,0.0987191131966893,40,60
6172,just_relax,0.7000000000000001,2,1,1,20.772383169183968,0.1050370685516995,13,17
6173,just_relax,0.7000000000000001,7,8,-1,7.730245912108494,-0.1886474058767095,23,30
6174,just_relax,0.7000000000000001,1,4,-3,-19.07978076764297,-0.0990323290225223,12,16
6175,just_relax,0.7000000000000001,4,1,3,-35.97214378479956,0.1177153469227834,26,26
6176,just_relax,0.7000000000000001,2,1,1,10.43458607746352,0.2928331717513019,22,31
6177,just_relax,0.7000000000000001,0,4,-4,-44.06100392981337,0.0472872233535285,68,68
6178,just_relax,0.7000000000000001,0,0,0,0.0,-0.023435922256156,23,22
6179,just_relax,0.7000000000000001,0,1,-1,-70.33682987061846,-0.0850926171780876,43,42
6180,just_relax,0.7000000000000001,0,0,0,0.0,0.4841310448885781,18,17
6181,just_relax,0.7000000000000001,10,9,1,3.832756394240505,0.0454939872378786,28,42
6182,just_relax,0.7000000000000001,70,53,17,2.365355899328634,-0.0553244189601028,21,44
6183,just_relax,0.7000000000000001,0,2,-2,-77.18807696985652,0.1514932263010292,36,37
6184,just_relax,0.7000000000000001,0,0,0,0.0,-0.1539019942319011,15,14
6185,just_relax,0.7000000000000001,3,4,-1,9.38451057593501,-0.4458600147141037,14,16
6186,just_relax,0.7000000000000001,216,310,-94,-2.7290824541085144,-0.0230897468133314,61,119
6187,just_relax,0.7000000000000001,1,1,0,4.682976761684941,0.2741102393114462,19,20
6188,just_relax,0.7000000000000001,0,2,-2,-50.88743757841036,-0.0296068227702517,22,22
6189,just_relax,0.7000000000000001,1,9,-8,23.72641180750453,0.2279505236383843,54,58
6190,just_relax,0.7000000000000001,478,994,-516,4.815754118376262,-0.064031117966495,65,135
6191,just_relax,0.7000000000000001,4,0,4,75.84667846575718,-0.2278704501501391,16,18
6192,just_relax,0.7000000000000001,8,6,2,9.30523132619765,0.1182269647309421,17,27
6193,just_relax,0.7000000000000001,17,27,-10,8.227624508193166,0.0685807877262929,54,71
6194,just_relax,0.7000000000000001,0,2,-2,-63.62357906493096,-0.1890715554321209,23,22
6195,just_relax,0.7000000000000001,2,1,1,-31.000082766591376,0.0297207419374136,13,16
6196,just_relax,0.7000000000000001,117,266,-149,1.5490236170161822,-0.0813346812457009,85,131
6197,just_relax,0.7000000000000001,25,34,-9,9.647137491808152,-0.1473922614226961,28,55
6198,just_relax,0.7000000000000001,0,2,-2,-65.21494738663246,-0.2374984442430612,18,24
6199,just_relax,0.7000000000000001,1,1,0,30.278814520664824,-0.0840944329512896,19,22
6200,just_relax,0.7000000000000001,5,5,0,1.5164298166461805,-0.0957719210266205,47,46
6201,just_relax,0.7000000000000001,28,67,-39,7.1686457953217015,-0.189094221224358,39,64
6202,just_relax,0.7000000000000001,1,1,0,2.6146670602072604,-0.2092368889529524,17,18
6203,just_relax,0.7000000000000001,1,1,0,0.8189528417514396,0.0225403639725395,23,24
6204,just_relax,0.7000000000000001,1,2,-1,6.864377605720705,0.3801800689119039,13,16
6205,just_relax,0.7000000000000001,33,40,-7,1.5001355342839275,-0.2595232328753312,40,56
6206,just_relax,0.7000000000000001,1,1,0,18.56366664672309,0.2521192910040349,10,15
6207,just_relax,0.7000000000000001,0,1,-1,-35.73056452568524,-0.4481257062900202,21,20
6208,just_relax,0.7000000000000001,3,3,0,-22.798366485782644,-0.355382555854948,30,35
6209,just_relax,0.7000000000000001,2,4,-2,5.108522192211339,0.1201872154727821,71,77
6210,relax_and_recompute,0.75,0,0,0,0.0,0.2442558895066808,17,18
6211,relax_and_recompute,0.75,3,12,-9,-1.804088764268286,0.211707592007001,43,48
6212,relax_and_recompute,0.75,3,2,1,17.502768156105475,-0.063880377105016,38,45
6213,relax_and_recompute,0.75,0,0,0,0.0,-0.3466971719855717,12,12
6214,relax_and_recompute,0.75,13,4,9,-13.447102340097594,0.0939663941737835,23,38
6215,relax_and_recompute,0.75,1,1,0,-7.141292271777246,-0.0879233999541676,19,22
6216,relax_and_recompute,0.75,865,812,53,0.1998160333011824,-0.0714725941536241,35,143
6217,relax_and_recompute,0.75,3,0,3,50.915753846695,0.0399813005251989,92,91
6218,relax_and_recompute,0.75,2,9,-7,-13.132391437137258,0.0031197499946741,43,51
6219,relax_and_recompute,0.75,1,0,1,68.96409830526328,0.2953135490804517,35,36
6220,relax_and_recompute,0.75,0,0,0,0.0,-0.3629368681087109,11,13
6221,relax_and_recompute,0.75,16,20,-4,-0.0334226868086915,-0.0272138173704904,10,25
6222,relax_and_recompute,0.75,26,13,13,-12.373382963316054,0.0565870570909243,86,136
6223,relax_and_recompute,0.75,0,0,0,0.0,-0.2971801679247467,10,12
6224,relax_and_recompute,0.75,0,0,0,0.0,0.0524078794511398,32,31
6225,relax_and_recompute,0.75,7,2,5,-24.0676021472185,0.0568950683216036,20,26
6226,relax_and_recompute,0.75,1,0,1,73.66528905481532,-0.2726610324403901,11,11
6227,relax_and_recompute,0.75,4,3,1,-18.863352208855574,0.1125259601506266,34,42
6228,relax_and_recompute,0.75,17,11,6,0.7740338611953348,-0.5557386895586554,14,25
6229,relax_and_recompute,0.75,5,11,-6,-0.1130942772975771,-0.0673236284086807,31,46
6230,relax_and_recompute,0.75,3,4,-1,15.989958560352903,0.2489363797876038,42,45
6231,relax_and_recompute,0.75,1169,1111,58,-1.0139503080002117,-0.1254528292664852,39,173
6232,relax_and_recompute,0.75,8,12,-4,4.175023222907214,0.4666981007269556,14,24
6233,relax_and_recompute,0.75,0,0,0,0.0,0.1640437039026382,24,25
6234,relax_and_recompute,0.75,1,1,0,8.077635523563472,0.3114820847514064,12,19
6235,relax_and_recompute,0.75,88,97,-9,-1.178453507137469,-0.0893640065556741,41,72
6236,relax_and_recompute,0.75,246,210,36,-0.6049552228176509,0.0567540561641958,59,115
6237,relax_and_recompute,0.75,18,3,15,8.464523088460204,-0.0296028038811773,32,37
6238,relax_and_recompute,0.75,1,0,1,68.76530599798073,0.0824000458898279,20,20
6239,relax_and_recompute,0.75,20,24,-4,-6.801749869276179,0.0392884408902445,12,31
6240,relax_and_recompute,0.75,0,0,0,0.0,-0.0990511322259127,10,10
6241,relax_and_recompute,0.75,0,0,0,0.0,0.1145902436818494,20,21
6242,relax_and_recompute,0.75,35,27,8,-0.0775681987541503,-0.0504377720606078,39,52
6243,relax_and_recompute,0.75,365,327,38,-0.469134866676228,0.0176321398619971,42,109
6244,relax_and_recompute,0.75,2,1,1,-0.9792410681456404,0.0164593338338554,25,28
6245,relax_and_recompute,0.75,190,203,-13,-2.1749065871737017,0.059581377996022,56,106
6246,relax_and_recompute,0.75,488,415,73,-3.670042612132242,-0.1924999827679249,87,189
6247,relax_and_recompute,0.75,63,51,12,4.596932654442355,-0.2495354419178979,56,82
6248,relax_and_recompute,0.75,1,1,0,12.26002699277268,0.1336815662598514,13,15
6249,relax_and_recompute,0.75,80,89,-9,2.8377126719461145,0.057491366680842,36,63
6250,relax_and_recompute,0.75,0,0,0,0.0,-0.1142145583205141,16,15
6251,relax_and_recompute,0.75,0,0,0,0.0,-0.0287392082429974,67,66
6252,relax_and_recompute,0.75,14,21,-7,-4.169506532586041,0.443982410823626,42,60
6253,relax_and_recompute,0.75,1,0,1,63.84730931280773,-0.4009258976738137,39,38
6254,relax_and_recompute,0.75,9,9,0,1.9613971856279304,0.1998263683138827,20,36
6255,relax_and_recompute,0.75,1,0,1,79.61380130220299,-0.1483200684653356,10,9
6256,relax_and_recompute,0.75,0,0,0,0.0,0.0073142718278526,13,15
6257,relax_and_recompute,0.75,10,4,6,-6.3411182265342205,-0.1903584559796755,34,41
6258,relax_and_recompute,0.75,26,3,23,1.670199889578619,-0.1919676106225998,37,42
6259,relax_and_recompute,0.75,34,21,13,-1.4197487852621435,0.2479422785615053,18,29
6260,relax_and_recompute,0.75,3,0,3,71.27965271952728,-0.3972467852470639,23,22
6261,relax_and_recompute,0.75,0,0,0,0.0,0.1675489994927416,13,12
6262,relax_and_recompute,0.75,1,0,1,71.13161233458239,0.5990572788890002,15,14
6263,relax_and_recompute,0.75,0,0,0,0.0,0.066210563607846,69,68
6264,relax_and_recompute,0.75,0,0,0,0.0,-0.06754906949041,40,39
6265,relax_and_recompute,0.75,4,2,2,1.3534440036344506,-0.088173981159937,89,93
6266,relax_and_recompute,0.75,10,8,2,7.929132099718828,0.0974495024552695,20,32
6267,relax_and_recompute,0.75,4,2,2,19.489378062282213,0.0371665603748054,69,83
6268,relax_and_recompute,0.75,1,2,-1,-13.598542275242991,-0.1429758963690733,12,15
6269,relax_and_recompute,0.75,0,0,0,0.0,-0.1535872498108104,15,14
6270,relax_and_recompute,0.75,6,2,4,16.668066945835157,-0.0262896686703949,23,26
6271,relax_and_recompute,0.75,2,4,-2,3.2868356310776363,-0.124256156051682,12,20
6272,relax_and_recompute,0.75,197,217,-20,0.4857250756353579,0.0460015542573546,64,122
6273,relax_and_recompute,0.75,14,7,7,8.866760449272704,0.4069297609711103,58,71
6274,relax_and_recompute,0.75,0,0,0,0.0,0.0507690529638552,20,19
6275,relax_and_recompute,0.75,402,320,82,-1.478999246245067,-0.0363794001090589,100,191
6276,relax_and_recompute,0.75,100,27,73,-7.799605731984791,-0.0024567307331537,41,61
6277,relax_and_recompute,0.75,35,21,14,-6.823825620920715,-0.0282611713820497,13,31
6278,relax_and_recompute,0.75,3,7,-4,-11.34738254674044,0.2416278864442539,10,15
6279,relax_and_recompute,0.75,18,7,11,-7.301017014766586,0.092454023788009,37,47
6280,relax_and_recompute,0.75,2,0,2,45.496814441406805,0.0183216203856942,21,21
6281,relax_and_recompute,0.75,0,0,0,0.0,-0.4117813510466795,11,10
6282,relax_and_recompute,0.75,49,55,-6,-5.353447589713944,-0.1331930404296515,44,80
6283,relax_and_recompute,0.75,2,4,-2,4.190696946369059,0.3966553486414126,12,21
6284,relax_and_recompute,0.75,0,6,-6,-70.2774350170868,0.3363485484551999,37,43
6285,relax_and_recompute,0.75,13,19,-6,-1.7460188162283146,-0.1794819628280196,41,52
6286,relax_and_recompute,0.75,6,0,6,68.60873333819178,-0.3350457182979002,90,89
6287,relax_and_recompute,0.75,0,0,0,0.0,-0.1903682226222834,22,21
6288,relax_and_recompute,0.75,8,1,7,23.99019903446073,-0.1684335731456947,37,43
6289,relax_and_recompute,0.75,3,0,3,63.2683016731616,0.0867332747885269,47,47
6290,relax_and_recompute,0.75,15,4,11,-23.15413951993444,-0.1242915596758396,12,20
6291,relax_and_recompute,0.75,123,110,13,0.1299382187069682,0.3115868861848447,84,124
6292,relax_and_recompute,0.75,6,0,6,76.82086615534477,-0.1359377529440125,88,92
6293,relax_and_recompute,0.75,434,358,76,-0.5764899750277692,0.0612391924453582,59,122
6294,relax_and_recompute,0.75,4,4,0,-2.5813094744812446,0.0525157383964188,26,31
6295,relax_and_recompute,0.75,0,0,0,0.0,-0.4595649622066923,28,27
6296,relax_and_recompute,0.75,4,9,-5,-7.103359209477105,-0.0006965439425826,18,26
6297,relax_and_recompute,0.75,9,4,5,13.63030754447604,0.2213432966887164,23,26
6298,relax_and_recompute,0.75,2,3,-1,1.7085434529954426,0.1426374985717801,43,43
6299,relax_and_recompute,0.75,6,3,3,-9.78254405417536,-0.3600110096342706,22,26
6300,relax_and_recompute,0.75,0,0,0,0.0,0.2071971411976078,15,14
6301,relax_and_recompute,0.75,32,19,13,-2.162135501271422,-0.0272733214634181,36,48
6302,relax_and_recompute,0.75,5,4,1,-2.6039295436790297,0.0865462165611673,30,37
6303,relax_and_recompute,0.75,2,1,1,11.72696294555672,-0.0204690657160927,10,13
6304,relax_and_recompute,0.75,0,0,0,0.0,-0.1533419262845217,12,11
6305,relax_and_recompute,0.75,171,194,-23,2.30300177119802,-0.0321945183485938,55,105
6306,relax_and_recompute,0.75,0,3,-3,-70.36297418096738,0.0690402125845656,13,17
6307,relax_and_recompute,0.75,0,0,0,0.0,-0.1022844803264849,30,29
6308,relax_and_recompute,0.75,4,2,2,6.090844390877336,-0.073331729964746,36,43
6309,relax_and_recompute,0.75,32,16,16,-5.114143378631333,0.290564095193321,40,60
6310,relax_and_recompute,0.75,0,2,-2,-60.28143202844192,0.1180152933038447,13,17
6311,relax_and_recompute,0.75,14,6,8,-7.712039682088402,0.2432078212363333,23,30
6312,relax_and_recompute,0.75,0,3,-3,-68.06881608259654,-0.314499351552996,12,16
6313,relax_and_recompute,0.75,0,0,0,0.0,0.0502983498950385,26,26
6314,relax_and_recompute,0.75,0,1,-1,-50.639412601494186,0.0753384511051827,22,31
6315,relax_and_recompute,0.75,4,1,3,-6.991910359999991,-0.0493642048181117,68,68
6316,relax_and_recompute,0.75,0,0,0,0.0,0.0225200737215476,23,22
6317,relax_and_recompute,0.75,0,0,0,0.0,-0.0589706148477034,43,42
6318,relax_and_recompute,0.75,0,0,0,0.0,-0.0820172054396894,18,17
6319,relax_and_recompute,0.75,9,3,6,-7.876007773096617,0.4874665443877167,28,42
6320,relax_and_recompute,0.75,36,44,-8,3.8406242300028737,0.0082081247406108,21,44
6321,relax_and_recompute,0.75,3,0,3,65.11328481092345,0.047872621849541,36,37
6322,relax_and_recompute,0.75,0,0,0,0.0,-0.1708082770319571,15,14
6323,relax_and_recompute,0.75,0,0,0,0.0,0.314320233429961,14,16
6324,relax_and_recompute,0.75,231,237,-6,1.5885622274068891,-0.0916485550847583,61,119
6325,relax_and_recompute,0.75,2,1,1,-7.357470063540546,-0.0797823548192456,19,20
6326,relax_and_recompute,0.75,5,0,5,70.95427026765958,0.062278524301917,22,22
6327,relax_and_recompute,0.75,2,0,2,69.29185853877368,0.2556095678295326,54,58
6328,relax_and_recompute,0.75,498,411,87,-1.2710976400774072,0.0472913356261288,65,135
6329,relax_and_recompute,0.75,1,0,1,87.12054870835674,-0.117070727235656,16,18
6330,relax_and_recompute,0.75,7,8,-1,15.96589049722754,0.1008300912935745,17,27
6331,relax_and_recompute,0.75,11,12,-1,-6.306779000905685,-0.2892410292578655,54,71
6332,relax_and_recompute,0.75,1,0,1,76.8302584404818,-0.1519492045948961,23,22
6333,relax_and_recompute,0.75,2,2,0,-11.000368019228604,-0.1597767288904795,13,16
6334,relax_and_recompute,0.75,195,147,48,-3.121456121597191,-0.0012696493197144,85,131
6335,relax_and_recompute,0.75,49,38,11,-7.729288632753793,-0.1070653274459796,28,55
6336,relax_and_recompute,0.75,9,4,5,17.652702926986336,-0.1260398940840517,18,24
6337,relax_and_recompute,0.75,4,0,4,78.37109003363209,-0.0724087031773563,19,22
6338,relax_and_recompute,0.75,1,2,-1,17.282733144011388,0.1618545075596843,47,46
6339,relax_and_recompute,0.75,16,23,-7,2.2883931270520748,0.1700517397216721,39,64
6340,relax_and_recompute,0.75,0,1,-1,-78.83112527614054,0.0870889503333149,17,18
6341,relax_and_recompute,0.75,3,1,2,-7.271165565185839,-0.4139522558885428,23,24
6342,relax_and_recompute,0.75,1,1,0,-8.876677231132405,-0.0499459914823402,13,16
6343,relax_and_recompute,0.75,17,15,2,0.3059664305614546,0.2991450454289367,40,56
6344,relax_and_recompute,0.75,1,0,1,78.97626034117772,-0.177538500165462,10,15
6345,relax_and_recompute,0.75,0,0,0,0.0,0.4404461372889676,21,20
6346,relax_and_recompute,0.75,5,2,3,-0.5816536309979625,0.1870522715861976,30,35
6347,relax_and_recompute,0.75,0,3,-3,-62.485148876827736,-0.3428450775183684,71,77
6348,relax_one,0.75,0,0,0,0.0,0.0990459539931387,17,18
6349,relax_one,0.75,5,9,-4,5.986593753079262,0.0860294267515274,43,48
6350,relax_one,0.75,2,2,0,5.272602616931366,-0.0904975479355212,38,45
6351,relax_one,0.75,0,1,-1,-88.53938466835038,0.3240141854511316,12,12
6352,relax_one,0.75,11,25,-14,2.2539207295462376,-0.3919634698813277,23,38
6353,relax_one,0.75,1,2,-1,2.228379150845498,0.3153037574385988,19,22
6354,relax_one,0.75,873,1108,-235,1.128910220322588,0.2521586686652968,35,143
6355,relax_one,0.75,2,1,1,-12.891986042380225,0.1757311572197948,92,91
6356,relax_one,0.75,10,10,0,-3.965032970464179,-0.0434556644530554,43,51
6357,relax_one,0.75,1,2,-1,0.4028471211804287,-0.4246588654063642,35,36
6358,relax_one,0.75,0,1,-1,-80.73953572318331,0.0378716610608534,11,13
6359,relax_one,0.75,18,14,4,-0.5997520791167403,-0.1550018101086488,10,25
6360,relax_one,0.75,28,25,3,-6.764895598366913,-0.0798664198250644,86,136
6361,relax_one,0.75,0,0,0,0.0,-0.0894144420404711,10,12
6362,relax_one,0.75,0,0,0,0.0,0.0418250999818348,32,31
6363,relax_one,0.75,4,3,1,-3.073505530107965,0.0072595058054042,20,26
6364,relax_one,0.75,0,0,0,0.0,-0.1682774242747733,11,11
6365,relax_one,0.75,10,4,6,14.58584011900517,0.0894495711226761,34,42
6366,relax_one,0.75,15,13,2,-0.730745227782478,0.0182624893671214,14,25
6367,relax_one,0.75,23,13,10,-1.34714424961453,0.0819037462978852,31,46
6368,relax_one,0.75,0,3,-3,-74.56565741929249,0.2335832879899839,42,45
6369,relax_one,0.75,1036,1193,-157,-0.4850022118903681,0.1750872608001374,39,173
6370,relax_one,0.75,8,12,-4,7.539263789930374,-0.449970886741329,14,24
6371,relax_one,0.75,3,0,3,59.132992141594855,0.1208596155371627,24,25
6372,relax_one,0.75,1,2,-1,1.476110088966024,0.124461705968735,12,19
6373,relax_one,0.75,62,58,4,3.239307951769753,-0.195005225043184,41,72
6374,relax_one,0.75,240,166,74,-1.273046510052815,-0.0791887774864548,59,115
6375,relax_one,0.75,10,4,6,3.624435239415263,0.3076550123220667,32,37
6376,relax_one,0.75,0,1,-1,-70.13872339320682,0.2795560493261576,20,20
6377,relax_one,0.75,29,28,1,-1.6381258892585038,0.393483159461612,12,31
6378,relax_one,0.75,0,0,0,0.0,0.1530061629260402,10,10
6379,relax_one,0.75,0,2,-2,-62.70187656466869,-0.0216848154765315,20,21
6380,relax_one,0.75,27,16,11,-6.931068298758227,0.0711998778963761,39,52
6381,relax_one,0.75,436,312,124,-0.5381153683406197,-0.0288282471522901,42,109
6382,relax_one,0.75,1,0,1,84.9475013174768,-0.5719597603675104,25,28
6383,relax_one,0.75,222,214,8,0.5848165135631831,0.2452917166539756,56,106
6384,relax_one,0.75,461,474,-13,-0.9193605645491588,-0.0513992808179994,87,189
6385,relax_one,0.75,25,35,-10,5.617748423698643,0.1127361317765918,56,82
6386,relax_one,0.75,3,1,2,-16.63063976887078,-0.0828154138639918,13,15
6387,relax_one,0.75,67,69,-2,-0.8958841744649817,-0.4333973892655688,36,63
6388,relax_one,0.75,1,1,0,25.82291270717724,0.0608221884963511,16,15
6389,relax_one,0.75,0,0,0,0.0,-0.1586187269963463,67,66
6390,relax_one,0.75,23,21,2,2.4378229191468392,-0.1110432958924587,42,60
6391,relax_one,0.75,0,0,0,0.0,0.2110141086385841,39,38
6392,relax_one,0.75,11,17,-6,-1.901951721175024,0.0493524339229279,20,36
6393,relax_one,0.75,0,0,0,0.0,0.0630684409628431,10,9
6394,relax_one,0.75,1,0,1,45.50800963260833,0.2249017197057116,13,15
6395,relax_one,0.75,10,6,4,1.2406981007801932,0.1308286559510684,34,41
6396,relax_one,0.75,7,7,0,-5.647415711479212,-0.0096749392696708,37,42
6397,relax_one,0.75,14,25,-11,-6.953562819517025,0.2218730712676477,18,29
6398,relax_one,0.75,1,0,1,63.7532949111302,0.4002985870586635,23,22
6399,relax_one,0.75,0,0,0,0.0,0.1530618811555114,13,12
6400,relax_one,0.75,1,0,1,88.23334317727162,-0.302578308150415,15,14
6401,relax_one,0.75,0,0,0,0.0,-0.204166283296058,69,68
6402,relax_one,0.75,0,0,0,0.0,0.2344343873774015,40,39
6403,relax_one,0.75,0,1,-1,-89.33683357350326,-0.1330464008252685,89,93
6404,relax_one,0.75,13,17,-4,17.056590405967476,0.1168441949785175,20,32
6405,relax_one,0.75,5,4,1,-8.522603631386673,0.2050546413945549,69,83
6406,relax_one,0.75,1,1,0,15.220888949939225,0.1797160486730249,12,15
6407,relax_one,0.75,0,0,0,0.0,0.3777950818913457,15,14
6408,relax_one,0.75,1,1,0,-12.11947918840916,-0.0577407711210572,23,26
6409,relax_one,0.75,7,3,4,-13.848158270207314,-0.4039827133497731,12,20
6410,relax_one,0.75,236,178,58,-0.5200252893517003,-0.1236305263817496,64,122
6411,relax_one,0.75,27,29,-2,8.138755117263983,0.0859276170627162,58,71
6412,relax_one,0.75,0,1,-1,-84.64605376822551,-0.008959099574591,20,19
6413,relax_one,0.75,271,299,-28,-1.367475587335555,0.2050459995810121,100,191
6414,relax_one,0.75,33,40,-7,-7.975082993768687,0.2457831657386746,41,61
6415,relax_one,0.75,31,28,3,3.1441999890983823,0.1357091098450812,13,31
6416,relax_one,0.75,5,2,3,-0.8507183791687964,-0.002845690221331,10,15
6417,relax_one,0.75,9,6,3,2.807889811533826,0.3595727111988818,37,47
6418,relax_one,0.75,0,1,-1,-70.84204206792627,-0.2586932547898339,21,21
6419,relax_one,0.75,0,0,0,0.0,0.1519819421563224,11,10
6420,relax_one,0.75,51,46,5,-3.1510209755887644,-0.0306112164273643,44,80
6421,relax_one,0.75,2,3,-1,-12.60106730546729,-0.3424020026336638,12,21
6422,relax_one,0.75,0,3,-3,-57.67287478086202,-0.1101310041135393,37,43
6423,relax_one,0.75,9,40,-31,7.866379499654556,-0.0487177669590906,41,52
6424,relax_one,0.75,1,2,-1,21.56732841076986,0.0637792421184848,90,89
6425,relax_one,0.75,0,0,0,0.0,0.3178862965313379,22,21
6426,relax_one,0.75,3,13,-10,-1.4010402642469728,-0.0702525473303982,37,43
6427,relax_one,0.75,3,1,2,-14.312404694365874,-0.1718575652863296,47,47
6428,relax_one,0.75,4,5,-1,4.591491223219933,0.0050148699652174,12,20
6429,relax_one,0.75,141,101,40,-4.447102145881424,-0.4198763682852713,84,124
6430,relax_one,0.75,0,5,-5,-81.067411829356,0.1234976182916867,88,92
6431,relax_one,0.75,375,346,29,0.1688148230692547,-0.0127759339895552,59,122
6432,relax_one,0.75,18,6,12,-6.600679675206095,0.2722621494569458,26,31
6433,relax_one,0.75,0,0,0,0.0,0.1199155776887943,28,27
6434,relax_one,0.75,2,3,-1,7.014722706673027,-0.0300435881700961,18,26
6435,relax_one,0.75,5,6,-1,23.98129755396021,0.2643037017609899,23,26
6436,relax_one,0.75,1,0,1,46.635615080235226,0.2839597273437066,43,43
6437,relax_one,0.75,3,2,1,10.048565311639642,-0.0699323215609588,22,26
6438,relax_one,0.75,0,0,0,0.0,0.0516941144158188,15,14
6439,relax_one,0.75,12,11,1,4.383933494317127,0.192826532468085,36,48
6440,relax_one,0.75,8,3,5,-14.348139109704704,-0.116424596814421,30,37
6441,relax_one,0.75,3,1,2,-8.44708652306052,-0.073078884079913,10,13
6442,relax_one,0.75,0,1,-1,-89.31433003917384,-0.3953791701873322,12,11
6443,relax_one,0.75,204,198,6,2.312188264896392,0.13357513645297,55,105
6444,relax_one,0.75,3,3,0,1.2211011020076796,-0.4386010891441469,13,17
6445,relax_one,0.75,2,0,2,68.52645858613374,0.1579709908456461,30,29
6446,relax_one,0.75,5,1,4,-16.2085070090927,0.116167987277397,36,43
6447,relax_one,0.75,41,12,29,5.398067874979596,-0.0753908659447151,40,60
6448,relax_one,0.75,2,7,-5,3.574641250946911,0.0257023700576419,13,17
6449,relax_one,0.75,5,12,-7,7.911171351429274,-0.0351543790642195,23,30
6450,relax_one,0.75,4,4,0,-5.53453386183142,0.0131569288344564,12,16
6451,relax_one,0.75,1,1,0,34.338130844172,0.3494059332903113,26,26
6452,relax_one,0.75,1,1,0,11.82444857128428,0.1038414953185481,22,31
6453,relax_one,0.75,1,1,0,-14.713848463324886,0.2108370596522645,68,68
6454,relax_one,0.75,0,0,0,0.0,0.0885240422907899,23,22
6455,relax_one,0.75,0,0,0,0.0,-0.2466742438776809,43,42
6456,relax_one,0.75,0,5,-5,-69.28385554894265,-0.3107733047694591,18,17
6457,relax_one,0.75,7,12,-5,3.744700584976343,0.3293697162145649,28,42
6458,relax_one,0.75,49,54,-5,-2.122725622025847,0.1949110648433223,21,44
6459,relax_one,0.75,0,6,-6,-67.82650720600647,-0.0810713904830194,36,37
6460,relax_one,0.75,0,0,0,0.0,0.0844994817677856,15,14
6461,relax_one,0.75,1,1,0,-12.453863573803352,0.219226571456635,14,16
6462,relax_one,0.75,287,243,44,1.0585106966618485,0.1674678662752031,61,119
6463,relax_one,0.75,1,0,1,74.65045296311698,-0.1704828517113902,19,20
6464,relax_one,0.75,1,2,-1,10.717127474714758,0.2805918324558371,22,22
6465,relax_one,0.75,1,6,-5,13.382269268366372,-0.0895167386183145,54,58
6466,relax_one,0.75,594,547,47,0.0156307685665311,-0.0168043169643271,65,135
6467,relax_one,0.75,3,1,2,-15.306063979953578,0.1234327126535164,16,18
6468,relax_one,0.75,6,11,-5,10.943096259131297,0.1342763789695324,17,27
6469,relax_one,0.75,17,7,10,-0.1702305916299593,0.3085350025168859,54,71
6470,relax_one,0.75,0,0,0,0.0,-0.1426577327859568,23,22
6471,relax_one,0.75,1,2,-1,-0.1863839517674534,0.3126756963834851,13,16
6472,relax_one,0.75,264,155,109,2.257091108546625,0.1676097782397951,85,131
6473,relax_one,0.75,38,52,-14,3.6772955995634646,0.3532246767239597,28,55
6474,relax_one,0.75,3,3,0,0.0314769283759446,0.0276007648413875,18,24
6475,relax_one,0.75,2,2,0,38.00729417399032,0.1716680862547459,19,22
6476,relax_one,0.75,9,1,8,-9.963768231566846,0.0543383132658679,47,46
6477,relax_one,0.75,18,28,-10,-6.135137717103575,-0.1302239029827819,39,64
6478,relax_one,0.75,2,0,2,52.85150559829132,0.3017237999474486,17,18
6479,relax_one,0.75,1,3,-2,11.465033950211089,0.0789116888680343,23,24
6480,relax_one,0.75,2,1,1,-14.509146872733496,0.109809504900551,13,16
6481,relax_one,0.75,15,26,-11,3.447039884554023,-0.2247609769243447,40,56
6482,relax_one,0.75,0,1,-1,-88.02482918112538,-0.0441734938578985,10,15
6483,relax_one,0.75,0,0,0,0.0,-0.4280992976604218,21,20
6484,relax_one,0.75,3,4,-1,-6.506625578626526,-0.171449299045206,30,35
6485,relax_one,0.75,2,4,-2,6.512334261545149,-0.0622613434385548,71,77
6486,just_relax,0.75,0,0,0,0.0,0.1444492278550871,17,18
6487,just_relax,0.75,8,9,-1,32.45588169915662,-0.0184927003750622,43,48
6488,just_relax,0.75,2,7,-5,1.3697306257761284,-0.1882153057757115,38,45
6489,just_relax,0.75,0,0,0,0.0,-0.1682360547375572,12,12
6490,just_relax,0.75,6,31,-25,23.47988225754492,-0.3174864100603423,23,38
6491,just_relax,0.75,2,1,1,4.0960890170527335,0.0565592738466216,19,22
6492,just_relax,0.75,798,888,-90,1.5590436077051706,0.0173346332105009,35,143
6493,just_relax,0.75,5,6,-1,9.284548965393263,-0.1608637123289744,92,91
6494,just_relax,0.75,2,32,-30,0.5087373948418374,0.066583240555304,43,51
6495,just_relax,0.75,4,0,4,70.74039076645742,0.1876064325144946,35,36
6496,just_relax,0.75,0,0,0,0.0,0.2384512565014101,11,13
6497,just_relax,0.75,17,26,-9,3.7811917957299954,0.1234114539665537,10,25
6498,just_relax,0.75,22,40,-18,11.440625017402986,0.1277723076533582,86,136
6499,just_relax,0.75,0,0,0,0.0,0.1317483330302927,10,12
6500,just_relax,0.75,0,0,0,0.0,0.0653402444486572,32,31
6501,just_relax,0.75,2,8,-6,2.135640497331224,0.0112150108012895,20,26
6502,just_relax,0.75,0,0,0,0.0,-0.4844678599803079,11,11
6503,just_relax,0.75,6,6,0,-1.4051201687365236,-0.0413751073568641,34,42
6504,just_relax,0.75,11,13,-2,29.886997755192624,-0.1197483593816295,14,25
6505,just_relax,0.75,10,14,-4,2.2171886255318896,0.0172857986103694,31,46
6506,just_relax,0.75,1,19,-18,26.743861836091924,0.2081143781162717,42,45
6507,just_relax,0.75,1153,1104,49,-1.043431421816848,-0.1628912704546866,39,173
6508,just_relax,0.75,12,13,-1,-1.4053250712364616,-0.0213534548878517,14,24
6509,just_relax,0.75,0,2,-2,-47.37967104034597,0.1924158769870867,24,25
6510,just_relax,0.75,1,1,0,11.359711719136286,-0.1313756113621462,12,19
6511,just_relax,0.75,58,54,4,-0.3913652841262021,0.1362171362742841,41,72
6512,just_relax,0.75,204,202,2,1.9089361617777527,-0.1248475738994093,59,115
6513,just_relax,0.75,13,12,1,3.110571058670864,0.1734515086610194,32,37
6514,just_relax,0.75,1,1,0,23.58442333398457,0.5197074223665146,20,20
6515,just_relax,0.75,34,29,5,-2.6884929381519527,-0.0905790338243432,12,31
6516,just_relax,0.75,0,0,0,0.0,-0.5707040330974392,10,10
6517,just_relax,0.75,1,1,0,-14.391400613470026,0.1248353354810144,20,21
6518,just_relax,0.75,35,30,5,3.661452825733804,-0.1192300986175415,39,52
6519,just_relax,0.75,382,399,-17,1.3123114831644145,0.018919624996172,42,109
6520,just_relax,0.75,6,4,2,-1.5777012626427904,-0.0041938143578348,25,28
6521,just_relax,0.75,214,314,-100,4.083726648433405,0.0327391101180667,56,106
6522,just_relax,0.75,486,660,-174,7.39535080808475,-0.0678118768105907,87,189
6523,just_relax,0.75,23,34,-11,-0.5725572034353519,0.186302673161249,56,82
6524,just_relax,0.75,2,1,1,-35.18402618178373,-0.0847870085474123,13,15
6525,just_relax,0.75,89,99,-10,1.908325348194225,-0.0605641840970082,36,63
6526,just_relax,0.75,0,1,-1,-77.45272413625909,-0.435221735838554,16,15
6527,just_relax,0.75,0,0,0,0.0,-0.0305700768659733,67,66
6528,just_relax,0.75,11,46,-35,12.328977450743956,-0.3070992334631894,42,60
6529,just_relax,0.75,0,2,-2,-76.45834417721602,-0.0125812062283616,39,38
6530,just_relax,0.75,10,8,2,-8.380402050225541,0.1770918860266524,20,36
6531,just_relax,0.75,0,0,0,0.0,-0.0890404231659049,10,9
6532,just_relax,0.75,0,0,0,0.0,0.1574734331311756,13,15
6533,just_relax,0.75,11,16,-5,-2.6486034186708096,0.0337568388419655,34,41
6534,just_relax,0.75,5,5,0,-6.969196748776994,0.1783745011474203,37,42
6535,just_relax,0.75,25,23,2,-4.250023481259134,0.2230142949251266,18,29
6536,just_relax,0.75,2,2,0,-0.2783873208550034,-0.1411951732317237,23,22
6537,just_relax,0.75,0,0,0,0.0,0.1635376306343856,13,12
6538,just_relax,0.75,0,0,0,0.0,0.1629787100954209,15,14
6539,just_relax,0.75,0,0,0,0.0,-0.1182754421235887,69,68
6540,just_relax,0.75,0,0,0,0.0,-0.0594986388758028,40,39
6541,just_relax,0.75,14,3,11,0.345775500038286,-0.1091433876806257,89,93
6542,just_relax,0.75,16,15,1,-1.273728475763278,-0.0436867310073736,20,32
6543,just_relax,0.75,7,3,4,-7.736948196320185,0.0343572679201581,69,83
6544,just_relax,0.75,7,1,6,-3.36897204651369,0.2786770147231439,12,15
6545,just_relax,0.75,0,1,-1,-80.96877077525907,0.1690794124903947,15,14
6546,just_relax,0.75,2,2,0,3.946688703155658,-0.1730388903675804,23,26
6547,just_relax,0.75,2,4,-2,21.77025795265505,-0.084817185324325,12,20
6548,just_relax,0.75,208,247,-39,0.7749365636008676,-0.1275172973129783,64,122
6549,just_relax,0.75,32,8,24,15.821305129304127,-0.0337992515825537,58,71
6550,just_relax,0.75,0,0,0,0.0,-0.0811740651140294,20,19
6551,just_relax,0.75,306,371,-65,3.585682588054979,-0.2264266226270177,100,191
6552,just_relax,0.75,52,48,4,6.923971752366263,-0.2353693381406427,41,61
6553,just_relax,0.75,17,30,-13,18.416560175414183,-0.0298524785650475,13,31
6554,just_relax,0.75,4,3,1,4.534497336499669,-0.0646356558916937,10,15
6555,just_relax,0.75,12,7,5,-10.540663359500847,-0.1094288735255416,37,47
6556,just_relax,0.75,1,0,1,75.75874993998029,-0.0096114811780165,21,21
6557,just_relax,0.75,0,0,0,0.0,-0.3529835666994382,11,10
6558,just_relax,0.75,80,44,36,-7.218480676322351,0.3603432222550428,44,80
6559,just_relax,0.75,3,3,0,4.095691990485051,-0.1375756882668251,12,21
6560,just_relax,0.75,2,6,-4,-14.151960136446531,-0.1686060772801653,37,43
6561,just_relax,0.75,23,15,8,8.826183231165707,0.2261816512887333,41,52
6562,just_relax,0.75,1,1,0,18.16518081448957,0.1833583229464228,90,89
6563,just_relax,0.75,1,0,1,80.20518331907738,0.0518996215110889,22,21
6564,just_relax,0.75,4,3,1,3.5139487590869933,-0.0207231430828116,37,43
6565,just_relax,0.75,3,15,-12,8.71215641217082,-0.2352868434245658,47,47
6566,just_relax,0.75,5,4,1,-10.363752587486736,0.1728618524338063,12,20
6567,just_relax,0.75,122,129,-7,-3.008888713836548,-0.2155337271096217,84,124
6568,just_relax,0.75,0,1,-1,-73.40893995384128,-0.1410108023097415,88,92
6569,just_relax,0.75,328,321,7,2.9713095321825733,0.0520490255065386,59,122
6570,just_relax,0.75,4,5,-1,9.572007234075713,0.1945829530974154,26,31
6571,just_relax,0.75,0,0,0,0.0,-0.2286005680897977,28,27
6572,just_relax,0.75,3,6,-3,-2.0244648136143866,0.2765393408105114,18,26
6573,just_relax,0.75,5,1,4,20.651685830638783,0.1937619399635461,23,26
6574,just_relax,0.75,7,2,5,-7.219694533912829,0.0017161228338462,43,43
6575,just_relax,0.75,2,1,1,14.025321072220756,0.2701122787671186,22,26
6576,just_relax,0.75,0,0,0,0.0,-0.2667628466670697,15,14
6577,just_relax,0.75,9,13,-4,-6.597354784709111,0.1656073086268989,36,48
6578,just_relax,0.75,8,8,0,-10.471269509917144,0.1699951127610076,30,37
6579,just_relax,0.75,1,4,-3,11.823148777431342,-0.1957291007444566,10,13
6580,just_relax,0.75,0,1,-1,-74.4841221142518,-0.2492270738268223,12,11
6581,just_relax,0.75,156,207,-51,6.058523929386887,0.083559872016779,55,105
6582,just_relax,0.75,4,4,0,20.06251974176741,0.6405129171120452,13,17
6583,just_relax,0.75,2,3,-1,-20.99106320425451,0.1258886470846613,30,29
6584,just_relax,0.75,6,8,-2,5.247098660828627,-0.3095418757814583,36,43
6585,just_relax,0.75,14,21,-7,5.539107982236125,-0.2301136959280525,40,60
6586,just_relax,0.75,0,1,-1,-79.02153683012553,0.1640920145110179,13,17
6587,just_relax,0.75,9,5,4,-12.907159755821354,-0.1372104579853497,23,30
6588,just_relax,0.75,0,0,0,0.0,0.1071607851674432,12,16
6589,just_relax,0.75,0,1,-1,-87.7183804975595,-0.2353188185864189,26,26
6590,just_relax,0.75,1,0,1,75.28694271632702,0.290537083481146,22,31
6591,just_relax,0.75,0,2,-2,-72.24780995949155,-0.0201294746764111,68,68
6592,just_relax,0.75,0,0,0,0.0,0.0140787221834355,23,22
6593,just_relax,0.75,0,0,0,0.0,0.0752870366113055,43,42
6594,just_relax,0.75,0,0,0,0.0,0.0765472829410677,18,17
6595,just_relax,0.75,21,7,14,0.8018444086664474,0.0620467624759717,28,42
6596,just_relax,0.75,48,49,-1,1.0030331844865472,-0.2136911002066254,21,44
6597,just_relax,0.75,6,5,1,-20.876306755397657,0.0793439815762702,36,37
6598,just_relax,0.75,0,0,0,0.0,-0.2060837275717725,15,14
6599,just_relax,0.75,1,0,1,28.849142127375487,-0.0418743469654753,14,16
6600,just_relax,0.75,247,291,-44,-0.0227389669641269,-0.090169579237583,61,119
6601,just_relax,0.75,0,0,0,0.0,-0.3335796407474898,19,20
6602,just_relax,0.75,3,1,2,7.024272513421096,0.0023450773403422,22,22
6603,just_relax,0.75,3,9,-6,28.01034708891369,-0.0576399923413648,54,58
6604,just_relax,0.75,430,911,-481,5.002847675895794,-0.1978559583901185,65,135
6605,just_relax,0.75,0,1,-1,-85.05112700635105,0.2508770379838544,16,18
6606,just_relax,0.75,5,9,-4,3.6533013526689047,-0.0828864579619294,17,27
6607,just_relax,0.75,13,15,-2,-8.884425546517498,0.2500713374871146,54,71
6608,just_relax,0.75,0,6,-6,-67.70235205789542,-0.3063126708400334,23,22
6609,just_relax,0.75,2,0,2,58.49302531142397,-0.0383164300338326,13,16
6610,just_relax,0.75,216,265,-49,2.463765523541703,-0.0041379217215482,85,131
6611,just_relax,0.75,36,47,-11,4.068605794941298,0.202630592023554,28,55
6612,just_relax,0.75,2,6,-4,-10.73518058712581,0.0798702902473523,18,24
6613,just_relax,0.75,2,2,0,-0.8960512674839833,-0.2126257551458608,19,22
6614,just_relax,0.75,0,2,-2,-65.48807802280051,0.1663237454282949,47,46
6615,just_relax,0.75,43,33,10,-1.2819388563148308,-0.0131170044316724,39,64
6616,just_relax,0.75,1,0,1,87.30361227272569,0.106469081964902,17,18
6617,just_relax,0.75,4,1,3,-0.6698827162131806,0.2498001196179133,23,24
6618,just_relax,0.75,1,1,0,6.3958478465193735,-0.1383077756069525,13,16
6619,just_relax,0.75,21,63,-42,5.569610776971423,0.1921290049388633,40,56
6620,just_relax,0.75,1,1,0,-10.562695162918502,-0.0765903071431384,10,15
6621,just_relax,0.75,1,0,1,74.68818781210882,-0.0395381990277029,21,20
6622,just_relax,0.75,2,4,-2,29.043414466234616,0.0163559047083025,30,35
6623,just_relax,0.75,1,5,-4,-10.121646505128766,-0.0093347053890867,71,77
6624,relax_and_recompute,0.8,0,0,0,0.0,0.4655017408009929,17,18
6625,relax_and_recompute,0.8,10,7,3,1.7202254402482922,-0.3197816052810067,43,48
6626,relax_and_recompute,0.8,8,8,0,14.816386224196748,0.2562304720399414,38,45
6627,relax_and_recompute,0.8,1,0,1,65.08180124284299,0.3240739535402932,12,12
6628,relax_and_recompute,0.8,12,6,6,-4.550807881716949,0.1819363417554437,23,38
6629,relax_and_recompute,0.8,2,3,-1,-4.748773317816756,0.526524052366411,19,22
6630,relax_and_recompute,0.8,779,791,-12,-0.0553538895176544,0.1236922358388964,35,143
6631,relax_and_recompute,0.8,6,1,5,-17.991846733742683,-0.0500730691501117,92,91
6632,relax_and_recompute,0.8,4,2,2,-1.7766743904681732,-0.1706821571267055,43,51
6633,relax_and_recompute,0.8,0,1,-1,-57.09190840371815,0.0046231089442571,35,36
6634,relax_and_recompute,0.8,0,1,-1,-72.5968000571645,-0.0305378399533744,11,13
6635,relax_and_recompute,0.8,30,14,16,-6.758286928572588,-0.1119691085681812,10,25
6636,relax_and_recompute,0.8,15,30,-15,13.700860486547915,-0.0721614046999492,86,136
6637,relax_and_recompute,0.8,0,0,0,0.0,-0.3930667175018029,10,12
6638,relax_and_recompute,0.8,0,0,0,0.0,-0.1174157314568153,32,31
6639,relax_and_recompute,0.8,2,2,0,-9.438359910211162,-0.0302949640201163,20,26
6640,relax_and_recompute,0.8,0,0,0,0.0,-0.1070287439950087,11,11
6641,relax_and_recompute,0.8,3,1,2,-4.861532920624512,-0.0309432432353747,34,42
6642,relax_and_recompute,0.8,15,10,5,-5.210645973077888,0.4035180281376182,14,25
6643,relax_and_recompute,0.8,12,7,5,3.877071537368941,0.1473943486073264,31,46
6644,relax_and_recompute,0.8,3,3,0,-26.567208094927253,0.1564408691128467,42,45
6645,relax_and_recompute,0.8,1233,1132,101,-0.8637837115457572,-0.03225059870951,39,173
6646,relax_and_recompute,0.8,10,7,3,-6.252546494015974,0.6238343191166058,14,24
6647,relax_and_recompute,0.8,0,0,0,0.0,-0.1875299312902741,24,25
6648,relax_and_recompute,0.8,2,1,1,-11.460406311063096,-0.0999659687426877,12,19
6649,relax_and_recompute,0.8,100,67,33,5.928097769624067,0.0572166273008569,41,72
6650,relax_and_recompute,0.8,153,229,-76,1.6770480230845737,0.0670672560986718,59,115
6651,relax_and_recompute,0.8,11,2,9,21.52966422950246,-0.1909413641032644,32,37
6652,relax_and_recompute,0.8,0,1,-1,-73.06390017870079,-0.2414179086872425,20,20
6653,relax_and_recompute,0.8,26,23,3,-0.0581784335330866,0.2627004363987377,12,31
6654,relax_and_recompute,0.8,0,0,0,0.0,-0.1642588362390895,10,10
6655,relax_and_recompute,0.8,0,2,-2,-87.13558322999197,-6.106496696911545e-05,20,21
6656,relax_and_recompute,0.8,21,19,2,7.628703054589607,-0.0515256165476412,39,52
6657,relax_and_recompute,0.8,360,350,10,-0.0077690315894187,-0.0568961567541183,42,109
6658,relax_and_recompute,0.8,5,0,5,75.28775010641404,0.0069692026530109,25,28
6659,relax_and_recompute,0.8,205,239,-34,-0.3445328027295886,0.0059572483808346,56,106
6660,relax_and_recompute,0.8,517,426,91,-0.7274378496043354,-0.0093871259268225,87,189
6661,relax_and_recompute,0.8,44,48,-4,1.88875448368497,-0.1784996926847204,56,82
6662,relax_and_recompute,0.8,1,1,0,0.303446764201098,0.010825571691556,13,15
6663,relax_and_recompute,0.8,80,86,-6,0.5487071217037425,0.1078931043720844,36,63
6664,relax_and_recompute,0.8,0,1,-1,-59.568202618022255,-0.4100323266351647,16,15
6665,relax_and_recompute,0.8,0,0,0,0.0,0.1196409378745075,67,66
6666,relax_and_recompute,0.8,18,13,5,-2.015022421201266,0.1246276869920222,42,60
6667,relax_and_recompute,0.8,3,6,-3,18.76967888190741,-0.0330796613475005,39,38
6668,relax_and_recompute,0.8,13,17,-4,10.183053063936995,-0.5574515419090603,20,36
6669,relax_and_recompute,0.8,2,0,2,79.63121825560692,0.5831955113131284,10,9
6670,relax_and_recompute,0.8,0,0,0,0.0,-0.116348268967469,13,15
6671,relax_and_recompute,0.8,9,10,-1,7.901412772489067,0.1836842606577369,34,41
6672,relax_and_recompute,0.8,5,4,1,15.872996906533714,-0.1793752775889013,37,42
6673,relax_and_recompute,0.8,21,23,-2,5.721142386549197,0.5068082714277298,18,29
6674,relax_and_recompute,0.8,0,1,-1,-84.27133448082404,0.1028031628139916,23,22
6675,relax_and_recompute,0.8,0,0,0,0.0,0.0450363740295712,13,12
6676,relax_and_recompute,0.8,3,1,2,-13.510566562815228,-0.2013754489815789,15,14
6677,relax_and_recompute,0.8,0,0,0,0.0,0.0498975951990962,69,68
6678,relax_and_recompute,0.8,0,8,-8,-63.46377505620186,0.1479824531195807,40,39
6679,relax_and_recompute,0.8,5,0,5,67.5621637022234,0.3358057547460795,89,93
6680,relax_and_recompute,0.8,10,16,-6,2.7490858929025634,-0.1166045296730753,20,32
6681,relax_and_recompute,0.8,4,4,0,-4.398952858951503,-0.1012601566051536,69,83
6682,relax_and_recompute,0.8,1,1,0,22.22546410090965,-0.4871651448980624,12,15
6683,relax_and_recompute,0.8,0,1,-1,-80.27730368581078,-0.0775995132574177,15,14
6684,relax_and_recompute,0.8,4,1,3,-16.014170252085236,-0.1509787365258691,23,26
6685,relax_and_recompute,0.8,5,2,3,-6.631121376785018,-0.0950180107707021,12,20
6686,relax_and_recompute,0.8,195,204,-9,0.5660124444749854,0.1640996622992142,64,122
6687,relax_and_recompute,0.8,3,22,-19,18.822223742006727,-0.0813261196246122,58,71
6688,relax_and_recompute,0.8,0,0,0,0.0,0.2650357003539147,20,19
6689,relax_and_recompute,0.8,334,284,50,2.187786799919323,-0.0293704911295471,100,191
6690,relax_and_recompute,0.8,30,25,5,-1.6870358693078344,-0.1699662075698725,41,61
6691,relax_and_recompute,0.8,27,14,13,-4.836445759274142,-0.038450005252327,13,31
6692,relax_and_recompute,0.8,3,2,1,1.0507401905231433,0.5171597252582264,10,15
6693,relax_and_recompute,0.8,10,8,2,2.8228290398377,-0.0378000442157593,37,47
6694,relax_and_recompute,0.8,0,0,0,0.0,-0.0895333669571635,21,21
6695,relax_and_recompute,0.8,0,0,0,0.0,0.1595055578958275,11,10
6696,relax_and_recompute,0.8,38,54,-16,-0.2964042094659618,-0.217392559218263,44,80
6697,relax_and_recompute,0.8,3,2,1,-0.0940102582197823,-0.0822113981060973,12,21
6698,relax_and_recompute,0.8,4,0,4,63.356674171664615,0.0864003063214765,37,43
6699,relax_and_recompute,0.8,17,17,0,-4.788712842862019,0.1003300436379052,41,52
6700,relax_and_recompute,0.8,1,0,1,74.20539020891873,-0.0406439890292412,90,89
6701,relax_and_recompute,0.8,0,1,-1,-79.2048298109079,-0.1569734556596884,22,21
6702,relax_and_recompute,0.8,1,2,-1,37.76350438613193,-0.2042713415464651,37,43
6703,relax_and_recompute,0.8,2,2,0,19.24267999730784,0.121407466940025,47,47
6704,relax_and_recompute,0.8,5,5,0,-3.1334631265720603,-0.0310219609266385,12,20
6705,relax_and_recompute,0.8,155,136,19,0.2116752885154156,-0.3215125129244083,84,124
6706,relax_and_recompute,0.8,0,1,-1,-28.72511399095924,0.1862690018465228,88,92
6707,relax_and_recompute,0.8,367,350,17,1.636408110022778,-0.0842116271442371,59,122
6708,relax_and_recompute,0.8,7,6,1,2.637536584636891,0.0587455632620118,26,31
6709,relax_and_recompute,0.8,0,0,0,0.0,-0.1462552061389114,28,27
6710,relax_and_recompute,0.8,4,1,3,-17.863360839486162,0.1540890610100725,18,26
6711,relax_and_recompute,0.8,2,6,-4,-0.2586769528255459,-0.1886424016641462,23,26
6712,relax_and_recompute,0.8,5,1,4,-9.638604577142218,-0.1754396343389669,43,43
6713,relax_and_recompute,0.8,1,3,-2,19.86112711411032,0.3209190443762347,22,26
6714,relax_and_recompute,0.8,0,0,0,0.0,0.0625927101140012,15,14
6715,relax_and_recompute,0.8,14,10,4,-5.81950724796782,0.1771403745264732,36,48
6716,relax_and_recompute,0.8,4,5,-1,-9.44794793149444,-0.1765297105368916,30,37
6717,relax_and_recompute,0.8,1,2,-1,-4.822585448378845,-0.1022480076590583,10,13
6718,relax_and_recompute,0.8,2,1,1,2.255397999296917,0.0985199847797597,12,11
6719,relax_and_recompute,0.8,236,197,39,-4.474793527034642,-0.0098893572019206,55,105
6720,relax_and_recompute,0.8,0,0,0,0.0,-0.0343986229468837,13,17
6721,relax_and_recompute,0.8,0,0,0,0.0,-0.0845517701236305,30,29
6722,relax_and_recompute,0.8,2,11,-9,5.127793556654481,-0.0270553566863793,36,43
6723,relax_and_recompute,0.8,10,29,-19,1.9085792889138204,0.0794141676136949,40,60
6724,relax_and_recompute,0.8,1,0,1,62.27358469134152,0.1685892387268799,13,17
6725,relax_and_recompute,0.8,7,9,-2,7.338205129615261,-0.229445818565581,23,30
6726,relax_and_recompute,0.8,4,0,4,80.5569778037151,-0.1601427080898295,12,16
6727,relax_and_recompute,0.8,1,0,1,67.46204412910348,0.0317636432314822,26,26
6728,relax_and_recompute,0.8,4,3,1,-4.173263186129077,-0.1138469209282613,22,31
6729,relax_and_recompute,0.8,0,1,-1,-73.65866089125367,0.0877623540719579,68,68
6730,relax_and_recompute,0.8,0,0,0,0.0,0.0643233472210981,23,22
6731,relax_and_recompute,0.8,0,0,0,0.0,-0.049455949632154,43,42
6732,relax_and_recompute,0.8,0,2,-2,-59.90261989968129,0.0187628273692995,18,17
6733,relax_and_recompute,0.8,8,10,-2,7.217477159098195,-0.126907307927754,28,42
6734,relax_and_recompute,0.8,70,45,25,-4.609255441808031,0.344324199878086,21,44
6735,relax_and_recompute,0.8,0,0,0,0.0,-0.235325309897288,36,37
6736,relax_and_recompute,0.8,0,0,0,0.0,-0.0192953242283573,15,14
6737,relax_and_recompute,0.8,5,3,2,3.5305345020651373,-0.0899091359126129,14,16
6738,relax_and_recompute,0.8,266,207,59,-2.5368091666149013,-0.0202289487111597,61,119
6739,relax_and_recompute,0.8,1,0,1,83.13891975893974,0.0056941038891585,19,20
6740,relax_and_recompute,0.8,0,2,-2,-67.8737734259426,-0.437998083101987,22,22
6741,relax_and_recompute,0.8,0,1,-1,-72.1008102167574,-0.2265463539259075,54,58
6742,relax_and_recompute,0.8,474,426,48,0.2654399512119028,0.0021932643110802,65,135
6743,relax_and_recompute,0.8,1,4,-3,27.036930103058168,0.1011748842641202,16,18
6744,relax_and_recompute,0.8,14,4,10,-11.285505158049844,0.4286327271206088,17,27
6745,relax_and_recompute,0.8,16,11,5,-9.921237506894364,-0.1230076618639189,54,71
6746,relax_and_recompute,0.8,0,0,0,0.0,-0.4175321378381273,23,22
6747,relax_and_recompute,0.8,3,0,3,54.85331504971463,0.1734584314798122,13,16
6748,relax_and_recompute,0.8,168,168,0,-2.060386157160316,-0.1462199886516061,85,131
6749,relax_and_recompute,0.8,31,49,-18,0.2838309910300864,-0.028151742940377,28,55
6750,relax_and_recompute,0.8,3,1,2,10.24904567874882,-0.4221643655609371,18,24
6751,relax_and_recompute,0.8,0,2,-2,-69.68319480024076,-0.196344129326569,19,22
6752,relax_and_recompute,0.8,1,2,-1,5.688289306867105,-0.196190051507677,47,46
6753,relax_and_recompute,0.8,52,28,24,-5.423156325756416,0.3820208306052058,39,64
6754,relax_and_recompute,0.8,1,4,-3,-5.720745907508295,0.3360327414762624,17,18
6755,relax_and_recompute,0.8,2,5,-3,15.487597018881544,-0.0228722609549633,23,24
6756,relax_and_recompute,0.8,1,1,0,13.12890993312356,-0.101439083845603,13,16
6757,relax_and_recompute,0.8,16,17,-1,7.711432462825904,0.4952550404833632,40,56
6758,relax_and_recompute,0.8,0,2,-2,-68.10863598370508,0.0500425474112177,10,15
6759,relax_and_recompute,0.8,0,0,0,0.0,0.1567823022813517,21,20
6760,relax_and_recompute,0.8,2,4,-2,-10.952248574811565,-0.058361189827839,30,35
6761,relax_and_recompute,0.8,0,6,-6,-59.6281566979138,-0.4584673983208234,71,77
6762,relax_one,0.8,3,0,3,61.8832478449354,0.1371281647580924,17,18
6763,relax_one,0.8,6,3,3,8.919990568815102,0.0010577733875265,43,48
6764,relax_one,0.8,4,11,-7,-0.8564786547230909,0.2898317565521294,38,45
6765,relax_one,0.8,1,2,-1,6.232169145290712,-0.1050197883269745,12,12
6766,relax_one,0.8,9,6,3,1.5531314057696477,0.1157573933201904,23,38
6767,relax_one,0.8,2,0,2,88.25690205916376,-0.0176388297191438,19,22
6768,relax_one,0.8,868,818,50,-0.7902400267012197,0.0263528996873272,35,143
6769,relax_one,0.8,1,3,-2,26.725296184068668,0.1232833588858414,92,91
6770,relax_one,0.8,3,3,0,5.248474836220453,-0.1343372517179605,43,51
6771,relax_one,0.8,1,1,0,-11.936516779186476,0.0596311274375721,35,36
6772,relax_one,0.8,2,0,2,55.79234628454101,-0.118266650729779,11,13
6773,relax_one,0.8,20,26,-6,-2.497968003968268,0.3756825384643849,10,25
6774,relax_one,0.8,33,27,6,-2.259387705232548,0.2525272886834615,86,136
6775,relax_one,0.8,0,0,0,0.0,0.2416730759760739,10,12
6776,relax_one,0.8,0,0,0,0.0,0.0144814740615288,32,31
6777,relax_one,0.8,6,4,2,6.869956481159157,-0.210152426073354,20,26
6778,relax_one,0.8,0,1,-1,-64.05270378806372,-0.1515432147649038,11,11
6779,relax_one,0.8,3,1,2,14.731925971886035,0.1698334328666241,34,42
6780,relax_one,0.8,17,11,6,2.774655965192565,-0.0817257420245588,14,25
6781,relax_one,0.8,8,17,-9,0.4672747396240311,-0.0960953677413849,31,46
6782,relax_one,0.8,0,0,0,0.0,0.0169726108915936,42,45
6783,relax_one,0.8,1213,1120,93,0.6012005407279162,0.1816261707260634,39,173
6784,relax_one,0.8,8,10,-2,-5.956333276695631,0.0219368160573717,14,24
6785,relax_one,0.8,2,0,2,85.19351439737507,0.0648915768952919,24,25
6786,relax_one,0.8,1,1,0,-1.3202766386493892,-0.1141233649414307,12,19
6787,relax_one,0.8,76,64,12,-1.9266628549045488,-0.0685973760447392,41,72
6788,relax_one,0.8,281,181,100,-0.8371723827935185,0.1990255283047908,59,115
6789,relax_one,0.8,5,8,-3,-4.272254016324787,0.0479263220748078,32,37
6790,relax_one,0.8,0,1,-1,-74.1184188086727,-0.1182815607414049,20,20
6791,relax_one,0.8,26,24,2,-0.7806174158459527,0.0846408842874154,12,31
6792,relax_one,0.8,0,0,0,0.0,0.3003911135672146,10,10
6793,relax_one,0.8,2,1,1,-1.820522065476169,-0.0055398218997991,20,21
6794,relax_one,0.8,20,18,2,-10.0307497319844,-0.0340196085874545,39,52
6795,relax_one,0.8,353,419,-66,-0.5792996473795071,0.1473377959059216,42,109
6796,relax_one,0.8,3,1,2,-12.3223139106545,0.4622641999604006,25,28
6797,relax_one,0.8,231,201,30,2.576489610952379,0.0625584871175068,56,106
6798,relax_one,0.8,461,501,-40,-0.9059534018229628,0.0488262901558776,87,189
6799,relax_one,0.8,50,63,-13,-2.4479090357341704,0.222213859592648,56,82
6800,relax_one,0.8,1,1,0,5.789970040445979,0.0940624276093176,13,15
6801,relax_one,0.8,75,80,-5,-3.4548548969334405,-0.3439500356896861,36,63
6802,relax_one,0.8,0,0,0,0.0,0.0897800367437042,16,15
6803,relax_one,0.8,0,0,0,0.0,0.116582100341514,67,66
6804,relax_one,0.8,22,14,8,1.581813218419292,-0.063318513278282,42,60
6805,relax_one,0.8,0,0,0,0.0,-0.1223456687467425,39,38
6806,relax_one,0.8,11,10,1,1.2878544226630595,0.4251484506317716,20,36
6807,relax_one,0.8,0,0,0,0.0,0.2481311219218125,10,9
6808,relax_one,0.8,0,0,0,0.0,-0.0813200213676607,13,15
6809,relax_one,0.8,8,13,-5,-9.070164377621955,0.1094688248331109,34,41
6810,relax_one,0.8,5,4,1,-9.235293859199118,-0.1211299003210026,37,42
6811,relax_one,0.8,21,25,-4,1.0224079328562397,0.151626100700004,18,29
6812,relax_one,0.8,0,0,0,0.0,0.0037805328122624,23,22
6813,relax_one,0.8,0,0,0,0.0,0.094858469404208,13,12
6814,relax_one,0.8,0,0,0,0.0,-0.3571161036438336,15,14
6815,relax_one,0.8,0,0,0,0.0,0.0731228075444924,69,68
6816,relax_one,0.8,0,0,0,0.0,0.2035502514485117,40,39
6817,relax_one,0.8,0,0,0,0.0,0.2134066894916191,89,93
6818,relax_one,0.8,9,15,-6,5.049598436222979,0.0316767185936391,20,32
6819,relax_one,0.8,3,4,-1,5.409543135790571,0.146975071429729,69,83
6820,relax_one,0.8,2,2,0,4.769059536586568,0.3386040195154475,12,15
6821,relax_one,0.8,0,0,0,0.0,-0.125193183260309,15,14
6822,relax_one,0.8,0,2,-2,-40.90842207995789,-0.0251448388057669,23,26
6823,relax_one,0.8,7,10,-3,-8.444078536092661,-0.2700778686885716,12,20
6824,relax_one,0.8,228,174,54,-1.469572905415042,-0.0733340819114144,64,122
6825,relax_one,0.8,14,6,8,1.830865018301964,-0.1806652620838504,58,71
6826,relax_one,0.8,1,0,1,68.60302167238399,0.0300048082651314,20,19
6827,relax_one,0.8,322,301,21,-0.0480996801202877,-0.1328697992693392,100,191
6828,relax_one,0.8,42,43,-1,8.130495562225533,-0.2228376167633498,41,61
6829,relax_one,0.8,37,21,16,-8.255416504649403,-0.2300305078013536,13,31
6830,relax_one,0.8,3,3,0,-8.620452245211226,-0.0266126672143539,10,15
6831,relax_one,0.8,9,8,1,-15.595206327920527,0.014692302644391,37,47
6832,relax_one,0.8,1,1,0,-2.525694185655724,0.1650658715543813,21,21
6833,relax_one,0.8,1,0,1,84.57800722902559,0.2150721156102636,11,10
6834,relax_one,0.8,82,63,19,2.5605380644432003,-0.2219133190967479,44,80
6835,relax_one,0.8,2,2,0,17.453970110785747,-0.1900759371720525,12,21
6836,relax_one,0.8,4,5,-1,-5.905295280152181,-0.0245249302859783,37,43
6837,relax_one,0.8,9,11,-2,1.9492798701279028,0.0538333212274523,41,52
6838,relax_one,0.8,1,0,1,89.65006901957956,-0.4029678060260142,90,89
6839,relax_one,0.8,0,0,0,0.0,0.2072958297939419,22,21
6840,relax_one,0.8,12,4,8,-17.856879151227297,-0.1110156839373204,37,43
6841,relax_one,0.8,4,1,3,-16.091623312090462,0.0117813535328179,47,47
6842,relax_one,0.8,4,5,-1,-2.680242254404604,-0.0683991588301233,12,20
6843,relax_one,0.8,139,106,33,-1.4233719489359655,0.2936142719672587,84,124
6844,relax_one,0.8,2,1,1,12.481068421639192,-0.1926909414034691,88,92
6845,relax_one,0.8,353,266,87,-2.5547242645059143,0.1979176105360802,59,122
6846,relax_one,0.8,2,11,-9,22.35556453666068,0.1538791659485594,26,31
6847,relax_one,0.8,0,0,0,0.0,-0.0473251226230376,28,27
6848,relax_one,0.8,8,2,6,6.86876328566543,0.4041403903419979,18,26
6849,relax_one,0.8,1,1,0,14.601548695551545,0.4668150013199239,23,26
6850,relax_one,0.8,1,0,1,59.59915906072296,0.1215966554959333,43,43
6851,relax_one,0.8,5,2,3,11.112212659221434,0.3321065963165935,22,26
6852,relax_one,0.8,0,0,0,0.0,0.3090701087967052,15,14
6853,relax_one,0.8,21,7,14,4.32347368472378,0.0151689518920765,36,48
6854,relax_one,0.8,3,4,-1,-8.743821615039934,0.0503070154454312,30,37
6855,relax_one,0.8,1,3,-2,6.121645597484786,0.2066926632366242,10,13
6856,relax_one,0.8,1,0,1,61.05813358076676,0.4367417860289575,12,11
6857,relax_one,0.8,308,195,113,-2.42403021302065,-0.0128367349158106,55,105
6858,relax_one,0.8,0,4,-4,-79.91826006725671,0.0933793572450153,13,17
6859,relax_one,0.8,0,1,-1,-80.38484869363256,-0.0698380487813191,30,29
6860,relax_one,0.8,3,0,3,79.0477171233439,0.1436776511767213,36,43
6861,relax_one,0.8,18,15,3,-6.580217380476611,0.352723239785367,40,60
6862,relax_one,0.8,1,0,1,86.80577390446433,-0.1137735144838305,13,17
6863,relax_one,0.8,13,5,8,-3.87720730384104,0.1248605461603237,23,30
6864,relax_one,0.8,0,1,-1,-41.57635181468916,-0.0260965234849563,12,16
6865,relax_one,0.8,4,1,3,-6.522245780278396,0.054396438973692,26,26
6866,relax_one,0.8,2,1,1,14.699149499581871,0.4860581228712019,22,31
6867,relax_one,0.8,0,6,-6,-55.13093071398199,0.0093309946224863,68,68
6868,relax_one,0.8,0,0,0,0.0,0.0255592901119769,23,22
6869,relax_one,0.8,0,0,0,0.0,0.0134454695170365,43,42
6870,relax_one,0.8,1,1,0,36.47508106918716,0.3392441160796584,18,17
6871,relax_one,0.8,5,5,0,6.053821596430808,0.3110421148553888,28,42
6872,relax_one,0.8,52,45,7,-0.4298183642143272,0.0776740866310882,21,44
6873,relax_one,0.8,4,0,4,71.63275413936239,-0.0140185318352651,36,37
6874,relax_one,0.8,0,0,0,0.0,0.1413661617790352,15,14
6875,relax_one,0.8,5,3,2,-20.79607027405661,0.2942961021697394,14,16
6876,relax_one,0.8,194,224,-30,-2.067227899157082,0.049884650222347,61,119
6877,relax_one,0.8,0,0,0,0.0,-0.1583975509823347,19,20
6878,relax_one,0.8,0,0,0,0.0,0.4291787937265818,22,22
6879,relax_one,0.8,3,0,3,70.84134675051295,-0.0693045083315154,54,58
6880,relax_one,0.8,479,419,60,-1.7531951663191163,0.1123097049469907,65,135
6881,relax_one,0.8,3,6,-3,10.533130177558938,0.1055139406199198,16,18
6882,relax_one,0.8,6,8,-2,-10.96862386113002,-0.167683526633892,17,27
6883,relax_one,0.8,8,14,-6,10.972833843283349,0.0705988203860388,54,71
6884,relax_one,0.8,0,0,0,0.0,0.0101972608238748,23,22
6885,relax_one,0.8,2,1,1,32.008439425784964,-0.0757842278173258,13,16
6886,relax_one,0.8,152,141,11,0.2724129293506507,-0.2780596981214452,85,131
6887,relax_one,0.8,52,33,19,-9.268897704089618,0.0774023858460819,28,55
6888,relax_one,0.8,7,2,5,21.81147087544976,0.0998885519837828,18,24
6889,relax_one,0.8,1,2,-1,20.643773128072112,-0.2458609414122344,19,22
6890,relax_one,0.8,1,0,1,78.82712449343694,0.1844360973267667,47,46
6891,relax_one,0.8,25,29,-4,-2.83244733387481,0.3534085721070681,39,64
6892,relax_one,0.8,0,0,0,0.0,-0.1448447541018278,17,18
6893,relax_one,0.8,1,3,-2,25.318282960925323,0.0181849774362052,23,24
6894,relax_one,0.8,1,1,0,-10.520797580648946,0.2509809612566225,13,16
6895,relax_one,0.8,12,15,-3,9.720788948859289,-0.0996585845308759,40,56
6896,relax_one,0.8,1,0,1,80.12236242250559,0.124289226842052,10,15
6897,relax_one,0.8,0,0,0,0.0,-0.0474992348181972,21,20
6898,relax_one,0.8,11,1,10,14.551253224132637,0.2538230458259143,30,35
6899,relax_one,0.8,8,3,5,28.635869449184373,0.2657993754993434,71,77
6900,just_relax,0.8,3,2,1,1.8537908313348763,0.0016997909403986,17,18
6901,just_relax,0.8,8,11,-3,9.774836902995323,0.1494795201884177,43,48
6902,just_relax,0.8,12,8,4,-5.023767237687274,0.0338761754259043,38,45
6903,just_relax,0.8,5,0,5,41.03700477644886,0.2913544497741338,12,12
6904,just_relax,0.8,19,18,1,-5.109667075518871,-0.5004810648288727,23,38
6905,just_relax,0.8,1,1,0,17.764420143733915,-0.2505875057957197,19,22
6906,just_relax,0.8,803,835,-32,-0.4833126453968503,0.0116467536004585,35,143
6907,just_relax,0.8,0,7,-7,-58.0446379994769,-0.0222594879849502,92,91
6908,just_relax,0.8,9,35,-26,-2.3995430938979254,0.3166348458625362,43,51
6909,just_relax,0.8,0,1,-1,-59.6951649091246,0.113713489792227,35,36
6910,just_relax,0.8,0,0,0,0.0,-0.0454451050417233,11,13
6911,just_relax,0.8,21,23,-2,9.248254222445404,0.0678355804925151,10,25
6912,just_relax,0.8,41,44,-3,13.942833806368704,-0.1092852978537614,86,136
6913,just_relax,0.8,0,0,0,0.0,-0.3522339937155401,10,12
6914,just_relax,0.8,0,0,0,0.0,0.0571153903213904,32,31
6915,just_relax,0.8,5,5,0,-1.8344771432222728,-0.1699138704110572,20,26
6916,just_relax,0.8,1,0,1,73.5806824744577,-0.1669248811010225,11,11
6917,just_relax,0.8,5,11,-6,-17.384337784750485,0.2008981352136727,34,42
6918,just_relax,0.8,13,29,-16,9.024865888035343,-0.0972615856751272,14,25
6919,just_relax,0.8,17,13,4,8.679454561659668,-0.009457447443502,31,46
6920,just_relax,0.8,7,2,5,-17.278012025338285,0.0128382636840277,42,45
6921,just_relax,0.8,1134,1077,57,0.3305166295161683,-0.2071265899771461,39,173
6922,just_relax,0.8,15,8,7,-2.854712536214514,-0.2379522247543625,14,24
6923,just_relax,0.8,0,1,-1,-70.22399378231336,-0.0590422687288023,24,25
6924,just_relax,0.8,1,1,0,1.2716554558646038,0.3756006576957239,12,19
6925,just_relax,0.8,77,65,12,-1.4207111891622048,-0.1687771522138205,41,72
6926,just_relax,0.8,197,218,-21,5.039314958632083,0.1913527224019231,59,115
6927,just_relax,0.8,9,6,3,0.6720343097704244,-0.0497899028056175,32,37
6928,just_relax,0.8,2,0,2,78.1207779331779,-0.1674432222009263,20,20
6929,just_relax,0.8,26,29,-3,-1.418978233066369,-0.1010285139329988,12,31
6930,just_relax,0.8,0,0,0,0.0,-0.3588348379610224,10,10
6931,just_relax,0.8,0,0,0,0.0,0.1522266697021225,20,21
6932,just_relax,0.8,17,36,-19,-5.6290789589069945,0.0030968189295882,39,52
6933,just_relax,0.8,343,351,-8,2.4443934072125018,-0.227211887001406,42,109
6934,just_relax,0.8,1,5,-4,13.488028846509778,-0.4003243113980206,25,28
6935,just_relax,0.8,235,233,2,3.679304388102168,0.1199270353453734,56,106
6936,just_relax,0.8,434,630,-196,5.580997168642469,0.0210712765077343,87,189
6937,just_relax,0.8,59,28,31,-0.4516757579803965,-0.0444219798339872,56,82
6938,just_relax,0.8,1,2,-1,-0.9626120919670598,-0.3786395419245424,13,15
6939,just_relax,0.8,96,108,-12,-0.3298606957573398,-0.1908856351761173,36,63
6940,just_relax,0.8,0,2,-2,-74.55485234869714,-0.2231335026659366,16,15
6941,just_relax,0.8,0,0,0,0.0,-0.5320082267614044,67,66
6942,just_relax,0.8,20,28,-8,-10.846304944579783,0.0445889247633687,42,60
6943,just_relax,0.8,0,0,0,0.0,-0.0749585895562543,39,38
6944,just_relax,0.8,17,9,8,-8.52693411929782,0.0639838879669885,20,36
6945,just_relax,0.8,0,0,0,0.0,-0.5251528645379703,10,9
6946,just_relax,0.8,0,0,0,0.0,0.2389012092174638,13,15
6947,just_relax,0.8,18,11,7,-3.867694355189428,0.1821885869070927,34,41
6948,just_relax,0.8,1,3,-2,29.09153494881251,-0.2044623664320604,37,42
6949,just_relax,0.8,23,15,8,15.451551142623892,0.0721583306017757,18,29
6950,just_relax,0.8,0,0,0,0.0,-0.0005419390022357,23,22
6951,just_relax,0.8,0,0,0,0.0,0.0642303871540731,13,12
6952,just_relax,0.8,0,0,0,0.0,-0.2257299564891357,15,14
6953,just_relax,0.8,0,0,0,0.0,-0.1510240529171104,69,68
6954,just_relax,0.8,0,0,0,0.0,0.2557335049893492,40,39
6955,just_relax,0.8,7,2,5,14.56978275907602,-0.0632838622551273,89,93
6956,just_relax,0.8,12,17,-5,8.609005820483326,0.2457414661154855,20,32
6957,just_relax,0.8,1,5,-4,10.250547566246134,0.0628054748183373,69,83
6958,just_relax,0.8,2,2,0,1.6146668684947656,-0.5003190712229361,12,15
6959,just_relax,0.8,0,0,0,0.0,0.0562692938391202,15,14
6960,just_relax,0.8,5,1,4,-29.66084127470693,0.1268156349886487,23,26
6961,just_relax,0.8,6,2,4,-19.538640282557505,0.1848470985878277,12,20
6962,just_relax,0.8,245,280,-35,2.7963043630046656,-0.026939958777159,64,122
6963,just_relax,0.8,18,35,-17,4.831111603817661,0.0482305790244085,58,71
6964,just_relax,0.8,0,0,0,0.0,0.1571428912610113,20,19
6965,just_relax,0.8,293,347,-54,-1.4083820339067683,-0.0798012196867187,100,191
6966,just_relax,0.8,40,57,-17,11.173492624448052,0.3475098547213678,41,61
6967,just_relax,0.8,20,44,-24,10.510940436768664,-0.0135363673393382,13,31
6968,just_relax,0.8,6,8,-2,3.385867514402364,0.0238418448340986,10,15
6969,just_relax,0.8,13,8,5,9.900199941136542,-0.3473389291304435,37,47
6970,just_relax,0.8,0,0,0,0.0,-0.0234828606275324,21,21
6971,just_relax,0.8,1,0,1,85.59495634607767,-0.0220287810850524,11,10
6972,just_relax,0.8,88,34,54,-6.508199434770383,0.1163246714485191,44,80
6973,just_relax,0.8,7,2,5,0.0468180585847335,0.154971958382183,12,21
6974,just_relax,0.8,4,0,4,53.21287784584445,0.0490192883448423,37,43
6975,just_relax,0.8,15,14,1,2.3459847535337417,0.2391315593538712,41,52
6976,just_relax,0.8,8,2,6,-24.273193896282976,0.0242946429961058,90,89
6977,just_relax,0.8,0,5,-5,-44.86112204507539,-0.0465628993078064,22,21
6978,just_relax,0.8,3,6,-3,-15.341488158202177,-0.1204024836765835,37,43
6979,just_relax,0.8,2,8,-6,46.81551789807873,0.0335240638624956,47,47
6980,just_relax,0.8,4,4,0,2.9812468144851607,-0.2075554643427721,12,20
6981,just_relax,0.8,117,125,-8,0.1166218697297978,-0.0392146174081575,84,124
6982,just_relax,0.8,5,17,-12,26.617286490325107,-0.0415655194485437,88,92
6983,just_relax,0.8,525,504,21,5.226494222331702,-0.06964286678348,59,122
6984,just_relax,0.8,3,9,-6,-1.3885952221624365,0.225993308936596,26,31
6985,just_relax,0.8,0,0,0,0.0,-0.3553874753648528,28,27
6986,just_relax,0.8,2,3,-1,-43.591450034752086,0.1152904811951018,18,26
6987,just_relax,0.8,2,6,-4,7.015757585609705,-0.322338149246288,23,26
6988,just_relax,0.8,0,3,-3,-76.71716238615879,-0.1380951975338294,43,43
6989,just_relax,0.8,2,2,0,-5.403030062666502,-0.1043440587603115,22,26
6990,just_relax,0.8,0,0,0,0.0,0.1820249670756916,15,14
6991,just_relax,0.8,24,17,7,2.897697979375934,0.0643598368264353,36,48
6992,just_relax,0.8,7,5,2,1.0410436992954288,-0.05132208386041,30,37
6993,just_relax,0.8,3,2,1,-19.44194658148281,0.0115398347210812,10,13
6994,just_relax,0.8,0,0,0,0.0,0.5072577883407151,12,11
6995,just_relax,0.8,194,167,27,3.493284080636869,0.1055738219589509,55,105
6996,just_relax,0.8,0,1,-1,-61.73419571520449,0.2891950281325423,13,17
6997,just_relax,0.8,0,4,-4,-70.1547905568951,-0.3623373813040573,30,29
6998,just_relax,0.8,12,12,0,-8.927782555417572,-0.0008632717627619,36,43
6999,just_relax,0.8,16,44,-28,5.271395219472893,-0.0306645572499605,40,60
7000,just_relax,0.8,1,0,1,66.71403364223528,0.0603123150913434,13,17
7001,just_relax,0.8,6,11,-5,-5.620940174875116,0.3849283128392041,23,30
7002,just_relax,0.8,0,3,-3,-75.69015810619804,0.1442440975140673,12,16
7003,just_relax,0.8,2,2,0,37.50821595552296,0.0276442031426172,26,26
7004,just_relax,0.8,4,0,4,66.85772670852685,0.4157950493302476,22,31
7005,just_relax,0.8,1,1,0,-19.350656642748504,-0.0810489967461096,68,68
7006,just_relax,0.8,0,0,0,0.0,0.0130916002021062,23,22
7007,just_relax,0.8,0,8,-8,-51.38623055111612,0.0323407858782872,43,42
7008,just_relax,0.8,0,0,0,0.0,-0.0374763900906297,18,17
7009,just_relax,0.8,5,22,-17,10.790293920774332,0.0724875574639757,28,42
7010,just_relax,0.8,44,43,1,3.4422723896603458,-0.0910197288563016,21,44
7011,just_relax,0.8,3,7,-4,12.176428898944366,0.1457265085590505,36,37
7012,just_relax,0.8,0,0,0,0.0,-0.043362035526223,15,14
7013,just_relax,0.8,1,1,0,40.22078490518516,-0.000847087737112,14,16
7014,just_relax,0.8,284,213,71,-0.0014818269957004,-0.1224728648170063,61,119
7015,just_relax,0.8,0,2,-2,-79.0463818243635,-0.4271567501465922,19,20
7016,just_relax,0.8,0,4,-4,-50.74372743200678,-0.0446666855497184,22,22
7017,just_relax,0.8,5,2,3,63.217540807003374,-0.1767052393111617,54,58
7018,just_relax,0.8,487,863,-376,5.331544644653896,-0.2053462473740733,65,135
7019,just_relax,0.8,1,3,-2,14.229645251401358,0.0845380830592424,16,18
7020,just_relax,0.8,19,9,10,-4.158695745942261,0.0080399358207159,17,27
7021,just_relax,0.8,8,5,3,15.46572190793406,0.0558514493672802,54,71
7022,just_relax,0.8,0,1,-1,-67.59758668090547,-0.3425067493032662,23,22
7023,just_relax,0.8,2,1,1,-10.3666204134595,-0.0497962839429272,13,16
7024,just_relax,0.8,185,244,-59,2.5510233581280346,-0.0927077419625369,85,131
7025,just_relax,0.8,32,36,-4,-2.156231030184202,0.0334566370360712,28,55
7026,just_relax,0.8,5,3,2,15.878773071833812,0.393805513690084,18,24
7027,just_relax,0.8,3,3,0,-6.579446353190221,0.2132105691831985,19,22
7028,just_relax,0.8,4,0,4,68.51552498091355,0.19678801269372,47,46
7029,just_relax,0.8,37,59,-22,1.1313951141991296,-0.1736182686388503,39,64
7030,just_relax,0.8,2,1,1,-33.24813404916853,-0.0143973382039443,17,18
7031,just_relax,0.8,1,1,0,12.997771855104354,0.0308460757791166,23,24
7032,just_relax,0.8,2,1,1,-1.2333087162698178,0.1711179177712448,13,16
7033,just_relax,0.8,25,42,-17,3.313067007222763,-0.3252419903818683,40,56
7034,just_relax,0.8,0,0,0,0.0,0.5003287526193625,10,15
7035,just_relax,0.8,0,0,0,0.0,-0.1287586926055202,21,20
7036,just_relax,0.8,4,2,2,11.994212235758695,-0.1324184066735411,30,35
7037,just_relax,0.8,1,8,-7,11.531314360345476,-0.0112550377188876,71,77
7038,relax_and_recompute,0.8500000000000001,1,0,1,51.80343814226783,0.3534894009350017,17,18
7039,relax_and_recompute,0.8500000000000001,13,11,2,-5.785211304835009,0.1803138925597522,43,48
7040,relax_and_recompute,0.8500000000000001,6,3,3,2.1040977956405555,0.022479233006598,38,45
7041,relax_and_recompute,0.8500000000000001,0,2,-2,-64.80982951216936,0.025951679024345,12,12
7042,relax_and_recompute,0.8500000000000001,17,12,5,-14.032825725385877,-0.2238880314453739,23,38
7043,relax_and_recompute,0.8500000000000001,3,2,1,0.1883181413811172,-0.1783432642794667,19,22
7044,relax_and_recompute,0.8500000000000001,911,933,-22,-0.5836841642406583,-0.0576291494694566,35,143
7045,relax_and_recompute,0.8500000000000001,1,5,-4,0.3867130479051042,-0.0561386603800604,92,91
7046,relax_and_recompute,0.8500000000000001,19,14,5,-6.259128830350889,-0.0106636746542577,43,51
7047,relax_and_recompute,0.8500000000000001,3,1,2,11.705715456144551,0.2637727656034806,35,36
7048,relax_and_recompute,0.8500000000000001,0,4,-4,-63.86322448539563,0.1010566237329146,11,13
7049,relax_and_recompute,0.8500000000000001,20,19,1,0.4601568750176739,0.0341134075548709,10,25
7050,relax_and_recompute,0.8500000000000001,33,12,21,-0.1189753397775206,-0.1634154064941,86,136
7051,relax_and_recompute,0.8500000000000001,1,0,1,66.27392430968375,0.4312073975971323,10,12
7052,relax_and_recompute,0.8500000000000001,0,0,0,0.0,-0.0322271852471685,32,31
7053,relax_and_recompute,0.8500000000000001,3,3,0,-1.1081789655914631,0.0073008824096255,20,26
7054,relax_and_recompute,0.8500000000000001,0,0,0,0.0,-0.2004391949631548,11,11
7055,relax_and_recompute,0.8500000000000001,7,6,1,-11.33899178260733,-0.0295999529872865,34,42
7056,relax_and_recompute,0.8500000000000001,14,13,1,1.4447376645986196,0.0194598810374586,14,25
7057,relax_and_recompute,0.8500000000000001,9,20,-11,7.33589658685824,-0.1352902727174292,31,46
7058,relax_and_recompute,0.8500000000000001,1,5,-4,-10.764523675349096,-0.092722744989463,42,45
7059,relax_and_recompute,0.8500000000000001,1058,1100,-42,0.1029178224635174,0.1003103100669312,39,173
7060,relax_and_recompute,0.8500000000000001,11,12,-1,2.1475269460808306,-0.1183044836036685,14,24
7061,relax_and_recompute,0.8500000000000001,0,0,0,0.0,-0.127967560292202,24,25
7062,relax_and_recompute,0.8500000000000001,2,1,1,12.873982552078118,-0.210975074231739,12,19
7063,relax_and_recompute,0.8500000000000001,64,64,0,-3.3318323796911216,0.13135231231677,41,72
7064,relax_and_recompute,0.8500000000000001,181,201,-20,0.0606582952346528,-0.0715440033255598,59,115
7065,relax_and_recompute,0.8500000000000001,18,5,13,0.2811322028834908,0.0149292471509175,32,37
7066,relax_and_recompute,0.8500000000000001,0,0,0,0.0,-0.3200123737283629,20,20
7067,relax_and_recompute,0.8500000000000001,20,21,-1,2.8886518258852334,-0.0716170252331147,12,31
7068,relax_and_recompute,0.8500000000000001,2,0,2,62.457657265133,0.2722999754951615,10,10
7069,relax_and_recompute,0.8500000000000001,0,1,-1,-58.21237459435715,0.0351670615105292,20,21
7070,relax_and_recompute,0.8500000000000001,24,20,4,-1.833935326859788,-0.1765844653846381,39,52
7071,relax_and_recompute,0.8500000000000001,329,329,0,-0.2585799386088538,0.0475122393390352,42,109
7072,relax_and_recompute,0.8500000000000001,0,1,-1,-69.60919852019833,-0.2207642791351861,25,28
7073,relax_and_recompute,0.8500000000000001,170,183,-13,1.2941302955084737,-0.1909994870749258,56,106
7074,relax_and_recompute,0.8500000000000001,450,446,4,0.8786730662380648,-0.1928619851752192,87,189
7075,relax_and_recompute,0.8500000000000001,38,64,-26,-1.9020145971827416,-0.0139764538272753,56,82
7076,relax_and_recompute,0.8500000000000001,1,1,0,11.923448959139192,0.3609696998211569,13,15
7077,relax_and_recompute,0.8500000000000001,77,75,2,-1.0929956945936965,0.0353301332255332,36,63
7078,relax_and_recompute,0.8500000000000001,0,0,0,0.0,-0.1727188170511308,16,15
7079,relax_and_recompute,0.8500000000000001,0,0,0,0.0,-0.1089027431614262,67,66
7080,relax_and_recompute,0.8500000000000001,13,14,-1,0.8701721053403588,0.1746676389704257,42,60
7081,relax_and_recompute,0.8500000000000001,2,0,2,70.81240446937977,-0.2826237743391584,39,38
7082,relax_and_recompute,0.8500000000000001,8,10,-2,16.069674442845752,-0.229945223166572,20,36
7083,relax_and_recompute,0.8500000000000001,0,1,-1,-74.3832077978976,-0.1776566547566771,10,9
7084,relax_and_recompute,0.8500000000000001,0,0,0,0.0,0.4913210491417056,13,15
7085,relax_and_recompute,0.8500000000000001,19,4,15,9.728638940106222,-0.1009363900548089,34,41
7086,relax_and_recompute,0.8500000000000001,5,4,1,6.5122756847893015,0.2793853511392279,37,42
7087,relax_and_recompute,0.8500000000000001,29,29,0,2.7434716071296066,0.1416694592271652,18,29
7088,relax_and_recompute,0.8500000000000001,0,0,0,0.0,0.5150624958326693,23,22
7089,relax_and_recompute,0.8500000000000001,0,0,0,0.0,0.2630474876218001,13,12
7090,relax_and_recompute,0.8500000000000001,0,0,0,0.0,0.0914062615426932,15,14
7091,relax_and_recompute,0.8500000000000001,0,0,0,0.0,-0.2758133463287653,69,68
7092,relax_and_recompute,0.8500000000000001,0,0,0,0.0,0.0673120563407801,40,39
7093,relax_and_recompute,0.8500000000000001,3,0,3,58.7882183888453,-0.0071295442966751,89,93
7094,relax_and_recompute,0.8500000000000001,13,8,5,8.186593665721063,-0.1654422125272298,20,32
7095,relax_and_recompute,0.8500000000000001,5,4,1,-17.635195538508682,-0.3090548802453875,69,83
7096,relax_and_recompute,0.8500000000000001,0,2,-2,-64.3296298749292,-0.3592371668138075,12,15
7097,relax_and_recompute,0.8500000000000001,0,0,0,0.0,0.1510730150747101,15,14
7098,relax_and_recompute,0.8500000000000001,1,1,0,-15.925483636355452,0.0672955986338724,23,26
7099,relax_and_recompute,0.8500000000000001,2,2,0,-2.080513348967287,-0.101838021754267,12,20
7100,relax_and_recompute,0.8500000000000001,157,272,-115,4.506260074820922,-0.0986811871675825,64,122
7101,relax_and_recompute,0.8500000000000001,15,2,13,14.190491673569966,0.3091455863901371,58,71
7102,relax_and_recompute,0.8500000000000001,0,0,0,0.0,0.3275303085493973,20,19
7103,relax_and_recompute,0.8500000000000001,308,298,10,-3.5842913853599683,0.2010432868576632,100,191
7104,relax_and_recompute,0.8500000000000001,27,25,2,-1.263696157833465,0.0601219754036554,41,61
7105,relax_and_recompute,0.8500000000000001,25,29,-4,1.6325885576161596,0.0751489814694937,13,31
7106,relax_and_recompute,0.8500000000000001,3,3,0,0.5922122202763092,-0.0259844267388148,10,15
7107,relax_and_recompute,0.8500000000000001,10,9,1,-4.626157040850416,0.2279333389465214,37,47
7108,relax_and_recompute,0.8500000000000001,0,1,-1,-87.04614741572323,-0.095036271050531,21,21
7109,relax_and_recompute,0.8500000000000001,0,0,0,0.0,-0.0565826220899529,11,10
7110,relax_and_recompute,0.8500000000000001,54,76,-22,3.344003124325468,-0.3016923911403893,44,80
7111,relax_and_recompute,0.8500000000000001,3,3,0,-4.960363600796228,-0.3653183444722892,12,21
7112,relax_and_recompute,0.8500000000000001,9,2,7,-4.909077708396893,-0.1152485677453687,37,43
7113,relax_and_recompute,0.8500000000000001,12,18,-6,0.3868685242906906,-0.0143929503939899,41,52
7114,relax_and_recompute,0.8500000000000001,12,0,12,64.84937316924739,0.1452059945683753,90,89
7115,relax_and_recompute,0.8500000000000001,0,0,0,0.0,-0.0309248889293503,22,21
7116,relax_and_recompute,0.8500000000000001,3,1,2,-8.817144543035823,0.0651914788667302,37,43
7117,relax_and_recompute,0.8500000000000001,3,0,3,67.39094811607761,0.0334613464911331,47,47
7118,relax_and_recompute,0.8500000000000001,4,4,0,7.746186639393144,-0.061462480090252,12,20
7119,relax_and_recompute,0.8500000000000001,134,106,28,0.0223634014852649,-0.0735292692229212,84,124
7120,relax_and_recompute,0.8500000000000001,4,1,3,2.125930133733263,0.3731684543544625,88,92
7121,relax_and_recompute,0.8500000000000001,407,331,76,1.934593622447636,-0.0893225221091468,59,122
7122,relax_and_recompute,0.8500000000000001,3,2,1,17.656073279794256,0.0318893012071425,26,31
7123,relax_and_recompute,0.8500000000000001,0,0,0,0.0,0.5124336848761277,28,27
7124,relax_and_recompute,0.8500000000000001,9,3,6,0.5373776745906511,0.2164304284042191,18,26
7125,relax_and_recompute,0.8500000000000001,2,3,-1,-20.15451355956251,-0.0668728512593284,23,26
7126,relax_and_recompute,0.8500000000000001,1,1,0,-15.504329365715549,0.1201386444942892,43,43
7127,relax_and_recompute,0.8500000000000001,3,2,1,8.673882934709269,0.065494337891521,22,26
7128,relax_and_recompute,0.8500000000000001,0,0,0,0.0,-0.1286592819163112,15,14
7129,relax_and_recompute,0.8500000000000001,8,19,-11,5.049092914398038,0.0537949249029112,36,48
7130,relax_and_recompute,0.8500000000000001,5,11,-6,2.606117458823931,-0.1426517358237835,30,37
7131,relax_and_recompute,0.8500000000000001,2,1,1,-15.958309231211755,0.1340793287450262,10,13
7132,relax_and_recompute,0.8500000000000001,0,0,0,0.0,-0.2290191265324241,12,11
7133,relax_and_recompute,0.8500000000000001,193,217,-24,1.1492630188242998,0.2126351794083389,55,105
7134,relax_and_recompute,0.8500000000000001,0,3,-3,-76.26811578565513,-0.2651034771653526,13,17
7135,relax_and_recompute,0.8500000000000001,1,1,0,-3.745459828007157,-0.1280155831585503,30,29
7136,relax_and_recompute,0.8500000000000001,6,4,2,-2.8701078287557635,-0.0359526660807063,36,43
7137,relax_and_recompute,0.8500000000000001,10,26,-16,0.0505156325917113,-0.2346566383658875,40,60
7138,relax_and_recompute,0.8500000000000001,0,1,-1,-73.30476356561803,-0.1952923105982777,13,17
7139,relax_and_recompute,0.8500000000000001,12,5,7,11.715371616910808,-0.0375265052123056,23,30
7140,relax_and_recompute,0.8500000000000001,3,4,-1,-7.892009623477193,-0.3765404886786221,12,16
7141,relax_and_recompute,0.8500000000000001,1,4,-3,7.098782721628311,0.0374676476834577,26,26
7142,relax_and_recompute,0.8500000000000001,0,6,-6,-63.60853421214646,-0.2749608856584222,22,31
7143,relax_and_recompute,0.8500000000000001,1,0,1,60.76100465357704,-0.1488369968040616,68,68
7144,relax_and_recompute,0.8500000000000001,0,0,0,0.0,-0.0413746818745217,23,22
7145,relax_and_recompute,0.8500000000000001,0,0,0,0.0,0.0609004673717177,43,42
7146,relax_and_recompute,0.8500000000000001,0,0,0,0.0,0.3593269148606504,18,17
7147,relax_and_recompute,0.8500000000000001,5,11,-6,12.743840434374334,-0.0609378203366171,28,42
7148,relax_and_recompute,0.8500000000000001,83,39,44,-0.2784244517976617,0.1653571210489266,21,44
7149,relax_and_recompute,0.8500000000000001,0,2,-2,-63.67360749229103,0.3330759161684007,36,37
7150,relax_and_recompute,0.8500000000000001,0,0,0,0.0,0.0742627633428826,15,14
7151,relax_and_recompute,0.8500000000000001,0,1,-1,-89.23854329297022,0.1154453594082495,14,16
7152,relax_and_recompute,0.8500000000000001,230,209,21,-2.14757673977136,-0.1668894884548829,61,119
7153,relax_and_recompute,0.8500000000000001,2,1,1,-15.715808623393158,-0.0399601421251857,19,20
7154,relax_and_recompute,0.8500000000000001,0,1,-1,-79.40176238237046,0.3047884858534139,22,22
7155,relax_and_recompute,0.8500000000000001,3,1,2,-28.29867863284653,0.0035861368635906,54,58
7156,relax_and_recompute,0.8500000000000001,471,472,-1,-0.407032189119711,0.0057330809786565,65,135
7157,relax_and_recompute,0.8500000000000001,1,5,-4,24.587842593315315,-0.2751413074983418,16,18
7158,relax_and_recompute,0.8500000000000001,9,12,-3,-3.4402096678822787,0.0229087757462563,17,27
7159,relax_and_recompute,0.8500000000000001,6,16,-10,6.832680424108688,0.4537556823107699,54,71
7160,relax_and_recompute,0.8500000000000001,4,0,4,71.6716867910844,0.3142003792314241,23,22
7161,relax_and_recompute,0.8500000000000001,0,0,0,0.0,0.1933895527453524,13,16
7162,relax_and_recompute,0.8500000000000001,163,159,4,-4.019039052701125,0.0148004722194152,85,131
7163,relax_and_recompute,0.8500000000000001,36,46,-10,-1.922973751184557,-0.055042553950876,28,55
7164,relax_and_recompute,0.8500000000000001,1,2,-1,-34.05844982854282,0.0246597499881929,18,24
7165,relax_and_recompute,0.8500000000000001,3,3,0,-9.718304416500937,-0.171029374251749,19,22
7166,relax_and_recompute,0.8500000000000001,3,0,3,60.0,-0.1903646662148366,47,46
7167,relax_and_recompute,0.8500000000000001,34,46,-12,7.117680922217396,-0.179774519907072,39,64
7168,relax_and_recompute,0.8500000000000001,0,2,-2,-87.10349260308016,-0.0020763030601477,17,18
7169,relax_and_recompute,0.8500000000000001,2,1,1,-2.094457672892389,0.1245847381060216,23,24
7170,relax_and_recompute,0.8500000000000001,4,1,3,-0.5320942433455684,0.2538924457354675,13,16
7171,relax_and_recompute,0.8500000000000001,13,22,-9,5.762530160372549,0.0929527384526488,40,56
7172,relax_and_recompute,0.8500000000000001,0,0,0,0.0,-0.0177610072943626,10,15
7173,relax_and_recompute,0.8500000000000001,2,0,2,81.35204568808514,-0.0188534297761516,21,20
7174,relax_and_recompute,0.8500000000000001,2,3,-1,-8.647211634368375,-0.0986245614713792,30,35
7175,relax_and_recompute,0.8500000000000001,4,2,2,23.645649582589712,0.0875329855735728,71,77
7176,relax_one,0.8500000000000001,0,0,0,0.0,0.3572597354484631,17,18
7177,relax_one,0.8500000000000001,10,7,3,2.060804244433392,0.2736375737703085,43,48
7178,relax_one,0.8500000000000001,3,7,-4,-7.295531842663749,0.270683334980515,38,45
7179,relax_one,0.8500000000000001,0,0,0,0.0,-0.3079860624618102,12,12
7180,relax_one,0.8500000000000001,12,10,2,-6.862565829306973,0.032894348528607,23,38
7181,relax_one,0.8500000000000001,1,0,1,67.25859351318584,0.0133286019655755,19,22
7182,relax_one,0.8500000000000001,923,743,180,-0.502300994242411,0.0388136426572648,35,143
7183,relax_one,0.8500000000000001,13,0,13,51.774713935836985,-0.2441809924121781,92,91
7184,relax_one,0.8500000000000001,3,5,-2,-28.7453230382582,0.0479353178845672,43,51
7185,relax_one,0.8500000000000001,0,0,0,0.0,0.0974980912451035,35,36
7186,relax_one,0.8500000000000001,1,0,1,78.93329593157961,0.0739640313601909,11,13
7187,relax_one,0.8500000000000001,24,15,9,-6.076175572723301,-0.1588648760775879,10,25
7188,relax_one,0.8500000000000001,20,23,-3,-1.3387638010143237,-0.0172750059010441,86,136
7189,relax_one,0.8500000000000001,0,0,0,0.0,0.1882783733091431,10,12
7190,relax_one,0.8500000000000001,0,0,0,0.0,0.1196908801182279,32,31
7191,relax_one,0.8500000000000001,2,3,-1,-6.882512625356085,-0.3776289423046483,20,26
7192,relax_one,0.8500000000000001,0,0,0,0.0,-0.1503411454831423,11,11
7193,relax_one,0.8500000000000001,3,5,-2,17.949811850539092,-0.3902296198580012,34,42
7194,relax_one,0.8500000000000001,13,11,2,-7.19438703445654,0.386867396308324,14,25
7195,relax_one,0.8500000000000001,11,11,0,1.1903147612735268,-0.0059777053215382,31,46
7196,relax_one,0.8500000000000001,4,0,4,64.6607274306046,0.226904785640593,42,45
7197,relax_one,0.8500000000000001,1166,1055,111,-1.1761149327435731,0.1695977545652371,39,173
7198,relax_one,0.8500000000000001,8,9,-1,5.79306816447928,0.5368149922321048,14,24
7199,relax_one,0.8500000000000001,1,1,0,17.87096827774795,-0.161739045253428,24,25
7200,relax_one,0.8500000000000001,1,1,0,-0.620942975321995,0.0112072903957572,12,19
7201,relax_one,0.8500000000000001,60,66,-6,2.953443874743961,-0.0280266508274567,41,72
7202,relax_one,0.8500000000000001,278,166,112,-2.2888096303347325,-0.0266916023317113,59,115
7203,relax_one,0.8500000000000001,5,6,-1,-10.157917846143526,0.1075492585806752,32,37
7204,relax_one,0.8500000000000001,0,0,0,0.0,0.2383509368384833,20,20
7205,relax_one,0.8500000000000001,25,19,6,-0.857791097928299,-0.0780330730233984,12,31
7206,relax_one,0.8500000000000001,1,0,1,89.98234849640578,-0.0228478300918081,10,10
7207,relax_one,0.8500000000000001,2,0,2,53.31880310586696,0.0181895191017945,20,21
7208,relax_one,0.8500000000000001,27,19,8,-10.567880005521587,-0.0369936200760866,39,52
7209,relax_one,0.8500000000000001,358,351,7,1.353848271214055,-0.1300550778962969,42,109
7210,relax_one,0.8500000000000001,1,3,-2,11.734331194929126,-0.0727680702213623,25,28
7211,relax_one,0.8500000000000001,252,193,59,-1.4793426759837232,-0.1955440139495106,56,106
7212,relax_one,0.8500000000000001,422,464,-42,0.0697609721442589,0.2367960978643905,87,189
7213,relax_one,0.8500000000000001,41,53,-12,8.074259377093973,0.1169047720876903,56,82
7214,relax_one,0.8500000000000001,1,1,0,17.067431938756684,-0.066804782606084,13,15
7215,relax_one,0.8500000000000001,80,93,-13,-1.5533662436425075,0.3915704219853974,36,63
7216,relax_one,0.8500000000000001,1,0,1,88.28493133795216,0.0654310546548592,16,15
7217,relax_one,0.8500000000000001,0,0,0,0.0,-0.3770931052708333,67,66
7218,relax_one,0.8500000000000001,22,23,-1,-0.5081037459248847,0.1653706494068197,42,60
7219,relax_one,0.8500000000000001,1,2,-1,-34.100218140751075,0.3043110933805344,39,38
7220,relax_one,0.8500000000000001,10,19,-9,11.80218104204664,0.0425790283926156,20,36
7221,relax_one,0.8500000000000001,1,0,1,87.02226934763623,0.0432434995468813,10,9
7222,relax_one,0.8500000000000001,0,0,0,0.0,-0.0368057785089047,13,15
7223,relax_one,0.8500000000000001,14,7,7,-1.6812033562048896,-0.1295704489165901,34,41
7224,relax_one,0.8500000000000001,5,7,-2,3.0824380019718376,0.2118641654798829,37,42
7225,relax_one,0.8500000000000001,33,16,17,-3.562797933211243,-0.3252489188318878,18,29
7226,relax_one,0.8500000000000001,0,0,0,0.0,0.2716598039822172,23,22
7227,relax_one,0.8500000000000001,0,0,0,0.0,0.2450415070623546,13,12
7228,relax_one,0.8500000000000001,2,0,2,81.10726092928377,-0.33991215909447,15,14
7229,relax_one,0.8500000000000001,0,1,-1,-78.85804704187827,-0.195508636236259,69,68
7230,relax_one,0.8500000000000001,1,0,1,68.32515068087628,0.5284057924307923,40,39
7231,relax_one,0.8500000000000001,6,0,6,46.07650987450575,-0.0707742148336955,89,93
7232,relax_one,0.8500000000000001,9,10,-1,0.6456477784515045,0.023683883109409,20,32
7233,relax_one,0.8500000000000001,5,1,4,21.328898175779614,-0.1076431995287927,69,83
7234,relax_one,0.8500000000000001,2,2,0,-14.429883489850615,0.0371137787923864,12,15
7235,relax_one,0.8500000000000001,0,1,-1,-80.6845848871547,0.0574588966026183,15,14
7236,relax_one,0.8500000000000001,4,5,-1,6.581901322264912,0.1272942743889416,23,26
7237,relax_one,0.8500000000000001,2,9,-7,7.797308229854352,-0.0947964532650579,12,20
7238,relax_one,0.8500000000000001,179,197,-18,0.5181717751470387,0.0899674940276331,64,122
7239,relax_one,0.8500000000000001,7,29,-22,3.4787482886026453,-0.2300879288985595,58,71
7240,relax_one,0.8500000000000001,0,0,0,0.0,-0.2452911257581206,20,19
7241,relax_one,0.8500000000000001,499,261,238,-1.4276872496024922,0.2660220566613771,100,191
7242,relax_one,0.8500000000000001,32,30,2,-0.0292701876378913,-0.0680397038010179,41,61
7243,relax_one,0.8500000000000001,20,20,0,-2.2858442177159475,0.0130752267250711,13,31
7244,relax_one,0.8500000000000001,5,2,3,-3.0497931464616386,0.0527211551382368,10,15
7245,relax_one,0.8500000000000001,14,9,5,-10.83672403235206,-0.0126715748228323,37,47
7246,relax_one,0.8500000000000001,2,0,2,84.11895050114931,-0.1584051614763881,21,21
7247,relax_one,0.8500000000000001,0,0,0,0.0,0.2104079667014444,11,10
7248,relax_one,0.8500000000000001,50,30,20,-5.842063346116987,-0.0975654226637292,44,80
7249,relax_one,0.8500000000000001,4,6,-2,0.4433433013079195,-0.4303695991873206,12,21
7250,relax_one,0.8500000000000001,5,4,1,8.459915267497607,0.068724867916617,37,43
7251,relax_one,0.8500000000000001,8,16,-8,7.65741761620184,0.1318203457833413,41,52
7252,relax_one,0.8500000000000001,0,1,-1,-56.920993448219086,0.1845639142927322,90,89
7253,relax_one,0.8500000000000001,1,0,1,35.38601936328976,0.227706195138852,22,21
7254,relax_one,0.8500000000000001,6,2,4,8.421756220751078,-0.013503173501517,37,43
7255,relax_one,0.8500000000000001,1,0,1,58.99380685466295,0.4150438935492218,47,47
7256,relax_one,0.8500000000000001,8,4,4,-21.13658027721065,0.0869168210562431,12,20
7257,relax_one,0.8500000000000001,140,113,27,-2.678772675022479,0.3610720944055042,84,124
7258,relax_one,0.8500000000000001,7,0,7,64.44392431175915,0.0526496926512699,88,92
7259,relax_one,0.8500000000000001,366,372,-6,0.4975827625945754,0.0432106427657063,59,122
7260,relax_one,0.8500000000000001,5,6,-1,-10.515984145553034,0.3602319517679148,26,31
7261,relax_one,0.8500000000000001,3,0,3,71.2755406335937,-0.174918848939798,28,27
7262,relax_one,0.8500000000000001,7,3,4,-6.261066955043461,0.0373593228124319,18,26
7263,relax_one,0.8500000000000001,3,2,1,12.774550845467438,-0.1265725518961111,23,26
7264,relax_one,0.8500000000000001,1,1,0,5.683729474575372,-0.0565990616610686,43,43
7265,relax_one,0.8500000000000001,3,1,2,-26.950295586185696,0.0589587335859213,22,26
7266,relax_one,0.8500000000000001,0,0,0,0.0,0.2197997255106867,15,14
7267,relax_one,0.8500000000000001,28,12,16,-0.575718658012562,-0.0838468715405235,36,48
7268,relax_one,0.8500000000000001,1,9,-8,2.1067230829815244,-0.0298775852025163,30,37
7269,relax_one,0.8500000000000001,1,2,-1,0.2863380836076175,0.0281804963449306,10,13
7270,relax_one,0.8500000000000001,0,1,-1,-84.83103957462374,0.1728319781040038,12,11
7271,relax_one,0.8500000000000001,196,176,20,2.1465508958606563,0.195859039237757,55,105
7272,relax_one,0.8500000000000001,0,0,0,0.0,0.0382209259205558,13,17
7273,relax_one,0.8500000000000001,0,0,0,0.0,-0.1360601921574603,30,29
7274,relax_one,0.8500000000000001,2,3,-1,3.09690903518257,0.0153184121467876,36,43
7275,relax_one,0.8500000000000001,18,11,7,2.014605112470676,0.3505561030272102,40,60
7276,relax_one,0.8500000000000001,6,2,4,-10.394184455438849,0.3285771304348152,13,17
7277,relax_one,0.8500000000000001,17,8,9,-10.887788507457657,0.117819980848846,23,30
7278,relax_one,0.8500000000000001,1,1,0,13.906787808441544,-0.2303393349288122,12,16
7279,relax_one,0.8500000000000001,4,0,4,67.25765283123897,0.3229956670674231,26,26
7280,relax_one,0.8500000000000001,5,1,4,11.943163545297246,-0.071083936131774,22,31
7281,relax_one,0.8500000000000001,14,1,13,-8.16484458747832,0.0181414012733532,68,68
7282,relax_one,0.8500000000000001,0,0,0,0.0,0.0324915525318207,23,22
7283,relax_one,0.8500000000000001,2,0,2,64.3470717111028,-0.0632795353639457,43,42
7284,relax_one,0.8500000000000001,0,4,-4,-65.24027320785694,0.3993700260241339,18,17
7285,relax_one,0.8500000000000001,5,1,4,49.57472310784475,0.0338717478670039,28,42
7286,relax_one,0.8500000000000001,49,43,6,-0.7975766677900964,-0.3874636330706335,21,44
7287,relax_one,0.8500000000000001,0,0,0,0.0,0.2423985581290841,36,37
7288,relax_one,0.8500000000000001,0,0,0,0.0,0.1660775995651036,15,14
7289,relax_one,0.8500000000000001,0,0,0,0.0,-0.1294574725227959,14,16
7290,relax_one,0.8500000000000001,197,191,6,-0.4303487501511682,0.1007354583139241,61,119
7291,relax_one,0.8500000000000001,0,0,0,0.0,0.0394183485526864,19,20
7292,relax_one,0.8500000000000001,0,1,-1,-66.48789702455119,0.0362859308923551,22,22
7293,relax_one,0.8500000000000001,1,3,-2,-8.415740981800198,-0.0013642010414641,54,58
7294,relax_one,0.8500000000000001,468,511,-43,1.6966970283316982,-0.0511178416266721,65,135
7295,relax_one,0.8500000000000001,3,2,1,-1.2904026468255196,0.1170838715582627,16,18
7296,relax_one,0.8500000000000001,8,8,0,-0.4872304847716435,0.1914836096144432,17,27
7297,relax_one,0.8500000000000001,11,5,6,-5.6187527050092,-0.1031499529506322,54,71
7298,relax_one,0.8500000000000001,0,0,0,0.0,0.0672302970524049,23,22
7299,relax_one,0.8500000000000001,1,0,1,73.36975938369267,-0.0038216791673798,13,16
7300,relax_one,0.8500000000000001,163,125,38,-0.9654556294308634,0.3436495188961291,85,131
7301,relax_one,0.8500000000000001,39,38,1,-1.4253550989930377,-0.0339274920534442,28,55
7302,relax_one,0.8500000000000001,2,4,-2,9.63330441373578,-0.4952912318215487,18,24
7303,relax_one,0.8500000000000001,2,0,2,75.32973624210784,0.0314065672332406,19,22
7304,relax_one,0.8500000000000001,0,1,-1,-84.90383134680151,0.0077297199435957,47,46
7305,relax_one,0.8500000000000001,52,63,-11,3.976209213046701,0.1509939553189626,39,64
7306,relax_one,0.8500000000000001,1,1,0,26.75754029061304,0.2841223842714469,17,18
7307,relax_one,0.8500000000000001,2,2,0,1.8431018280543296,0.3729619618304459,23,24
7308,relax_one,0.8500000000000001,1,1,0,-2.588277036592132,0.4196422697393642,13,16
7309,relax_one,0.8500000000000001,23,15,8,0.3327533640061872,0.121583184640687,40,56
7310,relax_one,0.8500000000000001,3,1,2,-26.85551163906363,0.1078874720801281,10,15
7311,relax_one,0.8500000000000001,0,0,0,0.0,0.1349790037608716,21,20
7312,relax_one,0.8500000000000001,3,1,2,11.35935726167321,-0.147366337634786,30,35
7313,relax_one,0.8500000000000001,1,4,-3,31.700222304117155,0.0466252436091328,71,77
7314,just_relax,0.8500000000000001,1,1,0,13.927423972644064,0.1467553861249773,17,18
7315,just_relax,0.8500000000000001,8,7,1,-1.9375711553318808,0.0196677304379128,43,48
7316,just_relax,0.8500000000000001,7,6,1,-0.5329062147861094,-0.0031133358946795,38,45
7317,just_relax,0.8500000000000001,1,0,1,72.41061150270323,-0.5516293751692949,12,12
7318,just_relax,0.8500000000000001,11,28,-17,0.8560399590611638,-0.0701015630543606,23,38
7319,just_relax,0.8500000000000001,2,3,-1,3.0582114167320924,-0.2900668982268627,19,22
7320,just_relax,0.8500000000000001,799,735,64,0.0984864182292994,0.0340162605098369,35,143
7321,just_relax,0.8500000000000001,3,7,-4,0.4625524035066064,-0.2116676735091945,92,91
7322,just_relax,0.8500000000000001,6,8,-2,12.615902676541468,-0.0017496580549045,43,51
7323,just_relax,0.8500000000000001,7,4,3,-8.81012637548249,0.0647666253828682,35,36
7324,just_relax,0.8500000000000001,0,0,0,0.0,0.2903699467550331,11,13
7325,just_relax,0.8500000000000001,23,25,-2,4.028020264674595,-0.0867980353629001,10,25
7326,just_relax,0.8500000000000001,32,44,-12,7.073953363162097,-0.0127621765452419,86,136
7327,just_relax,0.8500000000000001,0,1,-1,-86.26823665309283,-0.2320432763712812,10,12
7328,just_relax,0.8500000000000001,0,0,0,0.0,0.0689133383633464,32,31
7329,just_relax,0.8500000000000001,4,4,0,8.419043632995312,0.1950268328397685,20,26
7330,just_relax,0.8500000000000001,0,0,0,0.0,0.1274820174501624,11,11
7331,just_relax,0.8500000000000001,4,7,-3,-6.570548340448646,-0.1968807223637401,34,42
7332,just_relax,0.8500000000000001,9,14,-5,11.61723415025999,-0.1736472863966953,14,25
7333,just_relax,0.8500000000000001,12,20,-8,6.308100419821358,-0.3071190434756615,31,46
7334,just_relax,0.8500000000000001,2,5,-3,26.22386963604317,0.0448017445396591,42,45
7335,just_relax,0.8500000000000001,1085,1186,-101,1.1529015550250603,-0.1360751068175866,39,173
7336,just_relax,0.8500000000000001,13,9,4,0.2043044391670037,-0.0347981322605466,14,24
7337,just_relax,0.8500000000000001,0,0,0,0.0,-0.1030020701752597,24,25
7338,just_relax,0.8500000000000001,1,2,-1,13.966169746072026,0.3432046774778212,12,19
7339,just_relax,0.8500000000000001,99,87,12,1.7728761011575287,-0.0853161309671345,41,72
7340,just_relax,0.8500000000000001,173,209,-36,2.6688440935737177,0.3905401567528013,59,115
7341,just_relax,0.8500000000000001,8,9,-1,-1.0851164745068471,-0.0290096768813534,32,37
7342,just_relax,0.8500000000000001,1,1,0,-3.899341494428242,0.107930805965535,20,20
7343,just_relax,0.8500000000000001,27,29,-2,1.1216628029648064,0.0621509067881029,12,31
7344,just_relax,0.8500000000000001,1,0,1,57.33629948571712,0.4536298942256641,10,10
7345,just_relax,0.8500000000000001,2,0,2,86.90760418331966,0.4842731380205567,20,21
7346,just_relax,0.8500000000000001,19,21,-2,8.140342901053238,-0.0922254761026923,39,52
7347,just_relax,0.8500000000000001,313,487,-174,0.540065943798183,0.0233510407909391,42,109
7348,just_relax,0.8500000000000001,3,1,2,-8.835116657867701,-0.226646852883395,25,28
7349,just_relax,0.8500000000000001,197,297,-100,5.926064386354405,-0.1286319087956804,56,106
7350,just_relax,0.8500000000000001,504,619,-115,12.7903688776871,-0.1159681969096613,87,189
7351,just_relax,0.8500000000000001,34,50,-16,5.59619393743386,0.363505398884598,56,82
7352,just_relax,0.8500000000000001,1,1,0,-5.751608618266729,-0.3808363221486029,13,15
7353,just_relax,0.8500000000000001,98,69,29,0.6862508721351332,0.0651229910514772,36,63
7354,just_relax,0.8500000000000001,0,4,-4,-71.94121002700979,-0.1314745235421929,16,15
7355,just_relax,0.8500000000000001,0,0,0,0.0,-0.0417364906078183,67,66
7356,just_relax,0.8500000000000001,14,19,-5,17.164520903809176,-0.0775307563693992,42,60
7357,just_relax,0.8500000000000001,0,2,-2,-72.16971673962897,-0.2368300998168214,39,38
7358,just_relax,0.8500000000000001,13,11,2,4.278014677891463,0.1146338843166693,20,36
7359,just_relax,0.8500000000000001,0,0,0,0.0,-0.2745364469100625,10,9
7360,just_relax,0.8500000000000001,1,1,0,11.849998424967438,0.3020581338039365,13,15
7361,just_relax,0.8500000000000001,13,26,-13,4.128659674027787,0.0090228515099294,34,41
7362,just_relax,0.8500000000000001,9,4,5,20.77892737326844,-0.225763328628935,37,42
7363,just_relax,0.8500000000000001,30,22,8,3.720798127669241,0.2618073591985926,18,29
7364,just_relax,0.8500000000000001,4,0,4,79.1376760775521,0.2326586623014443,23,22
7365,just_relax,0.8500000000000001,0,0,0,0.0,0.1347294566696716,13,12
7366,just_relax,0.8500000000000001,1,1,0,7.944402499965676,-0.1260383048683085,15,14
7367,just_relax,0.8500000000000001,0,0,0,0.0,-0.1658931318575387,69,68
7368,just_relax,0.8500000000000001,0,0,0,0.0,0.3349306475389842,40,39
7369,just_relax,0.8500000000000001,2,12,-10,-14.315837442933478,-0.3381239887388635,89,93
7370,just_relax,0.8500000000000001,12,10,2,20.13011222646489,-0.1526612079326039,20,32
7371,just_relax,0.8500000000000001,3,0,3,66.75651794053199,-0.3659802492112899,69,83
7372,just_relax,0.8500000000000001,3,1,2,-7.096265220050356,0.0990566829799772,12,15
7373,just_relax,0.8500000000000001,0,0,0,0.0,0.3070639340212003,15,14
7374,just_relax,0.8500000000000001,1,0,1,86.8783005762576,0.0692586282663186,23,26
7375,just_relax,0.8500000000000001,2,5,-3,8.405973039268787,0.2835916454313531,12,20
7376,just_relax,0.8500000000000001,215,233,-18,4.868398658225729,-0.0293995914263442,64,122
7377,just_relax,0.8500000000000001,7,25,-18,5.16296925561992,0.1122113235862992,58,71
7378,just_relax,0.8500000000000001,0,0,0,0.0,-0.2322821485603637,20,19
7379,just_relax,0.8500000000000001,390,386,4,3.753017595782275,-0.1283129792677255,100,191
7380,just_relax,0.8500000000000001,42,43,-1,6.660213022036373,0.2798202608208133,41,61
7381,just_relax,0.8500000000000001,24,44,-20,17.11757731844402,0.0538695503049535,13,31
7382,just_relax,0.8500000000000001,2,4,-2,46.660378907805885,-0.0786669594569632,10,15
7383,just_relax,0.8500000000000001,7,11,-4,10.684735125230482,0.2555287470381753,37,47
7384,just_relax,0.8500000000000001,1,5,-4,31.228828787017648,-0.059648409663108,21,21
7385,just_relax,0.8500000000000001,0,0,0,0.0,-0.126657691686314,11,10
7386,just_relax,0.8500000000000001,52,55,-3,-5.757020576466296,-0.4624563770738017,44,80
7387,just_relax,0.8500000000000001,3,2,1,-2.071591030812144,-0.3827260433425504,12,21
7388,just_relax,0.8500000000000001,6,1,5,-31.93501287068873,0.2610688419405642,37,43
7389,just_relax,0.8500000000000001,8,19,-11,-0.7679322911253124,-0.4139348387115502,41,52
7390,just_relax,0.8500000000000001,0,9,-9,-50.81000315450384,-0.0513287851847739,90,89
7391,just_relax,0.8500000000000001,0,0,0,0.0,-0.2811093859907563,22,21
7392,just_relax,0.8500000000000001,6,6,0,16.98256203745121,-0.2605821503570646,37,43
7393,just_relax,0.8500000000000001,2,4,-2,41.7818190299948,0.0586509920962857,47,47
7394,just_relax,0.8500000000000001,4,4,0,9.588605866858783,0.2662358756173211,12,20
7395,just_relax,0.8500000000000001,108,120,-12,-0.7049906991239823,0.0442098661194724,84,124
7396,just_relax,0.8500000000000001,0,2,-2,-48.59040687851161,-0.439430790946879,88,92
7397,just_relax,0.8500000000000001,357,363,-6,-1.5358501528716957,0.0453073905378086,59,122
7398,just_relax,0.8500000000000001,4,2,2,2.3105608711353227,0.2338205430805237,26,31
7399,just_relax,0.8500000000000001,0,0,0,0.0,-0.2645868309707937,28,27
7400,just_relax,0.8500000000000001,2,2,0,-24.859288432508627,-0.1699114384755156,18,26
7401,just_relax,0.8500000000000001,1,5,-4,18.34959902345633,-0.2007318521463813,23,26
7402,just_relax,0.8500000000000001,0,1,-1,-6.499183709764278,0.1769462294216754,43,43
7403,just_relax,0.8500000000000001,2,8,-6,-1.6834806469111925,-0.3648961154623111,22,26
7404,just_relax,0.8500000000000001,0,0,0,0.0,0.0858326394173021,15,14
7405,just_relax,0.8500000000000001,11,15,-4,-0.1082842701787356,-0.0913907882907377,36,48
7406,just_relax,0.8500000000000001,15,7,8,-4.852180638413351,-0.0564467795332125,30,37
7407,just_relax,0.8500000000000001,2,2,0,9.69657951169306,0.1355487577806663,10,13
7408,just_relax,0.8500000000000001,0,0,0,0.0,-0.1695624267784003,12,11
7409,just_relax,0.8500000000000001,208,224,-16,1.249700117563144,-0.1651957157929724,55,105
7410,just_relax,0.8500000000000001,2,2,0,-27.07676400217902,-0.1828408525251166,13,17
7411,just_relax,0.8500000000000001,0,2,-2,-59.27805082826365,-0.1695490059652817,30,29
7412,just_relax,0.8500000000000001,4,4,0,20.2527847678756,-0.0688744116428308,36,43
7413,just_relax,0.8500000000000001,30,41,-11,12.442284139279508,-0.2948071177856727,40,60
7414,just_relax,0.8500000000000001,0,5,-5,-76.07407858990814,0.3286504722056083,13,17
7415,just_relax,0.8500000000000001,7,7,0,0.9575505763972316,-0.1367918659301118,23,30
7416,just_relax,0.8500000000000001,0,4,-4,-60.00308731360172,0.327189758272544,12,16
7417,just_relax,0.8500000000000001,0,0,0,0.0,0.1098466291434083,26,26
7418,just_relax,0.8500000000000001,0,3,-3,-64.55566638645526,0.1729582578004591,22,31
7419,just_relax,0.8500000000000001,1,0,1,78.75376652741504,0.0200023217370693,68,68
7420,just_relax,0.8500000000000001,0,0,0,0.0,-0.0071529473448226,23,22
7421,just_relax,0.8500000000000001,0,7,-7,-70.12933012697482,0.0164645567927583,43,42
7422,just_relax,0.8500000000000001,1,0,1,80.52780329728245,0.1518403812917664,18,17
7423,just_relax,0.8500000000000001,10,9,1,4.579850831968329,0.1201860329809284,28,42
7424,just_relax,0.8500000000000001,51,42,9,-3.859511456123229,-0.1306459687404531,21,44
7425,just_relax,0.8500000000000001,0,2,-2,-49.32782571755287,-0.0297075944048624,36,37
7426,just_relax,0.8500000000000001,0,0,0,0.0,-0.0198087586479177,15,14
7427,just_relax,0.8500000000000001,0,0,0,0.0,-0.1365128299573775,14,16
7428,just_relax,0.8500000000000001,219,212,7,-0.0202505633257459,0.0740997381922028,61,119
7429,just_relax,0.8500000000000001,0,0,0,0.0,-0.269050135210409,19,20
7430,just_relax,0.8500000000000001,6,1,5,36.71199459469127,0.0646895735166163,22,22
7431,just_relax,0.8500000000000001,7,6,1,17.125267144329868,-0.3137170014390957,54,58
7432,just_relax,0.8500000000000001,571,616,-45,5.260587155461266,0.1190928963359896,65,135
7433,just_relax,0.8500000000000001,1,1,0,-1.8748235213913915,0.0786489629796295,16,18
7434,just_relax,0.8500000000000001,10,9,1,3.029170885305064,0.0952005301411516,17,27
7435,just_relax,0.8500000000000001,13,8,5,-2.5183749521949608,0.1860203132691888,54,71
7436,just_relax,0.8500000000000001,3,0,3,71.8329466577453,-0.1440278851687683,23,22
7437,just_relax,0.8500000000000001,1,1,0,-21.73192040017832,-0.3024729797389526,13,16
7438,just_relax,0.8500000000000001,168,219,-51,-0.4993724916278097,-0.1245246006882069,85,131
7439,just_relax,0.8500000000000001,29,50,-21,3.2443268971008337,0.0422085475389508,28,55
7440,just_relax,0.8500000000000001,1,7,-6,-6.6435184876440445,0.0897730089967427,18,24
7441,just_relax,0.8500000000000001,1,1,0,39.00245890845949,-0.1079744340137489,19,22
7442,just_relax,0.8500000000000001,4,5,-1,8.436650310980752,0.0956468888223879,47,46
7443,just_relax,0.8500000000000001,41,46,-5,7.123942685621998,0.2177009483239578,39,64
7444,just_relax,0.8500000000000001,0,1,-1,-66.22180972633245,-0.2292376743104479,17,18
7445,just_relax,0.8500000000000001,2,1,1,-0.4979341632894147,-0.3184909257531317,23,24
7446,just_relax,0.8500000000000001,3,1,2,7.63308713441188,0.3676066772815925,13,16
7447,just_relax,0.8500000000000001,22,31,-9,-1.5335293548414484,-0.0750700767373636,40,56
7448,just_relax,0.8500000000000001,1,1,0,1.107098915272957,0.4506783298013986,10,15
7449,just_relax,0.8500000000000001,0,1,-1,-86.99058663113355,0.4068212674814865,21,20
7450,just_relax,0.8500000000000001,2,7,-5,13.08861647646355,-0.1574492446028408,30,35
7451,just_relax,0.8500000000000001,4,4,0,-4.97928430977737,-0.3298068659752322,71,77
7452,relax_and_recompute,0.9,5,0,5,79.36848016465304,0.0391526244038338,17,18
7453,relax_and_recompute,0.9,8,7,1,-13.872410513516256,-0.2389078103223116,43,48
7454,relax_and_recompute,0.9,15,3,12,-11.94998925345586,-0.2276756986053372,38,45
7455,relax_and_recompute,0.9,0,0,0,0.0,0.1415363350506611,12,12
7456,relax_and_recompute,0.9,42,8,34,-10.346540934658634,0.2559747181487994,23,38
7457,relax_and_recompute,0.9,1,1,0,-7.355873572510845,-0.2901006945606147,19,22
7458,relax_and_recompute,0.9,912,852,60,-2.5243840893236893,-0.0529990451187503,35,143
7459,relax_and_recompute,0.9,1,1,0,2.4442177934584066,0.1062149049126429,92,91
7460,relax_and_recompute,0.9,3,2,1,-16.869258440371937,0.166052287854171,43,51
7461,relax_and_recompute,0.9,3,6,-3,20.97881529043726,0.0969506197294786,35,36
7462,relax_and_recompute,0.9,0,0,0,0.0,-0.4945470683138482,11,13
7463,relax_and_recompute,0.9,16,22,-6,2.818966208799111,0.151031000029852,10,25
7464,relax_and_recompute,0.9,33,15,18,-11.322851918357046,0.0151342831127738,86,136
7465,relax_and_recompute,0.9,1,0,1,39.03550671589574,0.0029097448935148,10,12
7466,relax_and_recompute,0.9,0,0,0,0.0,0.0240674804056068,32,31
7467,relax_and_recompute,0.9,9,2,7,-15.358418134171416,-0.0915305786077702,20,26
7468,relax_and_recompute,0.9,0,0,0,0.0,-0.1974559134306361,11,11
7469,relax_and_recompute,0.9,4,1,3,-36.238775743308494,0.0717996977782609,34,42
7470,relax_and_recompute,0.9,16,10,6,-7.9322502911832515,0.4057143821249682,14,25
7471,relax_and_recompute,0.9,9,10,-1,-2.3543157842479303,0.1311447890881767,31,46
7472,relax_and_recompute,0.9,4,1,3,0.6743333728033747,0.0210333480843216,42,45
7473,relax_and_recompute,0.9,1076,1196,-120,0.8056673337193843,-0.0782943113060117,39,173
7474,relax_and_recompute,0.9,8,8,0,-0.412833233555375,0.3486391045441393,14,24
7475,relax_and_recompute,0.9,1,1,0,-28.53464558926721,-0.1046260809915785,24,25
7476,relax_and_recompute,0.9,2,4,-2,15.08442026153594,0.4826178792340382,12,19
7477,relax_and_recompute,0.9,62,73,-11,-0.3439306787585678,-0.2463618943446796,41,72
7478,relax_and_recompute,0.9,159,238,-79,-1.1615765986149285,-0.0682667272839609,59,115
7479,relax_and_recompute,0.9,10,5,5,-7.942540861714157,-0.4382061138929797,32,37
7480,relax_and_recompute,0.9,0,0,0,0.0,0.0409151862613237,20,20
7481,relax_and_recompute,0.9,23,26,-3,1.354798995174633,0.1304956739196426,12,31
7482,relax_and_recompute,0.9,0,0,0,0.0,0.2266356690167815,10,10
7483,relax_and_recompute,0.9,2,0,2,82.9663833948536,0.6251617815560568,20,21
7484,relax_and_recompute,0.9,18,14,4,1.192016508842542,0.0477048110643266,39,52
7485,relax_and_recompute,0.9,386,295,91,-1.4715969271024392,0.1911849147766078,42,109
7486,relax_and_recompute,0.9,3,2,1,0.9584759710568562,-0.3209799551703406,25,28
7487,relax_and_recompute,0.9,191,161,30,3.0147364468052373,-0.1192523199401812,56,106
7488,relax_and_recompute,0.9,503,436,67,-0.43748568897783,-0.1048359946585851,87,189
7489,relax_and_recompute,0.9,29,48,-19,11.498949344168786,-0.0203253517168838,56,82
7490,relax_and_recompute,0.9,1,1,0,-15.089807642769117,-0.0994975713264068,13,15
7491,relax_and_recompute,0.9,73,95,-22,-0.1506816891174907,-0.0014102761824241,36,63
7492,relax_and_recompute,0.9,0,0,0,0.0,-0.0110579207088784,16,15
7493,relax_and_recompute,0.9,0,0,0,0.0,0.48269705299021,67,66
7494,relax_and_recompute,0.9,16,21,-5,-17.30496965373382,-0.2522552419796753,42,60
7495,relax_and_recompute,0.9,1,0,1,84.89888139564968,0.081322918129806,39,38
7496,relax_and_recompute,0.9,10,11,-1,-3.782457913894035,0.0800008713787046,20,36
7497,relax_and_recompute,0.9,0,0,0,0.0,0.0767646667665592,10,9
7498,relax_and_recompute,0.9,2,0,2,56.66252683726852,0.0033765002962939,13,15
7499,relax_and_recompute,0.9,12,5,7,4.475869744439571,-0.0141334102901792,34,41
7500,relax_and_recompute,0.9,7,4,3,0.6915518913344982,0.0619330552109361,37,42
7501,relax_and_recompute,0.9,22,26,-4,3.232033198481816,-0.27709577661906,18,29
7502,relax_and_recompute,0.9,8,1,7,-25.44433972142759,0.1191834632268475,23,22
7503,relax_and_recompute,0.9,0,0,0,0.0,0.0297948260752546,13,12
7504,relax_and_recompute,0.9,0,0,0,0.0,0.1153722514273594,15,14
7505,relax_and_recompute,0.9,13,0,13,49.12674436361354,-0.2255012256291904,69,68
7506,relax_and_recompute,0.9,0,0,0,0.0,0.0881819691045929,40,39
7507,relax_and_recompute,0.9,1,15,-14,22.680600451081503,0.2414679591897491,89,93
7508,relax_and_recompute,0.9,13,9,4,0.6499925580604469,-0.0033983762386121,20,32
7509,relax_and_recompute,0.9,5,3,2,-13.40492557848836,-0.2047501362637968,69,83
7510,relax_and_recompute,0.9,6,3,3,21.17375079478804,0.3816220075659045,12,15
7511,relax_and_recompute,0.9,0,1,-1,-80.09411737836567,-0.4634364534843331,15,14
7512,relax_and_recompute,0.9,3,0,3,61.26684961771495,0.1737487729138151,23,26
7513,relax_and_recompute,0.9,3,16,-13,-0.3224168872091937,0.154358055234953,12,20
7514,relax_and_recompute,0.9,223,244,-21,-2.24575365543528,-0.0552792134908429,64,122
7515,relax_and_recompute,0.9,18,11,7,-1.2996003401361875,0.0294323384202621,58,71
7516,relax_and_recompute,0.9,0,0,0,0.0,0.1818560182966406,20,19
7517,relax_and_recompute,0.9,411,320,91,2.397308743262592,0.2093214010315426,100,191
7518,relax_and_recompute,0.9,39,36,3,-2.690461206782288,0.0399159565910678,41,61
7519,relax_and_recompute,0.9,35,26,9,1.0627940449415263,-0.281423461277495,13,31
7520,relax_and_recompute,0.9,6,4,2,4.848378393685053,0.329851961498724,10,15
7521,relax_and_recompute,0.9,24,11,13,-5.405816801371586,-0.1658470581779285,37,47
7522,relax_and_recompute,0.9,0,1,-1,-89.11971585592805,-0.1408278740961711,21,21
7523,relax_and_recompute,0.9,0,1,-1,-74.44291102445668,0.0720770722623808,11,10
7524,relax_and_recompute,0.9,42,44,-2,-4.876794013059509,0.1276482700184786,44,80
7525,relax_and_recompute,0.9,4,3,1,-4.505782378345202,-0.2242800472737676,12,21
7526,relax_and_recompute,0.9,1,9,-8,-13.96048610586346,-0.0829624988069964,37,43
7527,relax_and_recompute,0.9,13,17,-4,-1.076450012707582,-0.0011585132807195,41,52
7528,relax_and_recompute,0.9,0,0,0,0.0,0.2472741100070875,90,89
7529,relax_and_recompute,0.9,0,0,0,0.0,-0.3193922843483688,22,21
7530,relax_and_recompute,0.9,3,3,0,-15.16223890682884,-0.3493289655848985,37,43
7531,relax_and_recompute,0.9,1,2,-1,-14.437868951243397,-0.1246802582441862,47,47
7532,relax_and_recompute,0.9,4,6,-2,20.60503498781606,0.2258763508520678,12,20
7533,relax_and_recompute,0.9,134,127,7,1.2149428540847822,-0.0266055745635021,84,124
7534,relax_and_recompute,0.9,0,4,-4,-69.49783301185164,0.1343681378692346,88,92
7535,relax_and_recompute,0.9,377,324,53,-1.3947940790273634,0.0712061649045375,59,122
7536,relax_and_recompute,0.9,3,7,-4,13.631171154095632,0.0674252224982832,26,31
7537,relax_and_recompute,0.9,0,0,0,0.0,-0.1688740088030514,28,27
7538,relax_and_recompute,0.9,8,14,-6,-1.9336968536984005,-0.0099110975086222,18,26
7539,relax_and_recompute,0.9,2,2,0,0.166535644450434,-0.1845581675945886,23,26
7540,relax_and_recompute,0.9,1,1,0,0.2036682927150224,0.0880259383624497,43,43
7541,relax_and_recompute,0.9,3,4,-1,-4.29559547459796,0.024442131111722,22,26
7542,relax_and_recompute,0.9,0,0,0,0.0,-0.0461485046232202,15,14
7543,relax_and_recompute,0.9,14,9,5,1.902147199755781,-0.0566102698897229,36,48
7544,relax_and_recompute,0.9,8,4,4,0.3907974011372062,0.1161495964243936,30,37
7545,relax_and_recompute,0.9,1,3,-2,12.189924283754737,0.0729003233715118,10,13
7546,relax_and_recompute,0.9,1,0,1,88.96601556276087,-0.3418516281809221,12,11
7547,relax_and_recompute,0.9,254,145,109,-1.831369392240788,-0.0321127082219394,55,105
7548,relax_and_recompute,0.9,1,1,0,20.352883906980395,0.2132169068200725,13,17
7549,relax_and_recompute,0.9,0,1,-1,-56.11314107025033,0.1485569176114851,30,29
7550,relax_and_recompute,0.9,6,7,-1,0.8287547308665495,0.0221413615463286,36,43
7551,relax_and_recompute,0.9,17,15,2,0.0403318384517916,0.3398864712987218,40,60
7552,relax_and_recompute,0.9,4,1,3,5.417319934735609,0.2900737034200173,13,17
7553,relax_and_recompute,0.9,13,9,4,-1.85363246158488,-0.0081032542004723,23,30
7554,relax_and_recompute,0.9,4,0,4,65.21512178401278,-0.0143523816303416,12,16
7555,relax_and_recompute,0.9,0,0,0,0.0,-0.3925057659832447,26,26
7556,relax_and_recompute,0.9,1,0,1,49.155622226976966,0.3263988542221601,22,31
7557,relax_and_recompute,0.9,2,0,2,41.24174878677699,0.117493071539246,68,68
7558,relax_and_recompute,0.9,0,0,0,0.0,-0.0436400630991266,23,22
7559,relax_and_recompute,0.9,0,0,0,0.0,-0.0217202890779268,43,42
7560,relax_and_recompute,0.9,1,0,1,71.67292891063084,0.3204761270052872,18,17
7561,relax_and_recompute,0.9,6,4,2,4.536535956836246,0.1600645131342032,28,42
7562,relax_and_recompute,0.9,56,45,11,6.185829159726843,0.0341020867644779,21,44
7563,relax_and_recompute,0.9,5,0,5,71.48693054108298,0.1056455935531318,36,37
7564,relax_and_recompute,0.9,0,0,0,0.0,0.0184243127948311,15,14
7565,relax_and_recompute,0.9,0,0,0,0.0,-0.326822079168218,14,16
7566,relax_and_recompute,0.9,223,273,-50,-0.7710733301548203,-0.1354264913487491,61,119
7567,relax_and_recompute,0.9,0,1,-1,-89.26308805851514,-0.3384204900390074,19,20
7568,relax_and_recompute,0.9,0,0,0,0.0,-0.0071306400417761,22,22
7569,relax_and_recompute,0.9,0,7,-7,-71.40844707971351,-0.1228952981839317,54,58
7570,relax_and_recompute,0.9,536,416,120,0.8490895846381363,-0.0052604380238807,65,135
7571,relax_and_recompute,0.9,2,4,-2,-4.944301526995602,-0.0316075867375259,16,18
7572,relax_and_recompute,0.9,7,10,-3,3.340788035201726,-0.0096570652639772,17,27
7573,relax_and_recompute,0.9,21,10,11,0.0682137039095778,-0.1678082203560328,54,71
7574,relax_and_recompute,0.9,0,0,0,0.0,-0.1076285473246073,23,22
7575,relax_and_recompute,0.9,7,0,7,69.46560795089538,0.3352685246648055,13,16
7576,relax_and_recompute,0.9,126,143,-17,-0.658947402326767,-0.2207669245398262,85,131
7577,relax_and_recompute,0.9,40,29,11,-4.733301189368127,-0.1103863287823921,28,55
7578,relax_and_recompute,0.9,3,8,-5,-12.466147558061778,-0.482872936059983,18,24
7579,relax_and_recompute,0.9,6,1,5,-13.701217177514948,-0.1038494216193242,19,22
7580,relax_and_recompute,0.9,1,4,-3,15.792734830489335,0.0528591313928804,47,46
7581,relax_and_recompute,0.9,37,20,17,2.643935016804015,-0.0099533811922283,39,64
7582,relax_and_recompute,0.9,0,0,0,0.0,0.0145111816013302,17,18
7583,relax_and_recompute,0.9,2,1,1,10.867303226855384,-0.1770539636817468,23,24
7584,relax_and_recompute,0.9,2,0,2,65.05096674018989,0.0143123051069076,13,16
7585,relax_and_recompute,0.9,28,22,6,7.792126077775507,0.1765916317155549,40,56
7586,relax_and_recompute,0.9,2,0,2,87.58918109731609,0.0363782930613957,10,15
7587,relax_and_recompute,0.9,2,1,1,-9.606107176409663,0.2690950921064672,21,20
7588,relax_and_recompute,0.9,9,4,5,-12.646007031725226,-0.1528577080888508,30,35
7589,relax_and_recompute,0.9,3,3,0,10.2842600440744,0.3674458895211799,71,77
7590,relax_one,0.9,5,0,5,62.76153723219336,-0.3041845539103732,17,18
7591,relax_one,0.9,6,2,4,40.83151019315702,0.0935487610375332,43,48
7592,relax_one,0.9,28,2,26,-2.8381279901105074,-0.2974768422857164,38,45
7593,relax_one,0.9,1,0,1,80.27685500236898,-0.1073660428094777,12,12
7594,relax_one,0.9,5,11,-6,0.8855216182453916,0.4176640468470656,23,38
7595,relax_one,0.9,1,0,1,64.44567618718318,-0.0623529275298371,19,22
7596,relax_one,0.9,816,825,-9,2.3918778523847664,0.1481097053761747,35,143
7597,relax_one,0.9,1,3,-2,1.0346478194659596,0.0860855683075378,92,91
7598,relax_one,0.9,11,8,3,11.385049584012036,0.0198726855732938,43,51
7599,relax_one,0.9,2,3,-1,-0.5123628436722782,0.0100848182025323,35,36
7600,relax_one,0.9,0,0,0,0.0,-0.0626175286244696,11,13
7601,relax_one,0.9,23,11,12,9.084194381917968,0.0030529858227741,10,25
7602,relax_one,0.9,16,15,1,-1.2658731544938746,-0.0098823773638092,86,136
7603,relax_one,0.9,1,0,1,79.78594651241174,-0.3767819183289616,10,12
7604,relax_one,0.9,0,0,0,0.0,0.049785852305992,32,31
7605,relax_one,0.9,5,5,0,1.9450008405330408,-0.1873787994877472,20,26
7606,relax_one,0.9,0,0,0,0.0,-0.3474344850299428,11,11
7607,relax_one,0.9,1,2,-1,23.64847043981804,0.0293757420632909,34,42
7608,relax_one,0.9,10,12,-2,0.4716927026050257,0.0349748506498357,14,25
7609,relax_one,0.9,7,12,-5,16.99315520277763,-0.1198080327562821,31,46
7610,relax_one,0.9,7,1,6,2.6549406571027845,-0.1547437243547601,42,45
7611,relax_one,0.9,1114,1082,32,0.6071871202528101,0.0984925153916856,39,173
7612,relax_one,0.9,10,9,1,8.944306310445143,0.5936089217675018,14,24
7613,relax_one,0.9,4,0,4,52.82257089844919,-0.0850866668756522,24,25
7614,relax_one,0.9,1,1,0,25.92322843476108,0.3613866808852697,12,19
7615,relax_one,0.9,65,53,12,-4.933774698910753,0.0438090471972464,41,72
7616,relax_one,0.9,226,203,23,-0.3260283753423252,-0.165361272611091,59,115
7617,relax_one,0.9,5,3,2,0.859252229742971,0.3519751528455215,32,37
7618,relax_one,0.9,0,1,-1,-82.0192438258857,-0.1063411433534294,20,20
7619,relax_one,0.9,24,23,1,2.582064588452269,0.1356442286389785,12,31
7620,relax_one,0.9,1,2,-1,61.01463938533263,0.0394720266415511,10,10
7621,relax_one,0.9,0,2,-2,-76.49429509098589,-0.2168695042240229,20,21
7622,relax_one,0.9,36,11,25,-10.261486576329808,-0.1463682104838329,39,52
7623,relax_one,0.9,337,313,24,0.9850896674330089,-0.3459221455988556,42,109
7624,relax_one,0.9,2,7,-5,3.820099593507379,0.2030203264214827,25,28
7625,relax_one,0.9,184,171,13,0.2111628723052092,0.0976193609219533,56,106
7626,relax_one,0.9,506,450,56,-0.4094591718745164,-0.1106917404129802,87,189
7627,relax_one,0.9,85,51,34,-2.140482096410849,0.2849810389353212,56,82
7628,relax_one,0.9,2,1,1,-21.30263609107466,0.1523594375977504,13,15
7629,relax_one,0.9,112,92,20,-1.058699897512632,0.4092135602174986,36,63
7630,relax_one,0.9,1,0,1,84.8871730874388,-0.0341473732833742,16,15
7631,relax_one,0.9,0,0,0,0.0,0.0682469665105109,67,66
7632,relax_one,0.9,27,16,11,-0.7577227643225939,0.2581543998094216,42,60
7633,relax_one,0.9,5,0,5,66.70881107049271,-0.2174469990169512,39,38
7634,relax_one,0.9,11,11,0,6.554361106919387,0.2362149761240914,20,36
7635,relax_one,0.9,0,0,0,0.0,0.011484630818966,10,9
7636,relax_one,0.9,0,0,0,0.0,-0.1911581511183812,13,15
7637,relax_one,0.9,10,8,2,-0.4245324477635108,-0.0526399714870621,34,41
7638,relax_one,0.9,3,10,-7,8.618365511428578,0.1297857469071082,37,42
7639,relax_one,0.9,27,13,14,0.8405090847332275,0.3533626501037699,18,29
7640,relax_one,0.9,2,0,2,84.55321028938255,-0.129302557874737,23,22
7641,relax_one,0.9,0,0,0,0.0,0.3310946891080479,13,12
7642,relax_one,0.9,0,0,0,0.0,-0.2027212457425344,15,14
7643,relax_one,0.9,1,1,0,-14.943388655999357,-0.29675659643252,69,68
7644,relax_one,0.9,1,0,1,81.75596855812118,-0.2277019967592164,40,39
7645,relax_one,0.9,3,5,-2,-2.8126600745825243,0.1816977741806759,89,93
7646,relax_one,0.9,9,10,-1,-14.5442975592159,-0.1000055264470307,20,32
7647,relax_one,0.9,1,1,0,24.07386074102544,0.1908037848782798,69,83
7648,relax_one,0.9,2,2,0,10.243673180707844,-0.0796011196450886,12,15
7649,relax_one,0.9,0,0,0,0.0,-0.1269225837194508,15,14
7650,relax_one,0.9,2,13,-11,-8.080338725631535,0.1239177230766366,23,26
7651,relax_one,0.9,8,6,2,8.83847220858025,0.2623021237732809,12,20
7652,relax_one,0.9,232,202,30,0.1834643963203035,0.2611406840026653,64,122
7653,relax_one,0.9,11,6,5,-10.919940191644171,-0.2811821459960827,58,71
7654,relax_one,0.9,0,0,0,0.0,0.1716628627102961,20,19
7655,relax_one,0.9,454,307,147,-1.032735502008208,0.0204016673976509,100,191
7656,relax_one,0.9,26,24,2,-7.290088804937213,-0.0636998375940033,41,61
7657,relax_one,0.9,18,22,-4,6.686486097772246,0.1556560249398267,13,31
7658,relax_one,0.9,2,3,-1,19.19300231402409,0.1341714161550642,10,15
7659,relax_one,0.9,16,10,6,-5.421742612955718,-0.2473110293414274,37,47
7660,relax_one,0.9,1,1,0,-0.6399522416086256,-0.0904253278110962,21,21
7661,relax_one,0.9,2,0,2,77.27856224201888,-0.4917400833000424,11,10
7662,relax_one,0.9,43,56,-13,6.138768579087873,-0.219363929090337,44,80
7663,relax_one,0.9,2,2,0,-5.219116551036535,-0.1605292869442672,12,21
7664,relax_one,0.9,7,4,3,4.810570547393063,-0.0911782007871939,37,43
7665,relax_one,0.9,25,23,2,5.788913007345229,-0.077493821764671,41,52
7666,relax_one,0.9,0,0,0,0.0,-0.0728908736414732,90,89
7667,relax_one,0.9,0,0,0,0.0,0.1710432867396338,22,21
7668,relax_one,0.9,8,3,5,-20.068612176981567,-0.1327431603506528,37,43
7669,relax_one,0.9,4,3,1,-16.898321631368105,-0.2778023094745546,47,47
7670,relax_one,0.9,4,4,0,-6.320233861395607,0.2154050461243117,12,20
7671,relax_one,0.9,137,106,31,-2.577258268566389,0.0796729861562459,84,124
7672,relax_one,0.9,0,0,0,0.0,-0.1089565737377796,88,92
7673,relax_one,0.9,345,368,-23,0.3635346069259171,0.1451590597609631,59,122
7674,relax_one,0.9,2,8,-6,13.94902047806788,-0.0919237180526283,26,31
7675,relax_one,0.9,4,0,4,59.29011161218524,-0.2292313194899222,28,27
7676,relax_one,0.9,3,3,0,19.84004519655474,-0.135856679879761,18,26
7677,relax_one,0.9,10,3,7,-8.25247586005456,0.3498943074467175,23,26
7678,relax_one,0.9,2,0,2,82.53749109278779,0.1069632228079765,43,43
7679,relax_one,0.9,2,2,0,0.398152409616074,0.0906998196107664,22,26
7680,relax_one,0.9,0,0,0,0.0,0.4136933999303014,15,14
7681,relax_one,0.9,13,16,-3,-6.021112672915351,-0.0274830602427872,36,48
7682,relax_one,0.9,3,10,-7,-5.970626244439238,0.0606416303424863,30,37
7683,relax_one,0.9,2,2,0,15.653597494537353,-0.2168459924278484,10,13
7684,relax_one,0.9,0,0,0,0.0,-0.1184625635814512,12,11
7685,relax_one,0.9,202,224,-22,-0.7146111326742925,0.0183878991619307,55,105
7686,relax_one,0.9,0,2,-2,-69.08003871524889,0.2519216551995088,13,17
7687,relax_one,0.9,1,3,-2,-1.4476687520789395,0.1136194011089527,30,29
7688,relax_one,0.9,8,1,7,0.2814010102909634,0.1497926234242957,36,43
7689,relax_one,0.9,18,16,2,9.075677442464553,-0.2281748914103976,40,60
7690,relax_one,0.9,2,1,1,36.43390331385015,-0.0666550871250608,13,17
7691,relax_one,0.9,5,8,-3,-2.153031327240143,0.1916782569172561,23,30
7692,relax_one,0.9,0,1,-1,-37.65327274202326,-0.2666498207699592,12,16
7693,relax_one,0.9,0,2,-2,-61.70976378390506,-0.0869174532875762,26,26
7694,relax_one,0.9,1,1,0,-5.283627055739373,-0.0341184413268429,22,31
7695,relax_one,0.9,0,0,0,0.0,-0.0764162581908561,68,68
7696,relax_one,0.9,0,0,0,0.0,-0.0594083612677037,23,22
7697,relax_one,0.9,0,0,0,0.0,-0.0501762762225157,43,42
7698,relax_one,0.9,0,0,0,0.0,-0.3039672418352617,18,17
7699,relax_one,0.9,32,5,27,-7.351107452428394,-0.0608970699511626,28,42
7700,relax_one,0.9,36,47,-11,3.141517157802852,-0.0788132184808686,21,44
7701,relax_one,0.9,2,2,0,13.215183201353923,-0.2838652541031667,36,37
7702,relax_one,0.9,0,0,0,0.0,-0.1376239084413308,15,14
7703,relax_one,0.9,3,0,3,70.81824305965672,0.0796654265431899,14,16
7704,relax_one,0.9,238,191,47,-0.7971897463688151,0.2120149547668247,61,119
7705,relax_one,0.9,2,0,2,82.68463327588329,0.3511390456632021,19,20
7706,relax_one,0.9,0,2,-2,-61.63510426348285,0.599319501561868,22,22
7707,relax_one,0.9,1,0,1,79.64978351760153,-0.3809703767759755,54,58
7708,relax_one,0.9,418,411,7,-0.297822490669958,-0.2960331885649435,65,135
7709,relax_one,0.9,0,1,-1,-87.42293007968931,0.0847703124541819,16,18
7710,relax_one,0.9,6,7,-1,-8.666332357846741,0.2903682926826754,17,27
7711,relax_one,0.9,25,5,20,-7.168103759906458,0.1480706699464028,54,71
7712,relax_one,0.9,0,6,-6,-58.383883095051935,-0.1247463749110515,23,22
7713,relax_one,0.9,1,0,1,79.1109637172288,-0.0088968929150311,13,16
7714,relax_one,0.9,149,142,7,0.6018375104478579,0.1742949305159368,85,131
7715,relax_one,0.9,36,55,-19,3.77605099569972,0.0024894374941122,28,55
7716,relax_one,0.9,1,3,-2,1.8850607139647195,0.0455426975664852,18,24
7717,relax_one,0.9,2,1,1,-0.945409847053,0.3443495244870831,19,22
7718,relax_one,0.9,1,1,0,3.7417067014277294,0.1912559167851484,47,46
7719,relax_one,0.9,39,26,13,-1.1300333922898034,-0.0389407627550555,39,64
7720,relax_one,0.9,0,0,0,0.0,-0.1922083472501689,17,18
7721,relax_one,0.9,2,1,1,6.757180889596896,-0.5124873858954357,23,24
7722,relax_one,0.9,3,1,2,-10.48614678654262,0.0104118952792415,13,16
7723,relax_one,0.9,8,7,1,2.49499524961589,-0.149521942224965,40,56
7724,relax_one,0.9,1,0,1,86.65230895224892,-0.3536358992751216,10,15
7725,relax_one,0.9,0,0,0,0.0,0.0904204162576084,21,20
7726,relax_one,0.9,3,3,0,5.106763062196549,0.4874829683325981,30,35
7727,relax_one,0.9,5,4,1,19.609234894298588,0.0596204963362154,71,77
7728,just_relax,0.9,0,0,0,0.0,0.3263041931778679,17,18
7729,just_relax,0.9,9,16,-7,6.245049099352791,-0.2372739589215515,43,48
7730,just_relax,0.9,19,4,15,-10.369484236063428,0.1425705044391414,38,45
7731,just_relax,0.9,1,0,1,56.77750883903165,-0.3083963748363146,12,12
7732,just_relax,0.9,23,31,-8,7.722139085557792,0.0321707291772049,23,38
7733,just_relax,0.9,0,0,0,0.0,-0.2386180676475525,19,22
7734,just_relax,0.9,739,771,-32,-1.0984086299638562,-0.0038689346248647,35,143
7735,just_relax,0.9,3,4,-1,13.097957094960124,-0.1860617252407032,92,91
7736,just_relax,0.9,2,29,-27,-24.55195840771896,-0.0118351466348565,43,51
7737,just_relax,0.9,4,0,4,72.50768801828056,0.0052433351368558,35,36
7738,just_relax,0.9,0,0,0,0.0,0.0601645774586614,11,13
7739,just_relax,0.9,25,26,-1,8.095425026826518,-0.0009083260826289,10,25
7740,just_relax,0.9,19,40,-21,3.609144771931362,-0.055045058718732,86,136
7741,just_relax,0.9,0,0,0,0.0,-0.0396783447174901,10,12
7742,just_relax,0.9,0,0,0,0.0,0.0496011521976998,32,31
7743,just_relax,0.9,6,7,-1,-0.6843880725389226,-0.0903456584725618,20,26
7744,just_relax,0.9,0,0,0,0.0,0.0397579529113465,11,11
7745,just_relax,0.9,5,18,-13,8.869609487465112,-0.0786588468223582,34,42
7746,just_relax,0.9,11,15,-4,17.03012055063178,-0.045655391278412,14,25
7747,just_relax,0.9,7,14,-7,6.932589909665289,-0.0879198258966641,31,46
7748,just_relax,0.9,0,5,-5,-42.1320127619186,-0.2487421834374323,42,45
7749,just_relax,0.9,1173,1161,12,0.8843816138129554,0.1203578844400877,39,173
7750,just_relax,0.9,12,8,4,-4.425598082379253,0.239434556332082,14,24
7751,just_relax,0.9,0,0,0,0.0,-0.3587620991115692,24,25
7752,just_relax,0.9,2,1,1,-2.401007622248187,0.1232311532657748,12,19
7753,just_relax,0.9,77,56,21,3.5454692607267404,-0.0115229184281704,41,72
7754,just_relax,0.9,187,180,7,0.5718938883042739,-0.2882379761743153,59,115
7755,just_relax,0.9,3,6,-3,-9.60004877351048,-0.2672007621346395,32,37
7756,just_relax,0.9,1,0,1,83.83746904323239,-0.1540835980931491,20,20
7757,just_relax,0.9,24,29,-5,1.2995085939196969,0.0177016462376936,12,31
7758,just_relax,0.9,0,0,0,0.0,-0.0255677890803529,10,10
7759,just_relax,0.9,0,1,-1,-54.879132413540574,0.1335149461841182,20,21
7760,just_relax,0.9,25,29,-4,2.6455357734509946,-0.1702883826523542,39,52
7761,just_relax,0.9,374,367,7,1.392309988707524,0.2941155739269864,42,109
7762,just_relax,0.9,1,0,1,75.49109613926096,-0.0453230232385799,25,28
7763,just_relax,0.9,180,259,-79,3.345990112278784,0.2401892379691503,56,106
7764,just_relax,0.9,461,657,-196,7.082222703817209,-0.0869221695739635,87,189
7765,just_relax,0.9,44,26,18,0.4386001216661128,0.1919011875907826,56,82
7766,just_relax,0.9,2,1,1,-34.0829116628626,0.1885020389188803,13,15
7767,just_relax,0.9,97,88,9,9.228723477215688,-0.1174959130286188,36,63
7768,just_relax,0.9,0,0,0,0.0,-0.266312799949891,16,15
7769,just_relax,0.9,0,0,0,0.0,0.3810555816988782,67,66
7770,just_relax,0.9,16,21,-5,-3.502295313132052,-0.0501275880042357,42,60
7771,just_relax,0.9,1,2,-1,5.7689603547181605,-0.1830633003161107,39,38
7772,just_relax,0.9,11,11,0,9.524415653557114,0.5570204453712604,20,36
7773,just_relax,0.9,0,1,-1,-75.48796714614055,0.3377594462493054,10,9
7774,just_relax,0.9,3,1,2,16.787254735539292,0.0161688240510619,13,15
7775,just_relax,0.9,9,12,-3,-1.937153473534608,0.1624867541449097,34,41
7776,just_relax,0.9,5,3,2,-19.06591636264045,-0.0433722684242099,37,42
7777,just_relax,0.9,32,22,10,-3.7623213027760016,0.2343077180664357,18,29
7778,just_relax,0.9,2,1,1,18.91215261705092,-0.2205527072358041,23,22
7779,just_relax,0.9,0,0,0,0.0,-0.2002252981184459,13,12
7780,just_relax,0.9,0,0,0,0.0,0.5527726878182322,15,14
7781,just_relax,0.9,0,0,0,0.0,-0.1715072985086947,69,68
7782,just_relax,0.9,0,0,0,0.0,-0.3046828647755577,40,39
7783,just_relax,0.9,0,3,-3,-59.8416108640453,-0.2149016357212839,89,93
7784,just_relax,0.9,12,15,-3,16.291729346711108,0.0550470258840886,20,32
7785,just_relax,0.9,2,2,0,-13.077411664255637,0.0675681670051776,69,83
7786,just_relax,0.9,0,2,-2,-69.51628387689405,0.0919462939839923,12,15
7787,just_relax,0.9,2,1,1,-17.689388900157596,0.2973651006491369,15,14
7788,just_relax,0.9,2,1,1,-13.62557376649866,0.2883793859546307,23,26
7789,just_relax,0.9,4,2,2,-7.556503207874769,0.4800106519611119,12,20
7790,just_relax,0.9,236,222,14,1.8786802589851843,0.4238531628607992,64,122
7791,just_relax,0.9,2,17,-15,6.552262980368724,-0.3203928256289226,58,71
7792,just_relax,0.9,0,0,0,0.0,-0.1092098216066514,20,19
7793,just_relax,0.9,258,361,-103,6.406232352934197,0.0252321213344732,100,191
7794,just_relax,0.9,34,36,-2,8.247540608288958,-0.1294657091828119,41,61
7795,just_relax,0.9,24,47,-23,8.092374212216427,-0.2160694494415139,13,31
7796,just_relax,0.9,3,6,-3,11.482129481889691,-0.28550885513091,10,15
7797,just_relax,0.9,7,9,-2,-1.7194818402408885,0.1614390968375335,37,47
7798,just_relax,0.9,0,0,0,0.0,-0.3259675508624319,21,21
7799,just_relax,0.9,0,0,0,0.0,-0.0170925311790427,11,10
7800,just_relax,0.9,44,41,3,7.661036885274676,0.1695426347414436,44,80
7801,just_relax,0.9,2,3,-1,13.2402357182674,0.2894201086604521,12,21
7802,just_relax,0.9,1,3,-2,46.78022639041495,0.0148196458431981,37,43
7803,just_relax,0.9,19,8,11,-4.198402582449766,-0.0751929331450527,41,52
7804,just_relax,0.9,0,0,0,0.0,-0.0992403342749653,90,89
7805,just_relax,0.9,1,0,1,68.00108464911969,-0.032005437164692,22,21
7806,just_relax,0.9,5,0,5,62.43686090556847,-0.208646186160514,37,43
7807,just_relax,0.9,0,6,-6,-52.53817579983798,0.1955039837184746,47,47
7808,just_relax,0.9,5,14,-9,10.88945796986615,0.3321470954976645,12,20
7809,just_relax,0.9,113,135,-22,-0.5064612320052078,-0.2557227025663927,84,124
7810,just_relax,0.9,0,4,-4,-44.77709559068071,0.0100989203845874,88,92
7811,just_relax,0.9,311,360,-49,3.1560512094192674,0.0790261388283611,59,122
7812,just_relax,0.9,2,2,0,-26.73141181668388,-0.2316632298550571,26,31
7813,just_relax,0.9,0,0,0,0.0,-0.3823585924528589,28,27
7814,just_relax,0.9,10,2,8,-10.436277813757258,0.0440003343255845,18,26
7815,just_relax,0.9,2,4,-2,-4.098168373526747,0.1145623063289085,23,26
7816,just_relax,0.9,0,2,-2,-29.77636707863501,-0.0272015217190706,43,43
7817,just_relax,0.9,6,5,1,11.90383653854868,0.0243939462934258,22,26
7818,just_relax,0.9,0,0,0,0.0,0.2279649198162593,15,14
7819,just_relax,0.9,23,8,15,-11.474872642796823,-0.1662664022896943,36,48
7820,just_relax,0.9,17,11,6,2.472064787354455,0.557252708888787,30,37
7821,just_relax,0.9,3,4,-1,-2.381189541924215,-0.0645637463738058,10,13
7822,just_relax,0.9,0,0,0,0.0,-0.2428376360307182,12,11
7823,just_relax,0.9,193,177,16,0.4192197964045974,0.1970926985566309,55,105
7824,just_relax,0.9,0,5,-5,-69.62087760117184,0.6108354346850198,13,17
7825,just_relax,0.9,0,0,0,0.0,-0.0042955843014028,30,29
7826,just_relax,0.9,10,4,6,-10.6294767245191,0.1633283823155583,36,43
7827,just_relax,0.9,18,29,-11,12.580675998504743,-0.1080212530695715,40,60
7828,just_relax,0.9,2,1,1,-13.727702130658123,0.2278143898819904,13,17
7829,just_relax,0.9,6,6,0,8.984878647306815,-0.3282452036002327,23,30
7830,just_relax,0.9,0,5,-5,-47.41573384233732,-0.0170740156381087,12,16
7831,just_relax,0.9,2,0,2,66.1878065436849,-0.3575305362964649,26,26
7832,just_relax,0.9,1,1,0,-1.051520193266434,-0.2319132410150418,22,31
7833,just_relax,0.9,7,2,5,22.86192557899988,-0.3144960752009894,68,68
7834,just_relax,0.9,0,0,0,0.0,-0.1018204736815249,23,22
7835,just_relax,0.9,0,9,-9,-38.128119210247526,0.1999918762658534,43,42
7836,just_relax,0.9,1,0,1,77.36817665760823,0.2544024235566948,18,17
7837,just_relax,0.9,24,12,12,-6.221405067315622,0.102557379808074,28,42
7838,just_relax,0.9,46,45,1,1.157268928293831,0.0633069357892056,21,44
7839,just_relax,0.9,4,8,-4,8.418675439112832,0.2264292636618298,36,37
7840,just_relax,0.9,0,0,0,0.0,0.0232782347819907,15,14
7841,just_relax,0.9,0,0,0,0.0,-0.0786713876293689,14,16
7842,just_relax,0.9,198,225,-27,1.6488892523337029,-0.0488557576434975,61,119
7843,just_relax,0.9,0,2,-2,-56.00684667666684,0.3653185942216282,19,20
7844,just_relax,0.9,7,1,6,30.565699285557,0.016179208530769,22,22
7845,just_relax,0.9,5,3,2,46.87401657886659,-0.0245079795171289,54,58
7846,just_relax,0.9,426,823,-397,7.013946168801205,-0.0411191109897961,65,135
7847,just_relax,0.9,1,0,1,72.96410604613108,-0.2827271437674009,16,18
7848,just_relax,0.9,7,8,-1,1.357697155563386,-0.1095519408898287,17,27
7849,just_relax,0.9,9,10,-1,5.477346600682289,-0.102814265176838,54,71
7850,just_relax,0.9,0,4,-4,-77.96404128249668,-0.1504243122765357,23,22
7851,just_relax,0.9,2,0,2,72.85903784240841,-0.3068382548527505,13,16
7852,just_relax,0.9,196,280,-84,1.2143206439329788,0.1091500421000039,85,131
7853,just_relax,0.9,51,46,5,-7.088627854764333,0.0876030662640718,28,55
7854,just_relax,0.9,1,4,-3,6.939698197738437,0.0310513201166235,18,24
7855,just_relax,0.9,2,1,1,4.313357533296028,-0.1534219318536601,19,22
7856,just_relax,0.9,1,1,0,-1.154567984046949,0.1613929045894767,47,46
7857,just_relax,0.9,40,84,-44,4.541949053758124,-0.1280352384081337,39,64
7858,just_relax,0.9,3,0,3,71.00124029851261,0.3956457266176799,17,18
7859,just_relax,0.9,2,1,1,-13.518167411462995,0.0090516047196235,23,24
7860,just_relax,0.9,1,6,-5,8.803243452754288,0.1218033980363924,13,16
7861,just_relax,0.9,12,49,-37,-0.6035270773311225,0.0418877454709374,40,56
7862,just_relax,0.9,1,0,1,76.67031318402339,-0.0050461086402479,10,15
7863,just_relax,0.9,1,1,0,-18.01075489742322,0.2796681191236799,21,20
7864,just_relax,0.9,4,3,1,4.289169222728695,-0.0505431744570143,30,35
7865,just_relax,0.9,3,3,0,9.112375125641982,-0.4380225163284792,71,77
7866,relax_and_recompute,0.95,0,0,0,0.0,0.1211521054617332,17,18
7867,relax_and_recompute,0.95,9,3,6,18.325743258792635,0.0301142832595426,43,48
7868,relax_and_recompute,0.95,10,7,3,-10.488173727414264,0.027923357491166,38,45
7869,relax_and_recompute,0.95,0,0,0,0.0,-0.179958815466023,12,12
7870,relax_and_recompute,0.95,10,15,-5,-6.0925361377817495,0.0146469995807649,23,38
7871,relax_and_recompute,0.95,6,0,6,70.03184827103492,0.1562576004864395,19,22
7872,relax_and_recompute,0.95,909,860,49,0.7163929269504408,-0.2218613214043018,35,143
7873,relax_and_recompute,0.95,3,5,-2,10.72334269175564,-0.2460714547789902,92,91
7874,relax_and_recompute,0.95,2,8,-6,-21.94146002268669,-0.0050028423646685,43,51
7875,relax_and_recompute,0.95,4,0,4,69.11367528382218,0.4860414618148594,35,36
7876,relax_and_recompute,0.95,0,0,0,0.0,-0.1807182369809192,11,13
7877,relax_and_recompute,0.95,20,20,0,-1.8566801801171096,-0.0711343120919675,10,25
7878,relax_and_recompute,0.95,18,23,-5,1.478994935704705,-0.0185013754983014,86,136
7879,relax_and_recompute,0.95,0,0,0,0.0,0.1335287355850501,10,12
7880,relax_and_recompute,0.95,0,0,0,0.0,0.01329640975268,32,31
7881,relax_and_recompute,0.95,3,7,-4,12.505094131154536,-0.0893935066479471,20,26
7882,relax_and_recompute,0.95,0,0,0,0.0,-0.3548921226283446,11,11
7883,relax_and_recompute,0.95,3,4,-1,5.815089845537358,-0.2454834286129306,34,42
7884,relax_and_recompute,0.95,14,13,1,-1.1702779517594737,0.0245581503056853,14,25
7885,relax_and_recompute,0.95,8,7,1,-14.221649125399267,-0.1111797191072336,31,46
7886,relax_and_recompute,0.95,2,0,2,83.47837468550802,0.2752632074358256,42,45
7887,relax_and_recompute,0.95,1261,1080,181,-0.7490820016862259,-0.2884685624049187,39,173
7888,relax_and_recompute,0.95,7,14,-7,-0.6793334090238545,-0.5589011750189873,14,24
7889,relax_and_recompute,0.95,1,1,0,-27.32361289994602,0.1735004090819976,24,25
7890,relax_and_recompute,0.95,2,1,1,-5.377949812545765,-0.5747098132565964,12,19
7891,relax_and_recompute,0.95,64,65,-1,-3.7743993144163497,0.1443045143207885,41,72
7892,relax_and_recompute,0.95,222,190,32,-1.034101559992877,-0.0595284176117187,59,115
7893,relax_and_recompute,0.95,6,8,-2,19.06351695935321,-0.205879982003731,32,37
7894,relax_and_recompute,0.95,0,1,-1,-54.60783007124843,-0.1852089543580571,20,20
7895,relax_and_recompute,0.95,26,40,-14,5.4833489836659695,0.0375441982254987,12,31
7896,relax_and_recompute,0.95,0,0,0,0.0,0.0678052331361455,10,10
7897,relax_and_recompute,0.95,2,1,1,-9.354434624120742,0.1042508786536156,20,21
7898,relax_and_recompute,0.95,21,32,-11,1.791098905606901,-0.1789620901475872,39,52
7899,relax_and_recompute,0.95,350,344,6,-0.3825643197258728,0.1562648979660781,42,109
7900,relax_and_recompute,0.95,1,1,0,-31.05404015912056,0.0304764929559216,25,28
7901,relax_and_recompute,0.95,238,204,34,1.0592672555135607,0.1880056101638934,56,106
7902,relax_and_recompute,0.95,465,546,-81,1.1639112992814376,-0.0671380264364795,87,189
7903,relax_and_recompute,0.95,34,70,-36,2.558176174756568,0.0049232277084826,56,82
7904,relax_and_recompute,0.95,1,2,-1,18.853949717055173,0.3850616355921746,13,15
7905,relax_and_recompute,0.95,86,67,19,-4.497418538872012,-0.2198978685348951,36,63
7906,relax_and_recompute,0.95,1,2,-1,26.78083774472013,-0.1751102557650212,16,15
7907,relax_and_recompute,0.95,0,0,0,0.0,0.0965950346296807,67,66
7908,relax_and_recompute,0.95,17,27,-10,3.503708512561282,-0.168176056884394,42,60
7909,relax_and_recompute,0.95,1,0,1,50.15877623107853,-0.1843462684579776,39,38
7910,relax_and_recompute,0.95,17,11,6,1.064197946665331,-0.5461301048832218,20,36
7911,relax_and_recompute,0.95,0,0,0,0.0,0.1356845341824922,10,9
7912,relax_and_recompute,0.95,2,0,2,81.42485117314817,0.0123852996987315,13,15
7913,relax_and_recompute,0.95,15,8,7,4.053160050760425,-0.0932055331757262,34,41
7914,relax_and_recompute,0.95,4,4,0,2.821948340955842,0.2561318602247784,37,42
7915,relax_and_recompute,0.95,21,24,-3,-4.679936043504895,-0.0727646240419606,18,29
7916,relax_and_recompute,0.95,0,2,-2,-78.44038906259573,-0.0995069165388521,23,22
7917,relax_and_recompute,0.95,0,0,0,0.0,0.2953843936558171,13,12
7918,relax_and_recompute,0.95,0,0,0,0.0,0.0824169358654038,15,14
7919,relax_and_recompute,0.95,12,0,12,58.18155922154108,0.0411870580191675,69,68
7920,relax_and_recompute,0.95,0,0,0,0.0,0.0725140492619912,40,39
7921,relax_and_recompute,0.95,0,0,0,0.0,-0.2151839439959511,89,93
7922,relax_and_recompute,0.95,10,15,-5,4.593311561946976,-0.1011892124525107,20,32
7923,relax_and_recompute,0.95,5,5,0,-12.520549394192711,0.1282347841216773,69,83
7924,relax_and_recompute,0.95,1,2,-1,5.425527906466456,-0.1107219243862536,12,15
7925,relax_and_recompute,0.95,0,2,-2,-80.77885493787122,0.246850815657688,15,14
7926,relax_and_recompute,0.95,1,2,-1,0.3615961799474547,0.0590575767344567,23,26
7927,relax_and_recompute,0.95,4,3,1,21.885170640422807,-0.041090153394858,12,20
7928,relax_and_recompute,0.95,234,193,41,-1.324511265790285,0.053918849560693,64,122
7929,relax_and_recompute,0.95,7,12,-5,4.750568467131643,-0.019906922892127,58,71
7930,relax_and_recompute,0.95,0,0,0,0.0,0.0586539666064699,20,19
7931,relax_and_recompute,0.95,307,279,28,-2.7629094283010147,0.0771236175235735,100,191
7932,relax_and_recompute,0.95,37,41,-4,-0.4530412929454712,-0.0876518322165553,41,61
7933,relax_and_recompute,0.95,34,22,12,-0.7050538163320255,-0.0570404095799924,13,31
7934,relax_and_recompute,0.95,7,4,3,-7.705770477576976,-0.1373982390886124,10,15
7935,relax_and_recompute,0.95,18,11,7,3.125997407674234,-0.12853767394655,37,47
7936,relax_and_recompute,0.95,1,0,1,89.76683778999863,0.3732902332604441,21,21
7937,relax_and_recompute,0.95,0,0,0,0.0,0.1894134967786334,11,10
7938,relax_and_recompute,0.95,48,61,-13,7.903318588378475,0.3429829348351455,44,80
7939,relax_and_recompute,0.95,2,6,-4,-0.7310180781732214,0.0592557912909859,12,21
7940,relax_and_recompute,0.95,0,2,-2,-53.31644401331405,-0.0843141978512631,37,43
7941,relax_and_recompute,0.95,8,13,-5,0.1481663678713261,-0.1396884799839362,41,52
7942,relax_and_recompute,0.95,0,1,-1,-83.76034555092131,-0.0962516711782685,90,89
7943,relax_and_recompute,0.95,0,0,0,0.0,0.3978273855375787,22,21
7944,relax_and_recompute,0.95,4,13,-9,12.056796940166691,-0.0233133698523801,37,43
7945,relax_and_recompute,0.95,2,1,1,-29.595918835475743,0.0195049759391043,47,47
7946,relax_and_recompute,0.95,4,7,-3,23.18560677153286,-0.2890606072731023,12,20
7947,relax_and_recompute,0.95,115,137,-22,-0.094911975729687,-0.1063234816243441,84,124
7948,relax_and_recompute,0.95,5,1,4,21.831770063441724,0.0573730826590812,88,92
7949,relax_and_recompute,0.95,382,346,36,0.6795049421958339,0.0634951793117258,59,122
7950,relax_and_recompute,0.95,3,4,-1,13.490303765910582,0.3141423284060683,26,31
7951,relax_and_recompute,0.95,0,0,0,0.0,-0.1682483881913276,28,27
7952,relax_and_recompute,0.95,1,4,-3,-17.876855950303636,-0.2512105575097882,18,26
7953,relax_and_recompute,0.95,7,2,5,-2.94605138448307,-0.3422033423567503,23,26
7954,relax_and_recompute,0.95,2,7,-5,10.799929886819156,-0.0483073783222254,43,43
7955,relax_and_recompute,0.95,1,1,0,-34.171361737726066,-0.0902903685882526,22,26
7956,relax_and_recompute,0.95,0,0,0,0.0,0.0706467594161437,15,14
7957,relax_and_recompute,0.95,13,17,-4,-4.747434600935932,-0.0969708204410756,36,48
7958,relax_and_recompute,0.95,8,9,-1,11.08020416269705,0.0549990691096444,30,37
7959,relax_and_recompute,0.95,1,6,-5,11.245745517723016,0.2181466909812226,10,13
7960,relax_and_recompute,0.95,0,0,0,0.0,-0.5521234442255666,12,11
7961,relax_and_recompute,0.95,196,199,-3,-0.1911716722205412,-0.0105748992823606,55,105
7962,relax_and_recompute,0.95,4,2,2,-3.5009817434646493,-0.0186317898981435,13,17
7963,relax_and_recompute,0.95,1,1,0,16.668124333299232,0.2886581284736361,30,29
7964,relax_and_recompute,0.95,7,12,-5,-4.546415968178891,-0.0115148762838821,36,43
7965,relax_and_recompute,0.95,30,26,4,2.8444760347046127,0.0646806751199237,40,60
7966,relax_and_recompute,0.95,1,0,1,42.12101211948223,-0.221384357549278,13,17
7967,relax_and_recompute,0.95,14,10,4,-3.029176776933056,-0.4037978825608277,23,30
7968,relax_and_recompute,0.95,3,1,2,-6.836282557177469,-0.0810247038035975,12,16
7969,relax_and_recompute,0.95,1,2,-1,17.389081167075773,-0.4472028208514254,26,26
7970,relax_and_recompute,0.95,2,2,0,-4.331762484715441,-0.1965414370320696,22,31
7971,relax_and_recompute,0.95,0,0,0,0.0,0.0483056666808919,68,68
7972,relax_and_recompute,0.95,0,0,0,0.0,-0.0262976874061496,23,22
7973,relax_and_recompute,0.95,0,1,-1,-36.077564297731776,-0.1708126869047566,43,42
7974,relax_and_recompute,0.95,1,0,1,82.28390773040614,0.0840905513529206,18,17
7975,relax_and_recompute,0.95,2,1,1,-7.770093377780199,0.1272190225432078,28,42
7976,relax_and_recompute,0.95,48,43,5,1.7217330661084276,-0.2737940232411024,21,44
7977,relax_and_recompute,0.95,0,0,0,0.0,-0.09430283322497,36,37
7978,relax_and_recompute,0.95,0,0,0,0.0,-0.0056601896428268,15,14
7979,relax_and_recompute,0.95,1,3,-2,5.597255361602109,0.4678754984648947,14,16
7980,relax_and_recompute,0.95,252,255,-3,-0.5364661086099431,-0.169067024383566,61,119
7981,relax_and_recompute,0.95,1,1,0,-1.6416660811574957,-0.1032151101948364,19,20
7982,relax_and_recompute,0.95,0,3,-3,-77.72653026166567,0.0845254242729116,22,22
7983,relax_and_recompute,0.95,1,3,-2,-0.1862943810187687,0.084505317162719,54,58
7984,relax_and_recompute,0.95,427,404,23,-0.1406836208581126,-0.0576838384582437,65,135
7985,relax_and_recompute,0.95,1,0,1,83.05144137088755,0.3353920847710447,16,18
7986,relax_and_recompute,0.95,13,7,6,-6.222360240759663,-0.2837239667274269,17,27
7987,relax_and_recompute,0.95,10,25,-15,6.503544868790357,-0.1037270935402668,54,71
7988,relax_and_recompute,0.95,1,0,1,77.02968925395456,-0.0236013976266258,23,22
7989,relax_and_recompute,0.95,1,2,-1,19.20903811501463,0.2566270970430559,13,16
7990,relax_and_recompute,0.95,108,200,-92,0.048860121248218,0.0119041316422076,85,131
7991,relax_and_recompute,0.95,49,78,-29,1.0563105190775843,-0.1988217631525367,28,55
7992,relax_and_recompute,0.95,2,15,-13,-14.315752918989986,-0.0622734282685693,18,24
7993,relax_and_recompute,0.95,1,1,0,1.4661303017910967,0.077584946596894,19,22
7994,relax_and_recompute,0.95,1,6,-5,11.615100663298549,0.2061774968282735,47,46
7995,relax_and_recompute,0.95,53,60,-7,1.446090044288752,-0.207143259638133,39,64
7996,relax_and_recompute,0.95,0,1,-1,-79.40778961295719,-0.4072226385555015,17,18
7997,relax_and_recompute,0.95,2,2,0,-9.14292390689998,0.1626149340501037,23,24
7998,relax_and_recompute,0.95,1,0,1,69.95829776882557,-0.1492647225503385,13,16
7999,relax_and_recompute,0.95,20,31,-11,5.603876134830813,-0.0632761150916974,40,56
8000,relax_and_recompute,0.95,0,2,-2,-64.56895575741069,0.1014109948958797,10,15
8001,relax_and_recompute,0.95,0,2,-2,-67.21725108773981,-0.0710057827973146,21,20
8002,relax_and_recompute,0.95,2,1,1,16.532497547020355,0.3177339312143838,30,35
8003,relax_and_recompute,0.95,2,2,0,-0.4658214457036251,0.386218041730029,71,77
8004,relax_one,0.95,2,1,1,9.22268384175844,0.291797876119383,17,18
8005,relax_one,0.95,14,5,9,1.994805534441895,0.3503987718997553,43,48
8006,relax_one,0.95,7,3,4,0.8509760210962583,-0.2909165202189583,38,45
8007,relax_one,0.95,0,0,0,0.0,-0.3971015727504776,12,12
8008,relax_one,0.95,18,12,6,-6.173164879090777,0.0370542379664924,23,38
8009,relax_one,0.95,1,1,0,9.504195461359146,0.0170149556968773,19,22
8010,relax_one,0.95,1012,788,224,-0.2485064216775399,0.271549025252166,35,143
8011,relax_one,0.95,2,2,0,-1.6477971118091972,-0.231285359812136,92,91
8012,relax_one,0.95,13,2,11,16.938565442807686,0.1476675374754614,43,51
8013,relax_one,0.95,2,1,1,-3.793653638434691,-0.1235232572764377,35,36
8014,relax_one,0.95,1,2,-1,-3.2821068440470498,0.2123456236388832,11,13
8015,relax_one,0.95,19,17,2,-3.765396792820056,0.021124560019711,10,25
8016,relax_one,0.95,25,38,-13,-5.133624385747929,0.0715230395456808,86,136
8017,relax_one,0.95,0,0,0,0.0,-0.1615744273626902,10,12
8018,relax_one,0.95,0,0,0,0.0,-0.0157725808015213,32,31
8019,relax_one,0.95,2,4,-2,-11.65240546635279,0.2179239582801803,20,26
8020,relax_one,0.95,0,0,0,0.0,0.3371485299411965,11,11
8021,relax_one,0.95,3,2,1,2.523217286415104,-0.2857459489218644,34,42
8022,relax_one,0.95,9,11,-2,1.5962114904007052,-0.0214114607213194,14,25
8023,relax_one,0.95,4,8,-4,2.8359616833856123,-0.0023004922239515,31,46
8024,relax_one,0.95,6,0,6,72.38901733169796,-0.244554172635516,42,45
8025,relax_one,0.95,1143,1067,76,1.0987310580995313,0.0658053095364521,39,173
8026,relax_one,0.95,11,11,0,2.2560479096249537,-0.2256342262414825,14,24
8027,relax_one,0.95,0,1,-1,-52.56164421575118,-0.0190073856916518,24,25
8028,relax_one,0.95,6,1,5,-15.918346571792611,-0.4122614031057685,12,19
8029,relax_one,0.95,67,66,1,2.0728777778196203,0.1247295900785043,41,72
8030,relax_one,0.95,236,150,86,1.022666407076521,-0.0179380690293744,59,115
8031,relax_one,0.95,12,7,5,5.071955549267614,-0.0267004330289168,32,37
8032,relax_one,0.95,1,0,1,89.36481921108575,0.2300686435760375,20,20
8033,relax_one,0.95,24,26,-2,-5.389568157053262,0.0735668228768259,12,31
8034,relax_one,0.95,0,1,-1,-66.83962183255804,-0.3081477243019869,10,10
8035,relax_one,0.95,3,0,3,85.36931213078033,0.0431657332709046,20,21
8036,relax_one,0.95,23,32,-9,2.054725087939076,0.1551859506098724,39,52
8037,relax_one,0.95,338,328,10,2.5168403482766597,-0.2424193525204961,42,109
8038,relax_one,0.95,1,2,-1,-2.708579535714506,0.2369743027809528,25,28
8039,relax_one,0.95,160,199,-39,-0.710800985513977,-0.0593546346328591,56,106
8040,relax_one,0.95,425,404,21,-0.608680650717524,0.0364283029378477,87,189
8041,relax_one,0.95,44,48,-4,3.077064378793878,0.286036760924219,56,82
8042,relax_one,0.95,2,1,1,-30.7495959588041,0.3707693829919286,13,15
8043,relax_one,0.95,68,64,4,-4.79129374609262,-0.168743167733535,36,63
8044,relax_one,0.95,0,0,0,0.0,0.1166440420295401,16,15
8045,relax_one,0.95,0,0,0,0.0,-0.0500821713759997,67,66
8046,relax_one,0.95,12,14,-2,-1.4935073740720242,-0.0125521239896313,42,60
8047,relax_one,0.95,0,0,0,0.0,0.0990859094538647,39,38
8048,relax_one,0.95,11,12,-1,-2.944748808367152,-0.2783559623870989,20,36
8049,relax_one,0.95,0,0,0,0.0,-0.0249168502773741,10,9
8050,relax_one,0.95,5,1,4,7.494643151004723,-0.1128029743481849,13,15
8051,relax_one,0.95,6,7,-1,-5.860318998477126,0.1171009736674631,34,41
8052,relax_one,0.95,4,7,-3,3.840182098186048,0.372950030781054,37,42
8053,relax_one,0.95,15,25,-10,-5.804849526078243,0.1802947009929992,18,29
8054,relax_one,0.95,3,0,3,67.16468985887947,0.1782741626259776,23,22
8055,relax_one,0.95,0,0,0,0.0,-0.3649151979320106,13,12
8056,relax_one,0.95,0,0,0,0.0,0.1729013808250342,15,14
8057,relax_one,0.95,1,1,0,4.428289724878205,0.2658255205352327,69,68
8058,relax_one,0.95,10,0,10,59.52654333813759,-0.1922666848795476,40,39
8059,relax_one,0.95,0,1,-1,-35.30302855682014,0.5101951313290578,89,93
8060,relax_one,0.95,12,11,1,-6.382999365172438,-0.2815647620246072,20,32
8061,relax_one,0.95,4,5,-1,-4.832783658290964,-0.0040750943484586,69,83
8062,relax_one,0.95,2,0,2,68.2686424292735,0.0593132407690633,12,15
8063,relax_one,0.95,1,0,1,67.61972492254219,0.0218745487459988,15,14
8064,relax_one,0.95,3,3,0,-16.332680271878644,-0.0355260884186554,23,26
8065,relax_one,0.95,2,2,0,7.813451284730732,-0.0275775457557448,12,20
8066,relax_one,0.95,249,190,59,3.1965718946342747,0.1615974556791733,64,122
8067,relax_one,0.95,22,2,20,13.49956529795034,0.0155195582966698,58,71
8068,relax_one,0.95,0,0,0,0.0,0.1798649402130596,20,19
8069,relax_one,0.95,310,305,5,-5.424653645730338,-0.1782706657506045,100,191
8070,relax_one,0.95,27,23,4,1.4547788709262832,-0.2724529843796175,41,61
8071,relax_one,0.95,27,33,-6,-1.0522895289600314,-0.185661193873957,13,31
8072,relax_one,0.95,6,3,3,-2.029042299086541,-0.0359579730123486,10,15
8073,relax_one,0.95,15,14,1,4.390024778960409,-0.3843132774932271,37,47
8074,relax_one,0.95,0,1,-1,-72.48080569910194,0.1116272096581831,21,21
8075,relax_one,0.95,0,0,0,0.0,-0.4020387127286297,11,10
8076,relax_one,0.95,39,48,-9,-5.944140254525919,0.1200351117783016,44,80
8077,relax_one,0.95,3,6,-3,19.155606807033188,0.3794698518833588,12,21
8078,relax_one,0.95,2,1,1,6.823079159904609,-0.4805554099515393,37,43
8079,relax_one,0.95,4,14,-10,3.450885199648525,0.0734761584330174,41,52
8080,relax_one,0.95,3,0,3,76.75516363159508,0.1216607403528988,90,89
8081,relax_one,0.95,0,0,0,0.0,0.3304472520049312,22,21
8082,relax_one,0.95,4,3,1,4.977026169061652,-0.0728002588545668,37,43
8083,relax_one,0.95,0,0,0,0.0,0.0620922268160638,47,47
8084,relax_one,0.95,4,6,-2,24.728694863413963,0.2999163895080606,12,20
8085,relax_one,0.95,116,129,-13,-0.6916178828686199,0.3044995356723726,84,124
8086,relax_one,0.95,0,1,-1,-81.83765849186453,0.1487722798140258,88,92
8087,relax_one,0.95,358,274,84,1.5768044439680369,0.0940435139430092,59,122
8088,relax_one,0.95,3,4,-1,-1.8550299790785372,-0.1030106766465525,26,31
8089,relax_one,0.95,0,0,0,0.0,-0.1075805725512308,28,27
8090,relax_one,0.95,3,2,1,43.6225996397298,0.0371339006661969,18,26
8091,relax_one,0.95,4,1,3,-13.541810204198534,0.1704521556587859,23,26
8092,relax_one,0.95,1,0,1,89.48265600842844,-0.0379625983080456,43,43
8093,relax_one,0.95,1,2,-1,14.085509043790111,0.2619530265163216,22,26
8094,relax_one,0.95,0,0,0,0.0,0.2154885962450978,15,14
8095,relax_one,0.95,17,20,-3,-22.175768221533424,0.2446874668510494,36,48
8096,relax_one,0.95,14,4,10,-13.82122215982973,0.1918996445633967,30,37
8097,relax_one,0.95,2,2,0,4.721752538899295,-0.1301644823868327,10,13
8098,relax_one,0.95,0,1,-1,-80.16102334041685,-0.0801850658853334,12,11
8099,relax_one,0.95,199,172,27,-0.3763457137703412,-0.0558461693403299,55,105
8100,relax_one,0.95,6,2,4,-3.8138051598134695,-0.1304742788533058,13,17
8101,relax_one,0.95,1,1,0,10.252485686795794,-0.000565163517236,30,29
8102,relax_one,0.95,11,1,10,-3.699064231188984,-0.0099128658962081,36,43
8103,relax_one,0.95,22,19,3,6.549798470498622,-0.1264443736604035,40,60
8104,relax_one,0.95,1,3,-2,6.651134436621547,0.5978799785529076,13,17
8105,relax_one,0.95,11,5,6,2.5352269180390365,0.3253871199216135,23,30
8106,relax_one,0.95,0,1,-1,-43.253156919330735,-0.1927917809325012,12,16
8107,relax_one,0.95,0,0,0,0.0,-0.1765772685843873,26,26
8108,relax_one,0.95,1,0,1,57.12081512457422,0.3963987903925218,22,31
8109,relax_one,0.95,0,3,-3,-70.00773092787153,-0.0264950288055522,68,68
8110,relax_one,0.95,0,0,0,0.0,0.0400097366671609,23,22
8111,relax_one,0.95,0,1,-1,-29.255864950501994,-0.2253812605833149,43,42
8112,relax_one,0.95,0,1,-1,-44.64808154442951,-0.1105638245914985,18,17
8113,relax_one,0.95,9,7,2,-5.119124712086091,0.1931892499177859,28,42
8114,relax_one,0.95,52,46,6,2.893983874162359,-0.0976689485249279,21,44
8115,relax_one,0.95,2,0,2,78.24541625129336,-0.5282455499420081,36,37
8116,relax_one,0.95,0,0,0,0.0,-0.2181196564181151,15,14
8117,relax_one,0.95,1,0,1,80.38766974158335,-0.1490199845840207,14,16
8118,relax_one,0.95,253,192,61,-1.6424641611702882,0.0371911337079379,61,119
8119,relax_one,0.95,0,3,-3,-71.52360577144053,0.1309678481524944,19,20
8120,relax_one,0.95,0,0,0,0.0,0.1523488410945821,22,22
8121,relax_one,0.95,4,0,4,62.04464852147524,-0.4324805206109093,54,58
8122,relax_one,0.95,513,429,84,-2.129587595857423,0.0613669201737179,65,135
8123,relax_one,0.95,0,0,0,0.0,0.1432591131963607,16,18
8124,relax_one,0.95,7,7,0,12.603630896918972,0.3198602894196259,17,27
8125,relax_one,0.95,13,14,-1,3.7255250101026007,-0.1781499652706877,54,71
8126,relax_one,0.95,0,0,0,0.0,-0.0915625009903483,23,22
8127,relax_one,0.95,3,2,1,18.37074690796732,-0.2728752741629494,13,16
8128,relax_one,0.95,132,211,-79,0.6927898795582692,-0.1140912204366797,85,131
8129,relax_one,0.95,44,48,-4,-8.98826773670546,0.1985683866542746,28,55
8130,relax_one,0.95,3,4,-1,17.38266803715787,0.0437985961716365,18,24
8131,relax_one,0.95,1,0,1,88.75071008350297,0.1351464520701545,19,22
8132,relax_one,0.95,7,2,5,5.410346380287514,-0.0058044761168014,47,46
8133,relax_one,0.95,51,36,15,-10.792344902298574,0.0037715161753318,39,64
8134,relax_one,0.95,3,0,3,81.45092104579821,0.4388498075569086,17,18
8135,relax_one,0.95,1,1,0,-3.017333052069532,-0.1441251677378996,23,24
8136,relax_one,0.95,1,1,0,-1.1457008903668964,-0.4432269008900797,13,16
8137,relax_one,0.95,7,18,-11,-6.756563639648675,-0.0214009872357638,40,56
8138,relax_one,0.95,1,3,-2,-33.41433988792957,-0.2284031320427396,10,15
8139,relax_one,0.95,0,1,-1,-21.69604615736065,-0.0100437048364248,21,20
8140,relax_one,0.95,9,4,5,-9.259136629913527,-0.2181538170770613,30,35
8141,relax_one,0.95,4,6,-2,-9.370895296355066,-0.2015397968288572,71,77
8142,just_relax,0.9500000000000001,1,0,1,88.27731637964756,0.00289090262982572,17,18
8143,just_relax,0.9500000000000001,3,7,-4,12.693093710526597,-0.04125550327964589,43,48
8144,just_relax,0.9500000000000001,6,4,2,3.884329468955457,0.09020668537742615,38,45
8145,just_relax,0.9500000000000001,0,0,0,0.0,0.34353670343835097,12,12
8146,just_relax,0.9500000000000001,20,14,6,-6.237274598269714,-0.3280571339658165,23,38
8147,just_relax,0.9500000000000001,3,1,2,-6.401969748724191,-0.24155637139748232,19,22
8148,just_relax,0.9500000000000001,825,719,106,0.39050418655850905,-0.05431962195617779,35,143
8149,just_relax,0.9500000000000001,8,5,3,-0.5928821940483147,0.13342528800815512,92,91
8150,just_relax,0.9500000000000001,7,10,-3,29.389345447820347,-0.07260202104143398,43,51
8151,just_relax,0.9500000000000001,8,4,4,-14.584617476884844,0.1998774563167136,35,36
8152,just_relax,0.9500000000000001,0,0,0,0.0,-0.06706768118567918,11,13
8153,just_relax,0.9500000000000001,24,19,5,9.011616759813862,-0.008033310907939684,10,25
8154,just_relax,0.9500000000000001,43,31,12,5.433766803064522,0.20543804928818943,86,136
8155,just_relax,0.9500000000000001,0,0,0,0.0,0.22976064080677894,10,12
8156,just_relax,0.9500000000000001,0,0,0,0.0,0.008040984633900572,32,31
8157,just_relax,0.9500000000000001,6,19,-13,1.8669201423767419,-0.1410202682263163,20,26
8158,just_relax,0.9500000000000001,0,0,0,0.0,0.4426561723442509,11,11
8159,just_relax,0.9500000000000001,10,10,0,8.30632617832525,0.08759988872534163,34,42
8160,just_relax,0.9500000000000001,14,12,2,23.68863130225501,-0.5377419046333733,14,25
8161,just_relax,0.9500000000000001,7,5,2,-1.5720953493355978,-0.07365230600379535,31,46
8162,just_relax,0.9500000000000001,0,14,-14,-54.83905752971178,-0.12095358978893067,42,45
8163,just_relax,0.9500000000000001,1244,1101,143,-0.1488723439032711,0.05008038625591038,39,173
8164,just_relax,0.9500000000000001,12,11,1,6.057323658053981,0.1592469086434215,14,24
8165,just_relax,0.9500000000000001,0,0,0,0.0,-0.2598827546256943,24,25
8166,just_relax,0.9500000000000001,0,1,-1,-71.06162077724828,-0.18521038706416493,12,19
8167,just_relax,0.9500000000000001,82,92,-10,1.8615034404636717,-0.0778640069870381,41,72
8168,just_relax,0.9500000000000001,207,196,11,2.953725306080784,-0.039670922285017673,59,115
8169,just_relax,0.9500000000000001,5,8,-3,-5.210982535892086,0.2644080235521724,32,37
8170,just_relax,0.9500000000000001,0,0,0,0.0,0.1140590520647673,20,20
8171,just_relax,0.9500000000000001,33,23,10,-1.1909065863732593,-0.21004700213396565,12,31
8172,just_relax,0.9500000000000001,0,1,-1,-76.21782110251951,-0.2797662540003447,10,10
8173,just_relax,0.9500000000000001,2,2,0,2.037123445000077,0.12930018859726267,20,21
8174,just_relax,0.9500000000000001,31,33,-2,-3.787283853105535,0.09953995080508615,39,52
8175,just_relax,0.9500000000000001,358,325,33,0.24975021413280274,-0.03897560117970289,42,109
8176,just_relax,0.9500000000000001,1,3,-2,7.508654606604196,0.16016377848323027,25,28
8177,just_relax,0.9500000000000001,209,176,33,5.6390657119247365,0.03854643276948544,56,106
8178,just_relax,0.9500000000000001,408,855,-447,5.600623534066763,-0.23594757745820616,87,189
8179,just_relax,0.9500000000000001,57,42,15,-9.088883748403234,0.12255662500316156,56,82
8180,just_relax,0.9500000000000001,1,0,1,80.82214231508593,-0.15822312512875913,13,15
8181,just_relax,0.9500000000000001,87,130,-43,5.359052954173741,0.022701659783335604,36,63
8182,just_relax,0.9500000000000001,1,2,-1,19.291258775638852,-0.12585263661422164,16,15
8183,just_relax,0.9500000000000001,0,0,0,0.0,0.11055182222222737,67,66
8184,just_relax,0.9500000000000001,23,24,-1,14.518037509426797,-0.1641613921841354,42,60
8185,just_relax,0.9500000000000001,1,1,0,-9.798794381200452,-0.0718677939035739,39,38
8186,just_relax,0.9500000000000001,15,11,4,0.5245282767495993,0.12553899384723743,20,36
8187,just_relax,0.9500000000000001,0,0,0,0.0,-0.14532349540909484,10,9
8188,just_relax,0.9500000000000001,0,4,-4,-66.33286845196041,-0.06921284555336904,13,15
8189,just_relax,0.9500000000000001,12,9,3,-0.9166379259997512,-0.08495734529282584,34,41
8190,just_relax,0.9500000000000001,8,5,3,7.2521611551336775,0.13192185534898604,37,42
8191,just_relax,0.9500000000000001,25,19,6,-3.604193929313112,-0.20618179409012538,18,29
8192,just_relax,0.9500000000000001,0,0,0,0.0,0.3368544802816872,23,22
8193,just_relax,0.9500000000000001,0,0,0,0.0,-0.1725422863481188,13,12
8194,just_relax,0.9500000000000001,0,0,0,0.0,0.4207100443319455,15,14
8195,just_relax,0.9500000000000001,0,1,-1,-57.37109991850613,0.004519025046504033,69,68
8196,just_relax,0.9500000000000001,0,2,-2,-71.53583106102475,0.1411271531442534,40,39
8197,just_relax,0.9500000000000001,26,0,26,66.55117300240396,-0.06740695662109675,89,93
8198,just_relax,0.9500000000000001,9,10,-1,2.2885409408523287,0.050163743527830595,20,32
8199,just_relax,0.9500000000000001,3,1,2,15.249299117966999,0.06414105602463771,69,83
8200,just_relax,0.9500000000000001,2,2,0,-5.766923998670521,0.1359195246604204,12,15
8201,just_relax,0.9500000000000001,0,0,0,0.0,-0.11641899398537203,15,14
8202,just_relax,0.9500000000000001,1,0,1,75.58711164020521,-0.37017369845654013,23,26
8203,just_relax,0.9500000000000001,2,2,0,4.135159365228006,-0.06932761293818623,12,20
8204,just_relax,0.9500000000000001,252,194,58,-0.20673375896907942,0.15708743144119497,64,122
8205,just_relax,0.9500000000000001,4,39,-35,-8.86160706891593,0.1113882548786338,58,71
8206,just_relax,0.9500000000000001,1,0,1,70.91056833250686,-0.4207093424328959,20,19
8207,just_relax,0.9500000000000001,283,554,-271,3.726229967023123,-0.021842058656737606,100,191
8208,just_relax,0.9500000000000001,32,51,-19,6.457653422698257,-0.12401967300482741,41,61
8209,just_relax,0.9500000000000001,29,31,-2,-0.6257587379814709,-0.10030015444187845,13,31
8210,just_relax,0.9500000000000001,3,6,-3,8.66768211320204,0.2756095893186853,10,15
8211,just_relax,0.9500000000000001,9,9,0,-5.048516798226977,0.059205252337073744,37,47
8212,just_relax,0.9500000000000001,1,0,1,74.68004257430731,0.16033315510582535,21,21
8213,just_relax,0.9500000000000001,0,0,0,0.0,0.014884431370356888,11,10
8214,just_relax,0.9500000000000001,98,57,41,-5.486000796251965,-0.06296705577399853,44,80
8215,just_relax,0.9500000000000001,3,2,1,-0.7306317570545389,-0.316866249999164,12,21
8216,just_relax,0.9500000000000001,1,0,1,36.070638218260214,0.1834880650691445,37,43
8217,just_relax,0.9500000000000001,21,6,15,-7.057627464369688,-0.13495789365227917,41,52
8218,just_relax,0.9500000000000001,0,1,-1,-47.22069937494773,-0.01933177048763146,90,89
8219,just_relax,0.9500000000000001,0,13,-13,-58.123364691526916,0.12220257947293756,22,21
8220,just_relax,0.9500000000000001,1,3,-2,-9.751446823017787,0.16690148678958305,37,43
8221,just_relax,0.9500000000000001,3,11,-8,36.75864205933952,0.17552337110965888,47,47
8222,just_relax,0.9500000000000001,4,4,0,-6.84879569187521,0.03602219239378335,12,20
8223,just_relax,0.9500000000000001,115,150,-35,2.902957681287347,0.10092352344323197,84,124
8224,just_relax,0.9500000000000001,3,3,0,25.091393274861822,-0.007827198709286609,88,92
8225,just_relax,0.9500000000000001,359,417,-58,3.0137724628402367,-0.08565361973941599,59,122
8226,just_relax,0.9500000000000001,6,2,4,-13.513087128577197,0.04410111973474251,26,31
8227,just_relax,0.9500000000000001,0,0,0,0.0,0.2887684966473085,28,27
8228,just_relax,0.9500000000000001,5,1,4,29.53770771508941,0.2788252207425578,18,26
8229,just_relax,0.9500000000000001,3,5,-2,-4.2463007692593635,0.1145194473866511,23,26
8230,just_relax,0.9500000000000001,3,1,2,4.324584867207676,-0.03729237560977727,43,43
8231,just_relax,0.9500000000000001,1,4,-3,-19.9230349831535,0.12993077192399072,22,26
8232,just_relax,0.9500000000000001,0,0,0,0.0,0.029167643561176737,15,14
8233,just_relax,0.9500000000000001,15,14,1,-8.33638616724695,0.2703863217073953,36,48
8234,just_relax,0.9500000000000001,8,4,4,-8.110932371209785,-0.1910597471799479,30,37
8235,just_relax,0.9500000000000001,2,2,0,2.157340371020041,0.2714833783160795,10,13
8236,just_relax,0.9500000000000001,1,1,0,7.534397755556213,0.2942451080480395,12,11
8237,just_relax,0.9500000000000001,195,258,-63,0.1629996011604149,-0.08075219242906184,55,105
8238,just_relax,0.9500000000000001,4,2,2,3.0962340094989145,-0.12892872196726257,13,17
8239,just_relax,0.9500000000000001,2,0,2,74.77990490018385,-0.07763582191177054,30,29
8240,just_relax,0.9500000000000001,17,3,14,-13.69134314524058,0.23088077646886707,36,43
8241,just_relax,0.9500000000000001,20,26,-6,10.820750239725186,0.23277634581065287,40,60
8242,just_relax,0.9500000000000001,0,1,-1,-64.23690745240877,0.4266144030040826,13,17
8243,just_relax,0.9500000000000001,8,11,-3,-9.147171338447464,0.2144735953800878,23,30
8244,just_relax,0.9500000000000001,3,3,0,34.519638008572706,-0.2612707609237064,12,16
8245,just_relax,0.9500000000000001,5,0,5,67.10058219614743,-0.2547563612466027,26,26
8246,just_relax,0.9500000000000001,0,2,-2,-66.57584512152373,0.49064809105404805,22,31
8247,just_relax,0.9500000000000001,3,12,-9,-4.020756569433274,-0.13406802841128773,68,68
8248,just_relax,0.9500000000000001,0,0,0,0.0,0.1474999125925095,23,22
8249,just_relax,0.9500000000000001,0,9,-9,-55.29512636875191,0.03381624904227909,43,42
8250,just_relax,0.9500000000000001,0,0,0,0.0,-0.01449754401632497,18,17
8251,just_relax,0.9500000000000001,12,13,-1,0.39468711910706133,-0.2950927240594885,28,42
8252,just_relax,0.9500000000000001,47,59,-12,0.7207588676434682,0.15651401973779733,21,44
8253,just_relax,0.9500000000000001,0,9,-9,-59.39013417858668,0.2919257645208835,36,37
8254,just_relax,0.9500000000000001,0,0,0,0.0,-0.08010043493397978,15,14
8255,just_relax,0.9500000000000001,0,0,0,0.0,-0.029409091476773952,14,16
8256,just_relax,0.9500000000000001,234,294,-60,-1.0901517784962067,0.08229456941266877,61,119
8257,just_relax,0.9500000000000001,0,0,0,0.0,0.3189324520957144,19,20
8258,just_relax,0.9500000000000001,0,2,-2,-74.70774986775368,-0.06297544860654947,22,22
8259,just_relax,0.9500000000000001,0,17,-17,-48.17012708371145,-0.010701537911414372,54,58
8260,just_relax,0.9500000000000001,448,724,-276,7.352471953956716,-0.23844129722542662,65,135
8261,just_relax,0.9500000000000001,2,0,2,82.63064688446896,0.16182969842844452,16,18
8262,just_relax,0.9500000000000001,7,9,-2,-1.1989114279774427,0.29045625782508,17,27
8263,just_relax,0.9500000000000001,9,19,-10,0.35946483727602185,0.13475559613115318,54,71
8264,just_relax,0.9500000000000001,3,0,3,71.6815019189071,-0.15193708859188515,23,22
8265,just_relax,0.9500000000000001,4,4,0,-5.642252330860934,0.23917356116452915,13,16
8266,just_relax,0.9500000000000001,182,243,-61,4.4121719975298745,-0.18147626347121848,85,131
8267,just_relax,0.9500000000000001,29,45,-16,0.5216850668515605,0.029132268377124015,28,55
8268,just_relax,0.9500000000000001,8,8,0,4.838349106381003,0.049588536903509395,18,24
8269,just_relax,0.9500000000000001,5,1,4,-9.343217507885768,0.06538944749154818,19,22
8270,just_relax,0.9500000000000001,2,2,0,6.836470118413104,0.13278244285634466,47,46
8271,just_relax,0.9500000000000001,37,62,-25,3.9602397552323865,-0.0458572197492888,39,64
8272,just_relax,0.9500000000000001,1,0,1,85.88194700781665,-0.41527049016456163,17,18
8273,just_relax,0.9500000000000001,1,2,-1,8.403207210772862,0.2088548773529043,23,24
8274,just_relax,0.9500000000000001,3,3,0,3.2907417155098813,-0.17146467403478927,13,16
8275,just_relax,0.9500000000000001,22,75,-53,2.2005414156269723,-0.10977411109271529,40,56
8276,just_relax,0.9500000000000001,1,0,1,81.3078807890377,-0.03165625807866623,10,15
8277,just_relax,0.9500000000000001,0,0,0,0.0,-0.040280731422501326,21,20
8278,just_relax,0.9500000000000001,5,4,1,19.479542536516767,0.024038026396234757,30,35
8279,just_relax,0.9500000000000001,5,3,2,-3.191287325901186,-0.17797283377390982,71,77
