,method,T,num_crossings0,num_crossings1,edge_cross_reduction,edge_cross_angle_reduction,aspect_ratio_reduction,num_nodes,num_edges
0,relax_and_recompute,0.0,0,6,-6,-12.82853096694232,0.4283413992029412,17,18
1,relax_and_recompute,0.0,1,3,-2,28.460357396396503,-0.2850059406919234,43,48
2,relax_and_recompute,0.0,3,5,-2,9.88581419291326,0.0069193652867528,38,45
3,relax_and_recompute,0.0,0,0,0,0.0,0.2384164839625763,12,12
4,relax_and_recompute,0.0,20,7,13,1.502478168846423,0.2029862696446577,23,38
5,relax_and_recompute,0.0,0,4,-4,-48.30308812678022,-0.0347389939534301,19,22
6,relax_and_recompute,0.0,976,1004,-28,-0.0620531910963606,-0.0009330148689207,35,143
7,relax_and_recompute,0.0,0,0,0,0.0,-0.0046858462976494,92,91
8,relax_and_recompute,0.0,2,2,0,-0.2090126471461957,-0.0072944214975458,43,51
9,relax_and_recompute,0.0,1,1,0,-1.0955168922138654,-0.0009913044466315,35,36
10,relax_and_recompute,0.0,1,2,-1,42.2633339524233,-0.2318627434700778,11,13
11,relax_and_recompute,0.0,22,19,3,-4.957652547927751,0.037406937188411,10,25
12,relax_and_recompute,0.0,16,16,0,-1.2375805476415778,-0.0662978026850604,86,136
13,relax_and_recompute,0.0,0,0,0,0.0,-0.0511964417518413,10,12
14,relax_and_recompute,0.0,0,0,0,0.0,-0.003990549338529,32,31
15,relax_and_recompute,0.0,2,2,0,0.8097822186271628,0.0720915422264546,20,26
16,relax_and_recompute,0.0,0,0,0,0.0,0.3194702926799226,11,11
17,relax_and_recompute,0.0,2,2,0,1.6133031779469889,-0.0013837411504996,34,42
18,relax_and_recompute,0.0,11,10,1,1.5445267212396203,-0.0356816848306716,14,25
19,relax_and_recompute,0.0,8,4,4,9.035240939106416,-0.2006547963227668,31,46
20,relax_and_recompute,0.0,0,2,-2,-60.43825847577355,-0.1126466588104083,42,45
21,relax_and_recompute,0.0,1265,1233,32,-0.0829886923942524,-0.0013136328692162,39,173
22,relax_and_recompute,0.0,11,10,1,-0.9259083214164718,-0.0036589420660914,14,24
23,relax_and_recompute,0.0,0,0,0,0.0,0.0381898987811113,24,25
24,relax_and_recompute,0.0,2,3,-1,18.97015617968725,0.1057791903370561,12,19
25,relax_and_recompute,0.0,59,59,0,0.0004995248301611,-0.0021609985989152,41,72
26,relax_and_recompute,0.0,182,192,-10,2.176227062990442,0.127488881317396,59,115
27,relax_and_recompute,0.0,6,4,2,3.763676058520289,0.4612476699024008,32,37
28,relax_and_recompute,0.0,1,0,1,64.5674534074053,-0.141219001604035,20,20
29,relax_and_recompute,0.0,41,26,15,-1.6275846340626714,0.0729158968985802,12,31
30,relax_and_recompute,0.0,0,1,-1,-69.48327432008485,0.3693150537109032,10,10
31,relax_and_recompute,0.0,0,1,-1,-54.77774441347712,-0.2668645740883934,20,21
32,relax_and_recompute,0.0,18,21,-3,0.5719110189928784,0.3696791622426242,39,52
33,relax_and_recompute,0.0,378,393,-15,0.6108526484877643,4.422482210819645e-05,42,109
34,relax_and_recompute,0.0,1,9,-8,21.83036785786023,-0.009946187399486,25,28
35,relax_and_recompute,0.0,170,157,13,-3.523679109137184,0.105536041898159,56,106
36,relax_and_recompute,0.0,567,575,-8,0.4383057260994292,-0.0017656065849445,87,189
37,relax_and_recompute,0.0,41,40,1,-2.249384452446378,-0.0072514307594979,56,82
38,relax_and_recompute,0.0,2,2,0,-8.391610918196733,0.5389949777682611,13,15
39,relax_and_recompute,0.0,104,92,12,-4.326875496007098,-0.2702144037643529,36,63
40,relax_and_recompute,0.0,0,0,0,0.0,0.0206358522083413,16,15
41,relax_and_recompute,0.0,0,0,0,0.0,-0.0061884200170785,67,66
42,relax_and_recompute,0.0,13,15,-2,4.302959451816811,0.0151127643612544,42,60
43,relax_and_recompute,0.0,0,4,-4,-66.92246387556978,-0.0020531545203872,39,38
44,relax_and_recompute,0.0,8,9,-1,8.482609675305326,-0.0246353290916525,20,36
45,relax_and_recompute,0.0,0,1,-1,-48.00023108256323,0.1999679001350571,10,9
46,relax_and_recompute,0.0,1,2,-1,16.895280258655347,-0.1448580536108933,13,15
47,relax_and_recompute,0.0,6,14,-8,18.824286639655867,-0.0841754274640885,34,41
48,relax_and_recompute,0.0,3,5,-2,3.41159566991864,0.101618768403258,37,42
49,relax_and_recompute,0.0,36,36,0,-1.704731745766196,-0.0868272376776762,18,29
50,relax_and_recompute,0.0,0,0,0,0.0,0.0314532687439244,23,22
51,relax_and_recompute,0.0,0,0,0,0.0,0.1413480989721667,13,12
52,relax_and_recompute,0.0,0,1,-1,-70.71524929725166,0.1516546567578266,15,14
53,relax_and_recompute,0.0,0,81,-81,-56.14899496220187,0.0273388470822635,69,68
54,relax_and_recompute,0.0,0,1,-1,-33.990764650055695,-0.0282621436299753,40,39
55,relax_and_recompute,0.0,0,4,-4,-64.68332591477235,0.1004150322501664,89,93
56,relax_and_recompute,0.0,13,12,1,-2.153586113029718,-0.0708055525167026,20,32
57,relax_and_recompute,0.0,2,3,-1,-7.067084936198143,-0.0593654442548075,69,83
58,relax_and_recompute,0.0,2,3,-1,28.77160166408776,-0.1615644846718398,12,15
59,relax_and_recompute,0.0,0,0,0,0.0,-0.0050006154443732,15,14
60,relax_and_recompute,0.0,0,1,-1,-73.35995106543365,-0.0661284376918611,23,26
61,relax_and_recompute,0.0,2,2,0,7.435447086102371,0.0512250419227734,12,20
62,relax_and_recompute,0.0,201,208,-7,-0.777546499391029,-0.0168449909220319,64,122
63,relax_and_recompute,0.0,7,3,4,-15.910964521134986,-0.0018322217021985,58,71
64,relax_and_recompute,0.0,0,0,0,0.0,-0.1147932957929044,20,19
65,relax_and_recompute,0.0,510,512,-2,-0.0138388627329746,-0.001793654381577,100,191
66,relax_and_recompute,0.0,34,26,8,0.6456109020465988,0.0277449779877803,41,61
67,relax_and_recompute,0.0,33,34,-1,-0.5384989905164446,0.0398816997391653,13,31
68,relax_and_recompute,0.0,5,3,2,12.118750923999592,-0.1168739524455244,10,15
69,relax_and_recompute,0.0,6,5,1,2.3116501951879656,-0.0709648635201967,37,47
70,relax_and_recompute,0.0,0,0,0,0.0,-0.0059846962189432,21,21
71,relax_and_recompute,0.0,0,0,0,0.0,-0.0586993005228398,11,10
72,relax_and_recompute,0.0,57,57,0,0.0064914760634735,-0.0077421754008314,44,80
73,relax_and_recompute,0.0,6,3,3,1.9384908848239064,-0.2181743805279128,12,21
74,relax_and_recompute,0.0,2,2,0,40.57817790180843,-0.0379305285754828,37,43
75,relax_and_recompute,0.0,6,8,-2,-0.1735310719531781,0.0463842795036362,41,52
76,relax_and_recompute,0.0,0,1,-1,-46.752240048820696,0.0365026507213964,90,89
77,relax_and_recompute,0.0,0,0,0,0.0,-0.0185734409897135,22,21
78,relax_and_recompute,0.0,1,6,-5,-12.824308725883805,-0.0280060439235303,37,43
79,relax_and_recompute,0.0,0,1,-1,-89.65010094514068,0.1086179312853023,47,47
80,relax_and_recompute,0.0,4,6,-2,16.941840910668297,-0.0594288998091482,12,20
81,relax_and_recompute,0.0,114,149,-35,-2.165226771283031,-0.074246937434519,84,124
82,relax_and_recompute,0.0,0,0,0,0.0,0.0048268199732052,88,92
83,relax_and_recompute,0.0,380,377,3,-0.7163078021950682,-0.0065915804467664,59,122
84,relax_and_recompute,0.0,4,3,1,0.203280810508815,0.0446821006516815,26,31
85,relax_and_recompute,0.0,0,0,0,0.0,-0.0004552342701906,28,27
86,relax_and_recompute,0.0,6,3,3,17.423606921762705,-0.2587472042056525,18,26
87,relax_and_recompute,0.0,1,3,-2,-12.914228578214503,0.0322817081119266,23,26
88,relax_and_recompute,0.0,0,5,-5,-0.8399978558704028,-0.0099238347816712,43,43
89,relax_and_recompute,0.0,2,3,-1,26.34761393126834,0.2227207785283125,22,26
90,relax_and_recompute,0.0,0,0,0,0.0,0.0069609129569286,15,14
91,relax_and_recompute,0.0,10,19,-9,5.648675414166,0.1018849030252861,36,48
92,relax_and_recompute,0.0,6,6,0,3.132031887299874,-0.366934867361315,30,37
93,relax_and_recompute,0.0,1,1,0,11.616152189123014,-0.2081405675796964,10,13
94,relax_and_recompute,0.0,0,0,0,0.0,0.0064655704930129,12,11
95,relax_and_recompute,0.0,168,153,15,-1.4597591062543387,0.1638614131178267,55,105
96,relax_and_recompute,0.0,1,1,0,16.028380475211264,0.0421533847818661,13,17
97,relax_and_recompute,0.0,0,0,0,0.0,0.0087163662247045,30,29
98,relax_and_recompute,0.0,3,4,-1,-9.905682406522075,-0.002170500293968,36,43
99,relax_and_recompute,0.0,36,40,-4,-3.781728400218512,-0.055822645815706,40,60
100,relax_and_recompute,0.0,0,0,0,0.0,0.098172582453912,13,17
101,relax_and_recompute,0.0,6,8,-2,-4.960402959672933,-0.0115319394462201,23,30
102,relax_and_recompute,0.0,0,2,-2,-49.15219570851704,-0.0046408480681885,12,16
103,relax_and_recompute,0.0,0,3,-3,-56.243046788228376,0.0779735480437637,26,26
104,relax_and_recompute,0.0,0,0,0,0.0,-0.0250790796226426,22,31
105,relax_and_recompute,0.0,0,1,-1,-16.698583100951765,0.0054628957103297,68,68
106,relax_and_recompute,0.0,0,0,0,0.0,-0.0161170479303404,23,22
107,relax_and_recompute,0.0,0,0,0,0.0,-0.0349525596057489,43,42
108,relax_and_recompute,0.0,0,0,0,0.0,0.0088342706128086,18,17
109,relax_and_recompute,0.0,3,1,2,16.774590073756514,-0.1297888041253873,28,42
110,relax_and_recompute,0.0,45,50,-5,1.8841541587735409,0.0156030402407787,21,44
111,relax_and_recompute,0.0,0,0,0,0.0,-0.0396642980748244,36,37
112,relax_and_recompute,0.0,0,0,0,0.0,0.0301870067049527,15,14
113,relax_and_recompute,0.0,1,1,0,66.99851956452005,0.1736018005328949,14,16
114,relax_and_recompute,0.0,197,211,-14,1.6294158914226389,0.1952030013326532,61,119
115,relax_and_recompute,0.0,0,1,-1,-11.350899762409592,0.0118345485308287,19,20
116,relax_and_recompute,0.0,0,2,-2,-52.79175496631128,0.0259444423045324,22,22
117,relax_and_recompute,0.0,0,0,0,0.0,-0.0413225144380497,54,58
118,relax_and_recompute,0.0,651,578,73,-0.2210914170630502,0.0196220443446196,65,135
119,relax_and_recompute,0.0,1,3,-2,14.445875885923977,0.2759374392038085,16,18
120,relax_and_recompute,0.0,7,8,-1,8.396787180550831,0.1080910940256584,17,27
121,relax_and_recompute,0.0,22,4,18,-18.61747849085588,0.1446288399504806,54,71
122,relax_and_recompute,0.0,0,2,-2,-69.51467976885004,-0.0285407675374049,23,22
123,relax_and_recompute,0.0,1,2,-1,29.01115049910844,-0.3825499618326466,13,16
124,relax_and_recompute,0.0,155,149,6,-2.794184228530185,-0.0034415506621975,85,131
125,relax_and_recompute,0.0,44,58,-14,6.627037203531586,0.0061263330641294,28,55
126,relax_and_recompute,0.0,4,4,0,17.431676694704336,-0.0893290688064797,18,24
127,relax_and_recompute,0.0,0,2,-2,-42.90819456532754,-0.0171451020274844,19,22
128,relax_and_recompute,0.0,0,1,-1,-82.00366620821269,0.0734444320361835,47,46
129,relax_and_recompute,0.0,21,21,0,-3.6879171991704425,0.0716976646866419,39,64
130,relax_and_recompute,0.0,0,0,0,0.0,0.0182227768903252,17,18
131,relax_and_recompute,0.0,1,4,-3,21.828007633524308,-0.2884920192011501,23,24
132,relax_and_recompute,0.0,2,2,0,-2.1515607672736223,0.0826566971112059,13,16
133,relax_and_recompute,0.0,22,13,9,-0.7653465239512514,0.0480027811499798,40,56
134,relax_and_recompute,0.0,1,4,-3,21.349478086386988,-0.1111849075203919,10,15
135,relax_and_recompute,0.0,0,1,-1,-66.0749602970382,0.2212442968175675,21,20
136,relax_and_recompute,0.0,4,5,-1,20.74881945520164,-0.1306207019803847,30,35
137,relax_and_recompute,0.0,1,3,-2,9.643576919002086,-0.0210553555697637,71,77
138,relax_one,0.0,0,0,0,0.0,0.0,17,18
139,relax_one,0.0,1,1,0,0.0,0.0,43,48
140,relax_one,0.0,3,3,0,0.0,0.0,38,45
141,relax_one,0.0,0,0,0,0.0,0.0,12,12
142,relax_one,0.0,20,18,2,-3.2752299140735204,0.0114158034923678,23,38
143,relax_one,0.0,0,1,-1,-78.11694026732484,-0.0295512202700576,19,22
144,relax_one,0.0,976,978,-2,0.1423455471242221,-0.0025418055405018,35,143
145,relax_one,0.0,0,1,-1,-50.19567681247512,-0.0041327022016595,92,91
146,relax_one,0.0,2,2,0,0.0,0.0,43,51
147,relax_one,0.0,1,1,0,0.0,0.0,35,36
148,relax_one,0.0,1,1,0,0.0,0.0,11,13
149,relax_one,0.0,22,20,2,-3.01441643358082,0.0082886474985522,10,25
150,relax_one,0.0,16,16,0,0.0,0.0,86,136
151,relax_one,0.0,0,0,0,0.0,0.0,10,12
152,relax_one,0.0,0,0,0,0.0,0.0,32,31
153,relax_one,0.0,2,2,0,4.970962038347736,-0.0904350603192869,20,26
154,relax_one,0.0,0,0,0,0.0,0.0,11,11
155,relax_one,0.0,2,2,0,0.0,0.0,34,42
156,relax_one,0.0,11,11,0,0.0,0.0,14,25
157,relax_one,0.0,8,7,1,13.99583228956454,0.1582030612456263,31,46
158,relax_one,0.0,0,0,0,0.0,0.0,42,45
159,relax_one,0.0,1265,1240,25,0.1009906236120983,0.0001682713719424,39,173
160,relax_one,0.0,11,11,0,0.0,0.0,14,24
161,relax_one,0.0,0,0,0,0.0,0.0,24,25
162,relax_one,0.0,2,2,0,0.0,0.0,12,19
163,relax_one,0.0,59,59,0,0.4609819410147793,0.0044552421238692,41,72
164,relax_one,0.0,182,191,-9,1.446975953367918,0.0358261975695221,59,115
165,relax_one,0.0,6,6,0,0.0,0.0,32,37
166,relax_one,0.0,1,1,0,0.0,0.0,20,20
167,relax_one,0.0,41,32,9,2.305146048931391,0.0775874222420341,12,31
168,relax_one,0.0,0,0,0,0.0,0.0,10,10
169,relax_one,0.0,0,0,0,0.0,0.0,20,21
170,relax_one,0.0,18,18,0,0.0,0.0,39,52
171,relax_one,0.0,378,395,-17,-0.4859193577000411,-0.0010324457545943,42,109
172,relax_one,0.0,1,1,0,0.0,0.0,25,28
173,relax_one,0.0,170,170,0,0.0,0.0,56,106
174,relax_one,0.0,567,595,-28,0.7834114754025379,-0.002967395777259,87,189
175,relax_one,0.0,41,41,0,-3.1762323320181167,-0.0099859384844429,56,82
176,relax_one,0.0,2,2,0,0.0,0.0,13,15
177,relax_one,0.0,104,88,16,-3.3995451437074067,-0.111275141568526,36,63
178,relax_one,0.0,0,0,0,0.0,0.0,16,15
179,relax_one,0.0,0,0,0,0.0,0.0,67,66
180,relax_one,0.0,13,13,0,0.0,0.0,42,60
181,relax_one,0.0,0,0,0,0.0,0.0,39,38
182,relax_one,0.0,8,8,0,0.0,0.0,20,36
183,relax_one,0.0,0,0,0,0.0,0.0,10,9
184,relax_one,0.0,1,1,0,0.0,0.0,13,15
185,relax_one,0.0,6,7,-1,12.522285729298716,0.0299062089849014,34,41
186,relax_one,0.0,3,3,0,0.0,0.0,37,42
187,relax_one,0.0,36,36,0,0.0,0.0,18,29
188,relax_one,0.0,0,0,0,0.0,0.0,23,22
189,relax_one,0.0,0,0,0,0.0,0.0,13,12
190,relax_one,0.0,0,0,0,0.0,0.0,15,14
191,relax_one,0.0,0,0,0,0.0,0.0,69,68
192,relax_one,0.0,0,0,0,0.0,0.0,40,39
193,relax_one,0.0,0,0,0,0.0,0.0,89,93
194,relax_one,0.0,13,13,0,-2.975681235416161,-0.0847204542309565,20,32
195,relax_one,0.0,2,2,0,0.0,0.0,69,83
196,relax_one,0.0,2,2,0,0.0,0.0,12,15
197,relax_one,0.0,0,0,0,0.0,0.0,15,14
198,relax_one,0.0,0,0,0,0.0,0.0,23,26
199,relax_one,0.0,2,2,0,0.0,0.0,12,20
200,relax_one,0.0,201,201,0,0.0,0.0,64,122
201,relax_one,0.0,7,7,0,0.0,0.0,58,71
202,relax_one,0.0,0,0,0,0.0,0.0,20,19
203,relax_one,0.0,510,510,0,0.0060639005596385,-0.0006916839131552,100,191
204,relax_one,0.0,34,34,0,0.0,0.0,41,61
205,relax_one,0.0,33,34,-1,-0.6264707699284884,0.0331924782664471,13,31
206,relax_one,0.0,5,5,0,0.0,0.0,10,15
207,relax_one,0.0,6,6,0,0.0,0.0,37,47
208,relax_one,0.0,0,0,0,0.0,0.0,21,21
209,relax_one,0.0,0,0,0,0.0,0.0,11,10
210,relax_one,0.0,57,55,2,-1.1796960984034186,9.734149291917849e-05,44,80
211,relax_one,0.0,6,6,0,0.0,0.0,12,21
212,relax_one,0.0,2,2,0,42.15913628345388,-0.0181760816329957,37,43
213,relax_one,0.0,6,6,0,0.0,0.0,41,52
214,relax_one,0.0,0,0,0,0.0,0.0,90,89
215,relax_one,0.0,0,0,0,0.0,0.0,22,21
216,relax_one,0.0,1,1,0,-4.213527745425694,0.0417394626549948,37,43
217,relax_one,0.0,0,0,0,0.0,0.0,47,47
218,relax_one,0.0,4,4,0,0.0,0.0,12,20
219,relax_one,0.0,114,114,0,0.0,0.0,84,124
220,relax_one,0.0,0,0,0,0.0,0.0,88,92
221,relax_one,0.0,380,377,3,-0.3714807714610657,-0.0025427242202904,59,122
222,relax_one,0.0,4,4,0,0.0,0.0,26,31
223,relax_one,0.0,0,0,0,0.0,0.0,28,27
224,relax_one,0.0,6,6,0,0.0,0.0,18,26
225,relax_one,0.0,1,1,0,0.0,0.0,23,26
226,relax_one,0.0,0,0,0,0.0,0.0,43,43
227,relax_one,0.0,2,2,0,0.0,0.0,22,26
228,relax_one,0.0,0,0,0,0.0,0.0,15,14
229,relax_one,0.0,10,17,-7,3.5874123628873704,0.0856058777554238,36,48
230,relax_one,0.0,6,6,0,2.8016025522275783,-0.3535412006642752,30,37
231,relax_one,0.0,1,1,0,0.0,0.0,10,13
232,relax_one,0.0,0,0,0,0.0,0.0,12,11
233,relax_one,0.0,168,167,1,-0.7965879277094672,0.0475430066924907,55,105
234,relax_one,0.0,1,1,0,17.12164821735773,0.0578261695456346,13,17
235,relax_one,0.0,0,0,0,0.0,0.0,30,29
236,relax_one,0.0,3,3,0,0.0,0.0,36,43
237,relax_one,0.0,36,36,0,0.0,0.0,40,60
238,relax_one,0.0,0,0,0,0.0,0.0,13,17
239,relax_one,0.0,6,7,-1,-5.27235869178908,0.0082826452568239,23,30
240,relax_one,0.0,0,0,0,0.0,0.0,12,16
241,relax_one,0.0,0,0,0,0.0,0.0,26,26
242,relax_one,0.0,0,0,0,0.0,0.0,22,31
243,relax_one,0.0,0,0,0,0.0,0.0,68,68
244,relax_one,0.0,0,0,0,0.0,0.0,23,22
245,relax_one,0.0,0,0,0,0.0,-0.0348129737608335,43,42
246,relax_one,0.0,0,0,0,0.0,0.0,18,17
247,relax_one,0.0,3,3,0,0.0,0.0,28,42
248,relax_one,0.0,45,45,0,0.1036479088850654,-0.0041754562964496,21,44
249,relax_one,0.0,0,0,0,0.0,0.0,36,37
250,relax_one,0.0,0,0,0,0.0,0.0,15,14
251,relax_one,0.0,1,1,0,0.0,0.0,14,16
252,relax_one,0.0,197,204,-7,3.484436282689749,0.1757315340586914,61,119
253,relax_one,0.0,0,0,0,0.0,0.0,19,20
254,relax_one,0.0,0,0,0,0.0,0.0,22,22
255,relax_one,0.0,0,0,0,0.0,0.0,54,58
256,relax_one,0.0,651,651,0,0.0,0.0,65,135
257,relax_one,0.0,1,1,0,0.0,0.0,16,18
258,relax_one,0.0,7,7,0,0.0,0.0,17,27
259,relax_one,0.0,22,4,18,-19.06910671434205,0.1469333863626725,54,71
260,relax_one,0.0,0,2,-2,-59.99819093035041,-0.0131455917893484,23,22
261,relax_one,0.0,1,0,1,76.88395716132196,-0.1491322016956315,13,16
262,relax_one,0.0,155,146,9,-2.3741667241416664,-0.001397205031107,85,131
263,relax_one,0.0,44,44,0,0.0,0.0,28,55
264,relax_one,0.0,4,4,0,0.0,0.0,18,24
265,relax_one,0.0,0,0,0,0.0,0.0,19,22
266,relax_one,0.0,0,0,0,0.0,0.0,47,46
267,relax_one,0.0,21,19,2,-6.356920988253222,0.0143956759658575,39,64
268,relax_one,0.0,0,0,0,0.0,0.0,17,18
269,relax_one,0.0,1,1,0,0.0,0.0,23,24
270,relax_one,0.0,2,2,0,0.0,0.0,13,16
271,relax_one,0.0,22,22,0,0.0,0.0,40,56
272,relax_one,0.0,1,1,0,0.0,0.0,10,15
273,relax_one,0.0,0,0,0,0.0,0.0,21,20
274,relax_one,0.0,4,4,0,0.0,0.0,30,35
275,relax_one,0.0,1,1,0,0.0,0.0,71,77
276,just_relax,0.0,0,0,0,0.0,-0.0091692815110081,17,18
277,just_relax,0.0,1,1,0,0.0009607869158827,0.0014628518031132,43,48
278,just_relax,0.0,3,3,0,-0.0019521681741139,-7.679999619569777e-05,38,45
279,just_relax,0.0,0,0,0,0.0,-0.0037600566419999,12,12
280,just_relax,0.0,20,14,6,1.9891400956483096,0.1544148745043621,23,38
281,just_relax,0.0,0,1,-1,-78.11694026732484,-0.0295512202700576,19,22
282,just_relax,0.0,976,1188,-212,1.3106081233515638,0.0257948127350838,35,143
283,just_relax,0.0,0,4,-4,-39.1818408082167,-0.0156618414823971,92,91
284,just_relax,0.0,2,2,0,-0.00041775540015,-0.0002552385505018,43,51
285,just_relax,0.0,1,1,0,-0.0016870080925173,6.40249009676297e-05,35,36
286,just_relax,0.0,1,1,0,-0.000156439410091,0.0002508982184644,11,13
287,just_relax,0.0,22,24,-2,-3.49415891827384,0.1000113687896936,10,25
288,just_relax,0.0,16,13,3,0.2088785180214571,-2.2771107622610032e-05,86,136
289,just_relax,0.0,0,0,0,0.0,-1.765503840900351e-06,10,12
290,just_relax,0.0,0,0,0,0.0,-1.014518260578079e-05,32,31
291,just_relax,0.0,2,2,0,4.970962038347736,-0.0904350603192869,20,26
292,just_relax,0.0,0,0,0,0.0,0.000269092021105,11,11
293,just_relax,0.0,2,2,0,0.0009292844165713,-0.0008610890242942,34,42
294,just_relax,0.0,11,11,0,-0.0003616788843885,0.0005035529702898,14,25
295,just_relax,0.0,8,7,1,13.99583228956454,0.1582030612456263,31,46
296,just_relax,0.0,0,0,0,0.0,0.0042083907430441,42,45
297,just_relax,0.0,1265,1285,-20,2.6849459664833404,-0.1292871249874528,39,173
298,just_relax,0.0,11,11,0,0.0001627700527109,0.0015600944076981,14,24
299,just_relax,0.0,0,0,0,0.0,-0.000608053012485,24,25
300,just_relax,0.0,2,2,0,-2.981324638540173e-05,0.0001440646714581,12,19
301,just_relax,0.0,59,59,0,0.4609819410147793,0.0044552421238692,41,72
302,just_relax,0.0,182,178,4,0.0313317398119608,0.0970080713564147,59,115
303,just_relax,0.0,6,6,0,-0.0020404096920856,0.0011964290694836,32,37
304,just_relax,0.0,1,0,1,64.5674534074053,-0.0013228453280204,20,20
305,just_relax,0.0,41,33,8,8.182357833947279,-0.009895766072516,12,31
306,just_relax,0.0,0,0,0,0.0,-1.5942199658169898e-06,10,10
307,just_relax,0.0,0,0,0,0.0,0.0018153466622625,20,21
308,just_relax,0.0,18,18,0,0.0003589278580733,-0.0005865039043362,39,52
309,just_relax,0.0,378,369,9,2.979528253482861,0.0835817869771829,42,109
310,just_relax,0.0,1,1,0,-0.0010366044558338,-5.546321229055184e-05,25,28
311,just_relax,0.0,170,170,0,-0.0002769762706833,-0.0005002245004087,56,106
312,just_relax,0.0,567,521,46,-0.2657392120378574,0.1239070997048957,87,189
313,just_relax,0.0,41,43,-2,2.499128887843675,-0.033528056765164,56,82
314,just_relax,0.0,2,2,0,0.0004861774901456,1.2071037781558047e-06,13,15
315,just_relax,0.0,104,86,18,5.26724471872344,-0.2840091449765524,36,63
316,just_relax,0.0,0,0,0,0.0,4.3915154694929015e-06,16,15
317,just_relax,0.0,0,0,0,0.0,-5.223096419815221e-07,67,66
318,just_relax,0.0,13,13,0,0.0024384647237383,0.004260897920215,42,60
319,just_relax,0.0,0,0,0,0.0,0.0005903979895692,39,38
320,just_relax,0.0,8,8,0,-3.330899971842882e-05,0.0005334774465118,20,36
321,just_relax,0.0,0,0,0,0.0,-0.0010596071395927,10,9
322,just_relax,0.0,1,1,0,0.0009644178095271,-1.805181839154013e-05,13,15
323,just_relax,0.0,6,7,-1,12.522285729298716,0.0299062089849014,34,41
324,just_relax,0.0,3,3,0,-0.0014185667246167,0.0006213779664755,37,42
325,just_relax,0.0,36,36,0,7.196136941445275e-06,5.025038399830706e-06,18,29
326,just_relax,0.0,0,0,0,0.0,-0.0031405837993232,23,22
327,just_relax,0.0,0,0,0,0.0,1.0504657718901632e-05,13,12
328,just_relax,0.0,0,0,0,0.0,-0.0007613272869088,15,14
329,just_relax,0.0,0,0,0,0.0,-0.0017207203528439,69,68
330,just_relax,0.0,0,0,0,0.0,0.001934163275203,40,39
331,just_relax,0.0,0,0,0,0.0,0.0016954512903432,89,93
332,just_relax,0.0,13,13,0,1.511050374969713,-0.0878570612978808,20,32
333,just_relax,0.0,2,3,-1,-4.120223819609976,0.0096644512108772,69,83
334,just_relax,0.0,2,2,0,0.0006766545457281,-0.0007958153584334,12,15
335,just_relax,0.0,0,0,0,0.0,-0.0009758471183408,15,14
336,just_relax,0.0,0,0,0,0.0,-0.0007570529942456,23,26
337,just_relax,0.0,2,2,0,-0.0004670837519427,-0.000552899751354,12,20
338,just_relax,0.0,201,201,0,-5.927609844036397e-05,0.0001073571901385,64,122
339,just_relax,0.0,7,7,0,-0.0099055150386959,0.0003544031231826,58,71
340,just_relax,0.0,0,0,0,0.0,-0.0013086772972689,20,19
341,just_relax,0.0,510,505,5,-0.1096058695008466,0.0001562332230281,100,191
342,just_relax,0.0,34,34,0,0.0046498502251353,3.462795885833536e-05,41,61
343,just_relax,0.0,33,21,12,-0.322372772893118,0.0487025778316814,13,31
344,just_relax,0.0,5,5,0,0.0003476406123752,0.0002826333043987,10,15
345,just_relax,0.0,6,6,0,-0.0004254358946269,0.0003115870201488,37,47
346,just_relax,0.0,0,0,0,0.0,0.0007350584472026,21,21
347,just_relax,0.0,0,0,0,0.0,9.621758975453254e-06,11,10
348,just_relax,0.0,57,55,2,-1.1796960984034186,9.734149291917849e-05,44,80
349,just_relax,0.0,6,6,0,0.0001929725905256,-1.6711583069151104e-05,12,21
350,just_relax,0.0,2,5,-3,10.477360070400792,-0.0167672873232497,37,43
351,just_relax,0.0,6,6,0,-9.27967616917158e-05,0.0005867078171852,41,52
352,just_relax,0.0,0,0,0,0.0,0.0258238191424075,90,89
353,just_relax,0.0,0,0,0,0.0,-0.0001762041220683,22,21
354,just_relax,0.0,1,5,-4,-25.99394547658536,0.034397478016983,37,43
355,just_relax,0.0,0,0,0,0.0,0.009279908390236,47,47
356,just_relax,0.0,4,4,0,-0.0003372893218767,-9.212772776878708e-07,12,20
357,just_relax,0.0,114,95,19,0.8287298242191525,-0.006531385777559,84,124
358,just_relax,0.0,0,0,0,0.0,0.0016708237920683,88,92
359,just_relax,0.0,380,332,48,-1.681066658089314,0.0270328691740772,59,122
360,just_relax,0.0,4,4,0,2.0677824380754828e-05,-0.000363330475558,26,31
361,just_relax,0.0,0,0,0,0.0,4.418930553695688e-06,28,27
362,just_relax,0.0,6,6,0,0.0013890930604816,7.243956427815945e-06,18,26
363,just_relax,0.0,1,1,0,-0.0014241348598034,0.001861633846505,23,26
364,just_relax,0.0,0,0,0,0.0,0.0001814651838247,43,43
365,just_relax,0.0,2,2,0,0.0004949068667485,0.0012137972461528,22,26
366,just_relax,0.0,0,0,0,0.0,8.316094011640018e-06,15,14
367,just_relax,0.0,10,17,-7,3.5874123628873704,0.0856058777554238,36,48
368,just_relax,0.0,6,6,0,2.8016025522275783,-0.3535412006642752,30,37
369,just_relax,0.0,1,1,0,5.455328151526828e-05,-4.433967369288361e-05,10,13
370,just_relax,0.0,0,0,0,0.0,-0.0049855760382295,12,11
371,just_relax,0.0,168,182,-14,1.1771250480206064,-0.0267800915114647,55,105
372,just_relax,0.0,1,1,0,17.12164821735773,0.0578261695456346,13,17
373,just_relax,0.0,0,0,0,0.0,0.0003329515887838,30,29
374,just_relax,0.0,3,3,0,0.000583815366788,0.0008768881680062,36,43
375,just_relax,0.0,36,36,0,0.0010314806767866,-5.393936385500453e-05,40,60
376,just_relax,0.0,0,0,0,0.0,0.0017894746066188,13,17
377,just_relax,0.0,6,7,-1,-5.27235869178908,0.0082826452568239,23,30
378,just_relax,0.0,0,0,0,0.0,-2.940409977925107e-05,12,16
379,just_relax,0.0,0,0,0,0.0,3.901708024223183e-06,26,26
380,just_relax,0.0,0,0,0,0.0,-0.0031688166024113,22,31
381,just_relax,0.0,0,0,0,0.0,0.0008768193667615,68,68
382,just_relax,0.0,0,0,0,0.0,-7.938175057398134e-06,23,22
383,just_relax,0.0,0,0,0,0.0,-0.065399188004364,43,42
384,just_relax,0.0,0,0,0,0.0,-0.002899723134464,18,17
385,just_relax,0.0,3,3,0,-0.003194586812441,0.0012605153222713,28,42
386,just_relax,0.0,45,58,-13,0.9231299892006462,0.088218433779717,21,44
387,just_relax,0.0,0,0,0,0.0,-0.0112811671875761,36,37
388,just_relax,0.0,0,0,0,0.0,-3.4878924121017896e-05,15,14
389,just_relax,0.0,1,1,0,-0.0014549239964907,-0.00058525619921,14,16
390,just_relax,0.0,197,237,-40,1.3477492998050025,0.0885093784332623,61,119
391,just_relax,0.0,0,0,0,0.0,-0.0038599581671643,19,20
392,just_relax,0.0,0,0,0,0.0,-0.0006472841631984,22,22
393,just_relax,0.0,0,0,0,0.0,-0.0011415137972972,54,58
394,just_relax,0.0,651,651,0,-0.0003954210755097,0.0002252638081207,65,135
395,just_relax,0.0,1,1,0,-0.0029471577812358,0.0001749400264638,16,18
396,just_relax,0.0,7,7,0,0.0002013814076775,0.0006636994664107,17,27
397,just_relax,0.0,22,7,15,-12.985895473169307,0.1330374466905183,54,71
398,just_relax,0.0,0,2,-2,-59.99819093035041,-0.0131455917893484,23,22
399,just_relax,0.0,1,0,1,76.88395716132196,-0.1491322016956315,13,16
400,just_relax,0.0,155,185,-30,2.3843149677438973,-0.02495720013905,85,131
401,just_relax,0.0,44,44,0,0.0003032918935019,0.0025857794052007,28,55
402,just_relax,0.0,4,4,0,-0.0007096785766407,-5.4537984728875166e-05,18,24
403,just_relax,0.0,0,0,0,0.0,-0.003226028074061,19,22
404,just_relax,0.0,0,0,0,0.0,0.0048197166778652,47,46
405,just_relax,0.0,21,27,-6,0.0602947270368474,-0.3310372682946312,39,64
406,just_relax,0.0,0,0,0,0.0,-0.0037052423868473,17,18
407,just_relax,0.0,1,1,0,0.0005119856857191,0.0004745196477359,23,24
408,just_relax,0.0,2,2,0,0.0010275548569325,-0.004970471779609,13,16
409,just_relax,0.0,22,22,0,0.0038770082111057,0.0004285387996507,40,56
410,just_relax,0.0,1,1,0,-0.0002865966515059,-0.0003325971221349,10,15
411,just_relax,0.0,0,0,0,0.0,0.0003384089422906,21,20
412,just_relax,0.0,4,4,0,-0.0001029723687508,-0.0013906355929786,30,35
413,just_relax,0.0,1,1,0,0.0051043410712594,-0.0056156512673798,71,77
414,relax_and_recompute,0.05,0,2,-2,-37.975475184838686,0.4291271174204314,17,18
415,relax_and_recompute,0.05,1,3,-2,28.460357396396503,-0.2850059406919234,43,48
416,relax_and_recompute,0.05,3,5,-2,9.88581419291326,0.0069193652867528,38,45
417,relax_and_recompute,0.05,0,0,0,0.0,0.0,12,12
418,relax_and_recompute,0.05,20,7,13,1.502478168846423,0.2029862696446577,23,38
419,relax_and_recompute,0.05,0,4,-4,-48.30308812678022,-0.0347389939534301,19,22
420,relax_and_recompute,0.05,976,1004,-28,-0.0620531910963606,-0.0009330148689207,35,143
421,relax_and_recompute,0.05,0,0,0,0.0,-0.0046858462976494,92,91
422,relax_and_recompute,0.05,2,2,0,0.0,0.0,43,51
423,relax_and_recompute,0.05,1,1,0,0.0,0.0,35,36
424,relax_and_recompute,0.05,1,2,-1,42.2633339524233,-0.2318627434700778,11,13
425,relax_and_recompute,0.05,22,19,3,-4.957652547927751,0.037406937188411,10,25
426,relax_and_recompute,0.05,16,16,0,-1.2375805476415778,-0.0662978026850604,86,136
427,relax_and_recompute,0.05,0,0,0,0.0,0.0,10,12
428,relax_and_recompute,0.05,0,0,0,0.0,0.0,32,31
429,relax_and_recompute,0.05,2,2,0,0.8097822186271628,0.0720915422264546,20,26
430,relax_and_recompute,0.05,0,0,0,0.0,0.0,11,11
431,relax_and_recompute,0.05,2,2,0,1.6133031779469889,-0.0013837411504996,34,42
432,relax_and_recompute,0.05,11,10,1,1.5445267212396203,-0.0356816848306716,14,25
433,relax_and_recompute,0.05,8,4,4,9.035240939106416,-0.2006547963227668,31,46
434,relax_and_recompute,0.05,0,2,-2,-60.43825847577355,-0.1126466588104083,42,45
435,relax_and_recompute,0.05,1265,1233,32,-0.0829886923942524,-0.0013136328692162,39,173
436,relax_and_recompute,0.05,11,10,1,-0.9259083214164718,-0.0036589420660914,14,24
437,relax_and_recompute,0.05,0,0,0,0.0,0.0,24,25
438,relax_and_recompute,0.05,2,3,-1,18.97015617968725,0.1057791903370561,12,19
439,relax_and_recompute,0.05,59,59,0,0.0004995248301611,-0.0021609985989152,41,72
440,relax_and_recompute,0.05,182,192,-10,2.176227062990442,0.127488881317396,59,115
441,relax_and_recompute,0.05,6,4,2,3.763676058520289,0.4612476699024008,32,37
442,relax_and_recompute,0.05,1,0,1,64.5674534074053,-0.141219001604035,20,20
443,relax_and_recompute,0.05,41,26,15,-1.6275846340626714,0.0729158968985802,12,31
444,relax_and_recompute,0.05,0,1,-1,-69.48327432008485,0.3693150537109032,10,10
445,relax_and_recompute,0.05,0,1,-1,-54.77774441347712,-0.2668645740883934,20,21
446,relax_and_recompute,0.05,18,21,-3,0.5719110189928784,0.3696791622426242,39,52
447,relax_and_recompute,0.05,378,393,-15,0.6108526484877643,4.422482210819645e-05,42,109
448,relax_and_recompute,0.05,1,9,-8,21.83036785786023,-0.009946187399486,25,28
449,relax_and_recompute,0.05,170,157,13,-3.523679109137184,0.105536041898159,56,106
450,relax_and_recompute,0.05,567,575,-8,0.4383057260994292,-0.0017656065849445,87,189
451,relax_and_recompute,0.05,41,40,1,-2.249384452446378,-0.0072514307594979,56,82
452,relax_and_recompute,0.05,2,2,0,-8.391610918196733,0.5389949777682611,13,15
453,relax_and_recompute,0.05,104,88,16,-3.3995451437074067,-0.111275141568526,36,63
454,relax_and_recompute,0.05,0,0,0,0.0,0.0,16,15
455,relax_and_recompute,0.05,0,0,0,0.0,-0.0061884200170785,67,66
456,relax_and_recompute,0.05,13,13,0,0.0,0.0,42,60
457,relax_and_recompute,0.05,0,0,0,0.0,0.0,39,38
458,relax_and_recompute,0.05,8,9,-1,8.482609675305326,-0.0246353290916525,20,36
459,relax_and_recompute,0.05,0,0,0,0.0,0.3984134784004176,10,9
460,relax_and_recompute,0.05,1,2,-1,16.895280258655347,-0.1448580536108933,13,15
461,relax_and_recompute,0.05,6,14,-8,18.824286639655867,-0.0841754274640885,34,41
462,relax_and_recompute,0.05,3,5,-2,3.41159566991864,0.101618768403258,37,42
463,relax_and_recompute,0.05,36,36,0,0.0,0.0,18,29
464,relax_and_recompute,0.05,0,0,0,0.0,0.0314532687439244,23,22
465,relax_and_recompute,0.05,0,0,0,0.0,0.1253462347742774,13,12
466,relax_and_recompute,0.05,0,1,-1,-70.71524929725166,0.1516546567578266,15,14
467,relax_and_recompute,0.05,0,0,0,0.0,0.0,69,68
468,relax_and_recompute,0.05,0,0,0,0.0,0.0,40,39
469,relax_and_recompute,0.05,0,0,0,0.0,0.0,89,93
470,relax_and_recompute,0.05,13,12,1,-2.153586113029718,-0.0708055525167026,20,32
471,relax_and_recompute,0.05,2,3,-1,-7.067084936198143,-0.0593654442548075,69,83
472,relax_and_recompute,0.05,2,3,-1,28.77160166408776,-0.1615644846718398,12,15
473,relax_and_recompute,0.05,0,0,0,0.0,0.0,15,14
474,relax_and_recompute,0.05,0,1,-1,-73.35995106543365,-0.0661284376918611,23,26
475,relax_and_recompute,0.05,2,2,0,7.435447086102371,0.0512250419227734,12,20
476,relax_and_recompute,0.05,201,208,-7,-0.777546499391029,-0.0168449909220319,64,122
477,relax_and_recompute,0.05,7,3,4,-15.3477275810384,-0.0042339303565398,58,71
478,relax_and_recompute,0.05,0,0,0,0.0,-0.1147932957929044,20,19
479,relax_and_recompute,0.05,510,512,-2,-0.0138388627329746,-0.001793654381577,100,191
480,relax_and_recompute,0.05,34,34,0,0.0,0.0,41,61
481,relax_and_recompute,0.05,33,34,-1,-0.5384989905164446,0.0398816997391653,13,31
482,relax_and_recompute,0.05,5,3,2,12.118750923999592,-0.1168739524455244,10,15
483,relax_and_recompute,0.05,6,5,1,2.3116501951879656,-0.0709648635201967,37,47
484,relax_and_recompute,0.05,0,0,0,0.0,-0.0059846962189432,21,21
485,relax_and_recompute,0.05,0,0,0,0.0,-0.0586993005228398,11,10
486,relax_and_recompute,0.05,57,57,0,0.0064914760634735,-0.0077421754008314,44,80
487,relax_and_recompute,0.05,6,6,0,0.0,0.0,12,21
488,relax_and_recompute,0.05,2,2,0,40.57817790180843,-0.0379305285754828,37,43
489,relax_and_recompute,0.05,6,8,-2,-0.1735310719531781,0.0463842795036362,41,52
490,relax_and_recompute,0.05,0,0,0,0.0,0.0,90,89
491,relax_and_recompute,0.05,0,0,0,0.0,0.0,22,21
492,relax_and_recompute,0.05,1,6,-5,-12.824308725883805,-0.0280060439235303,37,43
493,relax_and_recompute,0.05,0,1,-1,-89.65010094514068,0.1086179312853023,47,47
494,relax_and_recompute,0.05,4,6,-2,16.941840910668297,-0.0594288998091482,12,20
495,relax_and_recompute,0.05,114,114,0,0.0,0.0,84,124
496,relax_and_recompute,0.05,0,0,0,0.0,0.0,88,92
497,relax_and_recompute,0.05,380,377,3,-0.3714807714610657,-0.0025427242202904,59,122
498,relax_and_recompute,0.05,4,3,1,0.203280810508815,0.0446821006516815,26,31
499,relax_and_recompute,0.05,0,0,0,0.0,0.0,28,27
500,relax_and_recompute,0.05,6,6,0,0.0,0.0,18,26
501,relax_and_recompute,0.05,1,3,-2,-12.914228578214503,0.0322817081119266,23,26
502,relax_and_recompute,0.05,0,5,-5,-0.8399978558704028,-0.0099238347816712,43,43
503,relax_and_recompute,0.05,2,3,-1,26.34761393126834,0.2227207785283125,22,26
504,relax_and_recompute,0.05,0,0,0,0.0,0.0,15,14
505,relax_and_recompute,0.05,10,19,-9,5.648675414166,0.1018849030252861,36,48
506,relax_and_recompute,0.05,6,6,0,3.132031887299874,-0.366934867361315,30,37
507,relax_and_recompute,0.05,1,1,0,11.616152189123014,-0.2081405675796964,10,13
508,relax_and_recompute,0.05,0,0,0,0.0,0.0,12,11
509,relax_and_recompute,0.05,168,153,15,-1.4597591062543387,0.1638614131178267,55,105
510,relax_and_recompute,0.05,1,1,0,16.028380475211264,0.0421533847818661,13,17
511,relax_and_recompute,0.05,0,0,0,0.0,0.0,30,29
512,relax_and_recompute,0.05,3,4,-1,-9.905682406522075,-0.002170500293968,36,43
513,relax_and_recompute,0.05,36,40,-4,-3.781728400218512,-0.055822645815706,40,60
514,relax_and_recompute,0.05,0,0,0,0.0,0.098172582453912,13,17
515,relax_and_recompute,0.05,6,8,-2,-4.960402959672933,-0.0115319394462201,23,30
516,relax_and_recompute,0.05,0,1,-1,-42.83711828492631,-0.075967346402093,12,16
517,relax_and_recompute,0.05,0,3,-3,-56.243046788228376,0.0779735480437637,26,26
518,relax_and_recompute,0.05,0,0,0,0.0,-0.0250790796226426,22,31
519,relax_and_recompute,0.05,0,0,0,0.0,0.0,68,68
520,relax_and_recompute,0.05,0,0,0,0.0,-0.0161170479303404,23,22
521,relax_and_recompute,0.05,0,0,0,0.0,-0.0349525596057489,43,42
522,relax_and_recompute,0.05,0,0,0,0.0,0.0088342706128086,18,17
523,relax_and_recompute,0.05,3,1,2,16.774590073756514,-0.1297888041253873,28,42
524,relax_and_recompute,0.05,45,50,-5,1.8841541587735409,0.0156030402407787,21,44
525,relax_and_recompute,0.05,0,0,0,0.0,0.0,36,37
526,relax_and_recompute,0.05,0,0,0,0.0,0.0,15,14
527,relax_and_recompute,0.05,1,1,0,66.99851956452005,0.1736018005328949,14,16
528,relax_and_recompute,0.05,197,211,-14,1.6294158914226389,0.1952030013326532,61,119
529,relax_and_recompute,0.05,0,1,-1,-11.350899762409592,0.0118345485308287,19,20
530,relax_and_recompute,0.05,0,2,-2,-52.79175496631128,0.0259444423045324,22,22
531,relax_and_recompute,0.05,0,0,0,0.0,-0.0413225144380497,54,58
532,relax_and_recompute,0.05,651,651,0,0.0,0.0,65,135
533,relax_and_recompute,0.05,1,3,-2,14.445875885923977,0.2759374392038085,16,18
534,relax_and_recompute,0.05,7,8,-1,8.396787180550831,0.1080910940256584,17,27
535,relax_and_recompute,0.05,22,4,18,-18.61747849085588,0.1446288399504806,54,71
536,relax_and_recompute,0.05,0,2,-2,-69.51467976885004,-0.0285407675374049,23,22
537,relax_and_recompute,0.05,1,2,-1,29.01115049910844,-0.3825499618326466,13,16
538,relax_and_recompute,0.05,155,149,6,-2.794184228530185,-0.0034415506621975,85,131
539,relax_and_recompute,0.05,44,58,-14,6.627037203531586,0.0061263330641294,28,55
540,relax_and_recompute,0.05,4,4,0,17.431676694704336,-0.0893290688064797,18,24
541,relax_and_recompute,0.05,0,2,-2,-42.90819456532754,-0.0171451020274844,19,22
542,relax_and_recompute,0.05,0,1,-1,-82.00366620821269,0.0734444320361835,47,46
543,relax_and_recompute,0.05,21,21,0,-3.6879171991704425,0.0716976646866419,39,64
544,relax_and_recompute,0.05,0,0,0,0.0,0.0182227768903252,17,18
545,relax_and_recompute,0.05,1,4,-3,21.828007633524308,-0.2884920192011501,23,24
546,relax_and_recompute,0.05,2,2,0,-2.1515607672736223,0.0826566971112059,13,16
547,relax_and_recompute,0.05,22,13,9,-0.7653465239512514,0.0480027811499798,40,56
548,relax_and_recompute,0.05,1,1,0,-6.456334298675088,-0.0400486519001042,10,15
549,relax_and_recompute,0.05,0,1,-1,-66.0749602970382,0.2212442968175675,21,20
550,relax_and_recompute,0.05,4,5,-1,20.74881945520164,-0.1306207019803847,30,35
551,relax_and_recompute,0.05,1,1,0,0.0,0.0,71,77
552,relax_one,0.05,0,0,0,0.0,0.0,17,18
553,relax_one,0.05,1,1,0,0.0,0.0,43,48
554,relax_one,0.05,3,3,0,0.0,0.0,38,45
555,relax_one,0.05,0,0,0,0.0,0.0,12,12
556,relax_one,0.05,20,18,2,-3.2752299140735204,0.0114158034923678,23,38
557,relax_one,0.05,0,1,-1,-78.11694026732484,-0.0295512202700576,19,22
558,relax_one,0.05,976,978,-2,0.1423455471242221,-0.0025418055405018,35,143
559,relax_one,0.05,0,1,-1,-50.19567681247512,-0.0041327022016595,92,91
560,relax_one,0.05,2,2,0,0.0,0.0,43,51
561,relax_one,0.05,1,1,0,0.0,0.0,35,36
562,relax_one,0.05,1,1,0,0.0,0.0,11,13
563,relax_one,0.05,22,20,2,-3.01441643358082,0.0082886474985522,10,25
564,relax_one,0.05,16,16,0,0.0,0.0,86,136
565,relax_one,0.05,0,0,0,0.0,0.0,10,12
566,relax_one,0.05,0,0,0,0.0,0.0,32,31
567,relax_one,0.05,2,2,0,4.970962038347736,-0.0904350603192869,20,26
568,relax_one,0.05,0,0,0,0.0,0.0,11,11
569,relax_one,0.05,2,2,0,0.0,0.0,34,42
570,relax_one,0.05,11,11,0,0.0,0.0,14,25
571,relax_one,0.05,8,7,1,13.99583228956454,0.1582030612456263,31,46
572,relax_one,0.05,0,0,0,0.0,0.0,42,45
573,relax_one,0.05,1265,1240,25,0.1009906236120983,0.0001682713719424,39,173
574,relax_one,0.05,11,11,0,0.0,0.0,14,24
575,relax_one,0.05,0,0,0,0.0,0.0,24,25
576,relax_one,0.05,2,2,0,0.0,0.0,12,19
577,relax_one,0.05,59,59,0,0.4609819410147793,0.0044552421238692,41,72
578,relax_one,0.05,182,191,-9,1.446975953367918,0.0358261975695221,59,115
579,relax_one,0.05,6,6,0,0.0,0.0,32,37
580,relax_one,0.05,1,1,0,0.0,0.0,20,20
581,relax_one,0.05,41,32,9,2.305146048931391,0.0775874222420341,12,31
582,relax_one,0.05,0,0,0,0.0,0.0,10,10
583,relax_one,0.05,0,0,0,0.0,0.0,20,21
584,relax_one,0.05,18,18,0,0.0,0.0,39,52
585,relax_one,0.05,378,395,-17,-0.4859193577000411,-0.0010324457545943,42,109
586,relax_one,0.05,1,1,0,0.0,0.0,25,28
587,relax_one,0.05,170,170,0,0.0,0.0,56,106
588,relax_one,0.05,567,595,-28,0.7834114754025379,-0.002967395777259,87,189
589,relax_one,0.05,41,41,0,-3.1762323320181167,-0.0099859384844429,56,82
590,relax_one,0.05,2,2,0,0.0,0.0,13,15
591,relax_one,0.05,104,88,16,-3.3995451437074067,-0.111275141568526,36,63
592,relax_one,0.05,0,0,0,0.0,0.0,16,15
593,relax_one,0.05,0,0,0,0.0,0.0,67,66
594,relax_one,0.05,13,13,0,0.0,0.0,42,60
595,relax_one,0.05,0,0,0,0.0,0.0,39,38
596,relax_one,0.05,8,8,0,0.0,0.0,20,36
597,relax_one,0.05,0,0,0,0.0,0.0,10,9
598,relax_one,0.05,1,1,0,0.0,0.0,13,15
599,relax_one,0.05,6,7,-1,12.522285729298716,0.0299062089849014,34,41
600,relax_one,0.05,3,3,0,0.0,0.0,37,42
601,relax_one,0.05,36,36,0,0.0,0.0,18,29
602,relax_one,0.05,0,0,0,0.0,0.0,23,22
603,relax_one,0.05,0,0,0,0.0,0.0,13,12
604,relax_one,0.05,0,0,0,0.0,0.0,15,14
605,relax_one,0.05,0,0,0,0.0,0.0,69,68
606,relax_one,0.05,0,0,0,0.0,0.0,40,39
607,relax_one,0.05,0,0,0,0.0,0.0,89,93
608,relax_one,0.05,13,13,0,-2.975681235416161,-0.0847204542309565,20,32
609,relax_one,0.05,2,2,0,0.0,0.0,69,83
610,relax_one,0.05,2,2,0,0.0,0.0,12,15
611,relax_one,0.05,0,0,0,0.0,0.0,15,14
612,relax_one,0.05,0,0,0,0.0,0.0,23,26
613,relax_one,0.05,2,2,0,0.0,0.0,12,20
614,relax_one,0.05,201,201,0,0.0,0.0,64,122
615,relax_one,0.05,7,7,0,0.0,0.0,58,71
616,relax_one,0.05,0,0,0,0.0,0.0,20,19
617,relax_one,0.05,510,510,0,0.0060639005596385,-0.0006916839131552,100,191
618,relax_one,0.05,34,34,0,0.0,0.0,41,61
619,relax_one,0.05,33,34,-1,-0.6264707699284884,0.0331924782664471,13,31
620,relax_one,0.05,5,5,0,0.0,0.0,10,15
621,relax_one,0.05,6,6,0,0.0,0.0,37,47
622,relax_one,0.05,0,0,0,0.0,0.0,21,21
623,relax_one,0.05,0,0,0,0.0,0.0,11,10
624,relax_one,0.05,57,55,2,-1.1796960984034186,9.734149291917849e-05,44,80
625,relax_one,0.05,6,6,0,0.0,0.0,12,21
626,relax_one,0.05,2,2,0,42.15913628345388,-0.0181760816329957,37,43
627,relax_one,0.05,6,6,0,0.0,0.0,41,52
628,relax_one,0.05,0,0,0,0.0,0.0,90,89
629,relax_one,0.05,0,0,0,0.0,0.0,22,21
630,relax_one,0.05,1,1,0,-4.213527745425694,0.0417394626549948,37,43
631,relax_one,0.05,0,0,0,0.0,0.0,47,47
632,relax_one,0.05,4,4,0,0.0,0.0,12,20
633,relax_one,0.05,114,114,0,0.0,0.0,84,124
634,relax_one,0.05,0,0,0,0.0,0.0,88,92
635,relax_one,0.05,380,377,3,-0.3714807714610657,-0.0025427242202904,59,122
636,relax_one,0.05,4,4,0,0.0,0.0,26,31
637,relax_one,0.05,0,0,0,0.0,0.0,28,27
638,relax_one,0.05,6,6,0,0.0,0.0,18,26
639,relax_one,0.05,1,1,0,0.0,0.0,23,26
640,relax_one,0.05,0,0,0,0.0,0.0,43,43
641,relax_one,0.05,2,2,0,0.0,0.0,22,26
642,relax_one,0.05,0,0,0,0.0,0.0,15,14
643,relax_one,0.05,10,17,-7,3.5874123628873704,0.0856058777554238,36,48
644,relax_one,0.05,6,6,0,2.8016025522275783,-0.3535412006642752,30,37
645,relax_one,0.05,1,1,0,0.0,0.0,10,13
646,relax_one,0.05,0,0,0,0.0,0.0,12,11
647,relax_one,0.05,168,167,1,-0.7965879277094672,0.0475430066924907,55,105
648,relax_one,0.05,1,1,0,17.12164821735773,0.0578261695456346,13,17
649,relax_one,0.05,0,0,0,0.0,0.0,30,29
650,relax_one,0.05,3,3,0,0.0,0.0,36,43
651,relax_one,0.05,36,36,0,0.0,0.0,40,60
652,relax_one,0.05,0,0,0,0.0,0.0,13,17
653,relax_one,0.05,6,7,-1,-5.27235869178908,0.0082826452568239,23,30
654,relax_one,0.05,0,0,0,0.0,0.0,12,16
655,relax_one,0.05,0,0,0,0.0,0.0,26,26
656,relax_one,0.05,0,0,0,0.0,0.0,22,31
657,relax_one,0.05,0,0,0,0.0,0.0,68,68
658,relax_one,0.05,0,0,0,0.0,0.0,23,22
659,relax_one,0.05,0,0,0,0.0,-0.0348129737608335,43,42
660,relax_one,0.05,0,0,0,0.0,0.0,18,17
661,relax_one,0.05,3,3,0,0.0,0.0,28,42
662,relax_one,0.05,45,45,0,0.1036479088850654,-0.0041754562964496,21,44
663,relax_one,0.05,0,0,0,0.0,0.0,36,37
664,relax_one,0.05,0,0,0,0.0,0.0,15,14
665,relax_one,0.05,1,1,0,0.0,0.0,14,16
666,relax_one,0.05,197,204,-7,3.484436282689749,0.1757315340586914,61,119
667,relax_one,0.05,0,0,0,0.0,0.0,19,20
668,relax_one,0.05,0,0,0,0.0,0.0,22,22
669,relax_one,0.05,0,0,0,0.0,0.0,54,58
670,relax_one,0.05,651,651,0,0.0,0.0,65,135
671,relax_one,0.05,1,1,0,0.0,0.0,16,18
672,relax_one,0.05,7,7,0,0.0,0.0,17,27
673,relax_one,0.05,22,4,18,-19.06910671434205,0.1469333863626725,54,71
674,relax_one,0.05,0,2,-2,-59.99819093035041,-0.0131455917893484,23,22
675,relax_one,0.05,1,0,1,76.88395716132196,-0.1491322016956315,13,16
676,relax_one,0.05,155,146,9,-2.3741667241416664,-0.001397205031107,85,131
677,relax_one,0.05,44,44,0,0.0,0.0,28,55
678,relax_one,0.05,4,4,0,0.0,0.0,18,24
679,relax_one,0.05,0,0,0,0.0,0.0,19,22
680,relax_one,0.05,0,0,0,0.0,0.0,47,46
681,relax_one,0.05,21,19,2,-6.356920988253222,0.0143956759658575,39,64
682,relax_one,0.05,0,0,0,0.0,0.0,17,18
683,relax_one,0.05,1,1,0,0.0,0.0,23,24
684,relax_one,0.05,2,2,0,0.0,0.0,13,16
685,relax_one,0.05,22,22,0,0.0,0.0,40,56
686,relax_one,0.05,1,1,0,0.0,0.0,10,15
687,relax_one,0.05,0,0,0,0.0,0.0,21,20
688,relax_one,0.05,4,4,0,0.0,0.0,30,35
689,relax_one,0.05,1,1,0,0.0,0.0,71,77
690,just_relax,0.05,0,0,0,0.0,-0.0091692815110081,17,18
691,just_relax,0.05,1,1,0,0.0009607869158827,0.0014628518031132,43,48
692,just_relax,0.05,3,3,0,-0.0019521681741139,-7.679999619569777e-05,38,45
693,just_relax,0.05,0,0,0,0.0,-0.0037600566419999,12,12
694,just_relax,0.05,20,14,6,1.9891400956483096,0.1544148745043621,23,38
695,just_relax,0.05,0,1,-1,-78.11694026732484,-0.0295512202700576,19,22
696,just_relax,0.05,976,1188,-212,1.3106081233515638,0.0257948127350838,35,143
697,just_relax,0.05,0,4,-4,-39.1818408082167,-0.0156618414823971,92,91
698,just_relax,0.05,2,2,0,-0.00041775540015,-0.0002552385505018,43,51
699,just_relax,0.05,1,1,0,-0.0016870080925173,6.40249009676297e-05,35,36
700,just_relax,0.05,1,1,0,-0.000156439410091,0.0002508982184644,11,13
701,just_relax,0.05,22,24,-2,-3.49415891827384,0.1000113687896936,10,25
702,just_relax,0.05,16,13,3,0.2088785180214571,-2.2771107622610032e-05,86,136
703,just_relax,0.05,0,0,0,0.0,-1.765503840900351e-06,10,12
704,just_relax,0.05,0,0,0,0.0,-1.014518260578079e-05,32,31
705,just_relax,0.05,2,2,0,4.970962038347736,-0.0904350603192869,20,26
706,just_relax,0.05,0,0,0,0.0,0.000269092021105,11,11
707,just_relax,0.05,2,2,0,0.0009292844165713,-0.0008610890242942,34,42
708,just_relax,0.05,11,11,0,-0.0003616788843885,0.0005035529702898,14,25
709,just_relax,0.05,8,7,1,13.99583228956454,0.1582030612456263,31,46
710,just_relax,0.05,0,0,0,0.0,0.0042083907430441,42,45
711,just_relax,0.05,1265,1285,-20,2.6849459664833404,-0.1292871249874528,39,173
712,just_relax,0.05,11,11,0,0.0001627700527109,0.0015600944076981,14,24
713,just_relax,0.05,0,0,0,0.0,-0.000608053012485,24,25
714,just_relax,0.05,2,2,0,-2.981324638540173e-05,0.0001440646714581,12,19
715,just_relax,0.05,59,59,0,0.4609819410147793,0.0044552421238692,41,72
716,just_relax,0.05,182,178,4,0.0313317398119608,0.0970080713564147,59,115
717,just_relax,0.05,6,6,0,-0.0020404096920856,0.0011964290694836,32,37
718,just_relax,0.05,1,0,1,64.5674534074053,-0.0013228453280204,20,20
719,just_relax,0.05,41,33,8,8.182357833947279,-0.009895766072516,12,31
720,just_relax,0.05,0,0,0,0.0,-1.5942199658169898e-06,10,10
721,just_relax,0.05,0,0,0,0.0,0.0018153466622625,20,21
722,just_relax,0.05,18,18,0,0.0003589278580733,-0.0005865039043362,39,52
723,just_relax,0.05,378,369,9,2.979528253482861,0.0835817869771829,42,109
724,just_relax,0.05,1,1,0,-0.0010366044558338,-5.546321229055184e-05,25,28
725,just_relax,0.05,170,170,0,-0.0002769762706833,-0.0005002245004087,56,106
726,just_relax,0.05,567,521,46,-0.2657392120378574,0.1239070997048957,87,189
727,just_relax,0.05,41,43,-2,2.499128887843675,-0.033528056765164,56,82
728,just_relax,0.05,2,2,0,0.0004861774901456,1.2071037781558047e-06,13,15
729,just_relax,0.05,104,86,18,5.26724471872344,-0.2840091449765524,36,63
730,just_relax,0.05,0,0,0,0.0,4.3915154694929015e-06,16,15
731,just_relax,0.05,0,0,0,0.0,-5.223096419815221e-07,67,66
732,just_relax,0.05,13,13,0,0.0024384647237383,0.004260897920215,42,60
733,just_relax,0.05,0,0,0,0.0,0.0005903979895692,39,38
734,just_relax,0.05,8,8,0,-3.330899971842882e-05,0.0005334774465118,20,36
735,just_relax,0.05,0,0,0,0.0,-0.0010596071395927,10,9
736,just_relax,0.05,1,1,0,0.0009644178095271,-1.805181839154013e-05,13,15
737,just_relax,0.05,6,7,-1,12.522285729298716,0.0299062089849014,34,41
738,just_relax,0.05,3,3,0,-0.0014185667246167,0.0006213779664755,37,42
739,just_relax,0.05,36,36,0,7.196136941445275e-06,5.025038399830706e-06,18,29
740,just_relax,0.05,0,0,0,0.0,-0.0031405837993232,23,22
741,just_relax,0.05,0,0,0,0.0,1.0504657718901632e-05,13,12
742,just_relax,0.05,0,0,0,0.0,-0.0007613272869088,15,14
743,just_relax,0.05,0,0,0,0.0,-0.0017207203528439,69,68
744,just_relax,0.05,0,0,0,0.0,0.001934163275203,40,39
745,just_relax,0.05,0,0,0,0.0,0.0016954512903432,89,93
746,just_relax,0.05,13,13,0,1.511050374969713,-0.0878570612978808,20,32
747,just_relax,0.05,2,3,-1,-4.120223819609976,0.0096644512108772,69,83
748,just_relax,0.05,2,2,0,0.0006766545457281,-0.0007958153584334,12,15
749,just_relax,0.05,0,0,0,0.0,-0.0009758471183408,15,14
750,just_relax,0.05,0,0,0,0.0,-0.0007570529942456,23,26
751,just_relax,0.05,2,2,0,-0.0004670837519427,-0.000552899751354,12,20
752,just_relax,0.05,201,201,0,-5.927609844036397e-05,0.0001073571901385,64,122
753,just_relax,0.05,7,7,0,-0.0099055150386959,0.0003544031231826,58,71
754,just_relax,0.05,0,0,0,0.0,-0.0013086772972689,20,19
755,just_relax,0.05,510,505,5,-0.1096058695008466,0.0001562332230281,100,191
756,just_relax,0.05,34,34,0,0.0046498502251353,3.462795885833536e-05,41,61
757,just_relax,0.05,33,21,12,-0.322372772893118,0.0487025778316814,13,31
758,just_relax,0.05,5,5,0,0.0003476406123752,0.0002826333043987,10,15
759,just_relax,0.05,6,6,0,-0.0004254358946269,0.0003115870201488,37,47
760,just_relax,0.05,0,0,0,0.0,0.0007350584472026,21,21
761,just_relax,0.05,0,0,0,0.0,9.621758975453254e-06,11,10
762,just_relax,0.05,57,55,2,-1.1796960984034186,9.734149291917849e-05,44,80
763,just_relax,0.05,6,6,0,0.0001929725905256,-1.6711583069151104e-05,12,21
764,just_relax,0.05,2,5,-3,10.477360070400792,-0.0167672873232497,37,43
765,just_relax,0.05,6,6,0,-9.27967616917158e-05,0.0005867078171852,41,52
766,just_relax,0.05,0,0,0,0.0,0.0258238191424075,90,89
767,just_relax,0.05,0,0,0,0.0,-0.0001762041220683,22,21
768,just_relax,0.05,1,5,-4,-25.99394547658536,0.034397478016983,37,43
769,just_relax,0.05,0,0,0,0.0,0.009279908390236,47,47
770,just_relax,0.05,4,4,0,-0.0003372893218767,-9.212772776878708e-07,12,20
771,just_relax,0.05,114,95,19,0.8287298242191525,-0.006531385777559,84,124
772,just_relax,0.05,0,0,0,0.0,0.0016708237920683,88,92
773,just_relax,0.05,380,332,48,-1.681066658089314,0.0270328691740772,59,122
774,just_relax,0.05,4,4,0,2.0677824380754828e-05,-0.000363330475558,26,31
775,just_relax,0.05,0,0,0,0.0,4.418930553695688e-06,28,27
776,just_relax,0.05,6,6,0,0.0013890930604816,7.243956427815945e-06,18,26
777,just_relax,0.05,1,1,0,-0.0014241348598034,0.001861633846505,23,26
778,just_relax,0.05,0,0,0,0.0,0.0001814651838247,43,43
779,just_relax,0.05,2,2,0,0.0004949068667485,0.0012137972461528,22,26
780,just_relax,0.05,0,0,0,0.0,8.316094011640018e-06,15,14
781,just_relax,0.05,10,17,-7,3.5874123628873704,0.0856058777554238,36,48
782,just_relax,0.05,6,6,0,2.8016025522275783,-0.3535412006642752,30,37
783,just_relax,0.05,1,1,0,5.455328151526828e-05,-4.433967369288361e-05,10,13
784,just_relax,0.05,0,0,0,0.0,-0.0049855760382295,12,11
785,just_relax,0.05,168,182,-14,1.1771250480206064,-0.0267800915114647,55,105
786,just_relax,0.05,1,1,0,17.12164821735773,0.0578261695456346,13,17
787,just_relax,0.05,0,0,0,0.0,0.0003329515887838,30,29
788,just_relax,0.05,3,3,0,0.000583815366788,0.0008768881680062,36,43
789,just_relax,0.05,36,36,0,0.0010314806767866,-5.393936385500453e-05,40,60
790,just_relax,0.05,0,0,0,0.0,0.0017894746066188,13,17
791,just_relax,0.05,6,7,-1,-5.27235869178908,0.0082826452568239,23,30
792,just_relax,0.05,0,0,0,0.0,-2.940409977925107e-05,12,16
793,just_relax,0.05,0,0,0,0.0,3.901708024223183e-06,26,26
794,just_relax,0.05,0,0,0,0.0,-0.0031688166024113,22,31
795,just_relax,0.05,0,0,0,0.0,0.0008768193667615,68,68
796,just_relax,0.05,0,0,0,0.0,-7.938175057398134e-06,23,22
797,just_relax,0.05,0,0,0,0.0,-0.065399188004364,43,42
798,just_relax,0.05,0,0,0,0.0,-0.002899723134464,18,17
799,just_relax,0.05,3,3,0,-0.003194586812441,0.0012605153222713,28,42
800,just_relax,0.05,45,58,-13,0.9231299892006462,0.088218433779717,21,44
801,just_relax,0.05,0,0,0,0.0,-0.0112811671875761,36,37
802,just_relax,0.05,0,0,0,0.0,-3.4878924121017896e-05,15,14
803,just_relax,0.05,1,1,0,-0.0014549239964907,-0.00058525619921,14,16
804,just_relax,0.05,197,237,-40,1.3477492998050025,0.0885093784332623,61,119
805,just_relax,0.05,0,0,0,0.0,-0.0038599581671643,19,20
806,just_relax,0.05,0,0,0,0.0,-0.0006472841631984,22,22
807,just_relax,0.05,0,0,0,0.0,-0.0011415137972972,54,58
808,just_relax,0.05,651,651,0,-0.0003954210755097,0.0002252638081207,65,135
809,just_relax,0.05,1,1,0,-0.0029471577812358,0.0001749400264638,16,18
810,just_relax,0.05,7,7,0,0.0002013814076775,0.0006636994664107,17,27
811,just_relax,0.05,22,7,15,-12.985895473169307,0.1330374466905183,54,71
812,just_relax,0.05,0,2,-2,-59.99819093035041,-0.0131455917893484,23,22
813,just_relax,0.05,1,0,1,76.88395716132196,-0.1491322016956315,13,16
814,just_relax,0.05,155,185,-30,2.3843149677438973,-0.02495720013905,85,131
815,just_relax,0.05,44,44,0,0.0003032918935019,0.0025857794052007,28,55
816,just_relax,0.05,4,4,0,-0.0007096785766407,-5.4537984728875166e-05,18,24
817,just_relax,0.05,0,0,0,0.0,-0.003226028074061,19,22
818,just_relax,0.05,0,0,0,0.0,0.0048197166778652,47,46
819,just_relax,0.05,21,27,-6,0.0602947270368474,-0.3310372682946312,39,64
820,just_relax,0.05,0,0,0,0.0,-0.0037052423868473,17,18
821,just_relax,0.05,1,1,0,0.0005119856857191,0.0004745196477359,23,24
822,just_relax,0.05,2,2,0,0.0010275548569325,-0.004970471779609,13,16
823,just_relax,0.05,22,22,0,0.0038770082111057,0.0004285387996507,40,56
824,just_relax,0.05,1,1,0,-0.0002865966515059,-0.0003325971221349,10,15
825,just_relax,0.05,0,0,0,0.0,0.0003384089422906,21,20
826,just_relax,0.05,4,4,0,-0.0001029723687508,-0.0013906355929786,30,35
827,just_relax,0.05,1,1,0,0.0051043410712594,-0.0056156512673798,71,77
828,relax_and_recompute,0.1,0,0,0,0.0,0.0,17,18
829,relax_and_recompute,0.1,1,3,-2,28.460357396396503,-0.2850059406919234,43,48
830,relax_and_recompute,0.1,3,5,-2,9.88581419291326,0.0069193652867528,38,45
831,relax_and_recompute,0.1,0,0,0,0.0,0.0,12,12
832,relax_and_recompute,0.1,20,7,13,1.502478168846423,0.2029862696446577,23,38
833,relax_and_recompute,0.1,0,4,-4,-48.30308812678022,-0.0347389939534301,19,22
834,relax_and_recompute,0.1,976,1004,-28,-0.0620531910963606,-0.0009330148689207,35,143
835,relax_and_recompute,0.1,0,0,0,0.0,-0.0046858462976494,92,91
836,relax_and_recompute,0.1,2,2,0,0.0,0.0,43,51
837,relax_and_recompute,0.1,1,1,0,0.0,0.0,35,36
838,relax_and_recompute,0.1,1,0,1,78.01020667896776,-0.0180391783628361,11,13
839,relax_and_recompute,0.1,22,19,3,-4.957652547927751,0.037406937188411,10,25
840,relax_and_recompute,0.1,16,16,0,-1.2375805476415778,-0.0662978026850604,86,136
841,relax_and_recompute,0.1,0,0,0,0.0,0.0,10,12
842,relax_and_recompute,0.1,0,0,0,0.0,0.0,32,31
843,relax_and_recompute,0.1,2,2,0,0.8097822186271628,0.0720915422264546,20,26
844,relax_and_recompute,0.1,0,0,0,0.0,0.0,11,11
845,relax_and_recompute,0.1,2,2,0,1.6133031779469889,-0.0013837411504996,34,42
846,relax_and_recompute,0.1,11,10,1,1.5445267212396203,-0.0356816848306716,14,25
847,relax_and_recompute,0.1,8,4,4,9.035240939106416,-0.2006547963227668,31,46
848,relax_and_recompute,0.1,0,2,-2,-60.43825847577355,-0.1126466588104083,42,45
849,relax_and_recompute,0.1,1265,1233,32,-0.0829886923942524,-0.0013136328692162,39,173
850,relax_and_recompute,0.1,11,10,1,-0.9259083214164718,-0.0036589420660914,14,24
851,relax_and_recompute,0.1,0,0,0,0.0,0.0,24,25
852,relax_and_recompute,0.1,2,3,-1,18.97015617968725,0.1057791903370561,12,19
853,relax_and_recompute,0.1,59,59,0,0.0004995248301611,-0.0021609985989152,41,72
854,relax_and_recompute,0.1,182,192,-10,2.176227062990442,0.127488881317396,59,115
855,relax_and_recompute,0.1,6,4,2,3.763676058520289,0.4612476699024008,32,37
856,relax_and_recompute,0.1,1,0,1,64.5674534074053,-0.141219001604035,20,20
857,relax_and_recompute,0.1,41,26,15,-1.6275846340626714,0.0729158968985802,12,31
858,relax_and_recompute,0.1,0,0,0,0.0,-0.1246606963590727,10,10
859,relax_and_recompute,0.1,0,0,0,0.0,0.0,20,21
860,relax_and_recompute,0.1,18,21,-3,0.5719110189928784,0.3696791622426242,39,52
861,relax_and_recompute,0.1,378,393,-15,0.6108526484877643,4.422482210819645e-05,42,109
862,relax_and_recompute,0.1,1,9,-8,21.83036785786023,-0.009946187399486,25,28
863,relax_and_recompute,0.1,170,157,13,-3.523679109137184,0.105536041898159,56,106
864,relax_and_recompute,0.1,567,575,-8,0.4383057260994292,-0.0017656065849445,87,189
865,relax_and_recompute,0.1,41,40,1,-2.249384452446378,-0.0072514307594979,56,82
866,relax_and_recompute,0.1,2,2,0,-8.392740270897733,0.5389967143152127,13,15
867,relax_and_recompute,0.1,104,88,16,-3.3995451437074067,-0.111275141568526,36,63
868,relax_and_recompute,0.1,0,0,0,0.0,0.0,16,15
869,relax_and_recompute,0.1,0,0,0,0.0,-0.0061884200170785,67,66
870,relax_and_recompute,0.1,13,13,0,0.0,0.0,42,60
871,relax_and_recompute,0.1,0,0,0,0.0,0.0,39,38
872,relax_and_recompute,0.1,8,9,-1,8.482609675305326,-0.0246353290916525,20,36
873,relax_and_recompute,0.1,0,0,0,0.0,0.0,10,9
874,relax_and_recompute,0.1,1,1,0,0.0,0.0,13,15
875,relax_and_recompute,0.1,6,14,-8,18.824286639655867,-0.0841754274640885,34,41
876,relax_and_recompute,0.1,3,5,-2,3.41159566991864,0.101618768403258,37,42
877,relax_and_recompute,0.1,36,36,0,0.0,0.0,18,29
878,relax_and_recompute,0.1,0,0,0,0.0,0.0314532687439244,23,22
879,relax_and_recompute,0.1,0,0,0,0.0,0.1253462347742774,13,12
880,relax_and_recompute,0.1,0,0,0,0.0,0.0,15,14
881,relax_and_recompute,0.1,0,0,0,0.0,0.0,69,68
882,relax_and_recompute,0.1,0,0,0,0.0,0.0,40,39
883,relax_and_recompute,0.1,0,0,0,0.0,0.0,89,93
884,relax_and_recompute,0.1,13,12,1,-2.153586113029718,-0.0708055525167026,20,32
885,relax_and_recompute,0.1,2,3,-1,-7.067084936198143,-0.0593654442548075,69,83
886,relax_and_recompute,0.1,2,3,-1,27.20264453478205,-0.1015090195781462,12,15
887,relax_and_recompute,0.1,0,0,0,0.0,0.0,15,14
888,relax_and_recompute,0.1,0,1,-1,-73.35995106543365,-0.0661284376918611,23,26
889,relax_and_recompute,0.1,2,2,0,7.435447086102371,0.0512250419227734,12,20
890,relax_and_recompute,0.1,201,208,-7,-0.777546499391029,-0.0168449909220319,64,122
891,relax_and_recompute,0.1,7,3,4,-15.3477275810384,-0.0042339303565398,58,71
892,relax_and_recompute,0.1,0,0,0,0.0,-0.1147932957929044,20,19
893,relax_and_recompute,0.1,510,512,-2,-0.0138388627329746,-0.001793654381577,100,191
894,relax_and_recompute,0.1,34,34,0,0.0,0.0,41,61
895,relax_and_recompute,0.1,33,34,-1,-0.5384989905164446,0.0398816997391653,13,31
896,relax_and_recompute,0.1,5,3,2,12.118750923999592,-0.1168739524455244,10,15
897,relax_and_recompute,0.1,6,5,1,2.3116501951879656,-0.0709648635201967,37,47
898,relax_and_recompute,0.1,0,0,0,0.0,-0.0059846962189432,21,21
899,relax_and_recompute,0.1,0,0,0,0.0,0.0,11,10
900,relax_and_recompute,0.1,57,57,0,0.0064914760634735,-0.0077421754008314,44,80
901,relax_and_recompute,0.1,6,6,0,0.0,0.0,12,21
902,relax_and_recompute,0.1,2,2,0,40.57817790180843,-0.0379305285754828,37,43
903,relax_and_recompute,0.1,6,8,-2,-0.1735310719531781,0.0463842795036362,41,52
904,relax_and_recompute,0.1,0,0,0,0.0,0.0,90,89
905,relax_and_recompute,0.1,0,0,0,0.0,0.0,22,21
906,relax_and_recompute,0.1,1,6,-5,-12.824308725883805,-0.0280060439235303,37,43
907,relax_and_recompute,0.1,0,1,-1,-89.65010094514068,0.1086179312853023,47,47
908,relax_and_recompute,0.1,4,6,-2,16.941840910668297,-0.0594288998091482,12,20
909,relax_and_recompute,0.1,114,114,0,0.0,0.0,84,124
910,relax_and_recompute,0.1,0,0,0,0.0,0.0,88,92
911,relax_and_recompute,0.1,380,377,3,-0.3714807714610657,-0.0025427242202904,59,122
912,relax_and_recompute,0.1,4,3,1,0.203280810508815,0.0446821006516815,26,31
913,relax_and_recompute,0.1,0,0,0,0.0,0.0,28,27
914,relax_and_recompute,0.1,6,6,0,0.0,0.0,18,26
915,relax_and_recompute,0.1,1,3,-2,-12.914228578214503,0.0322817081119266,23,26
916,relax_and_recompute,0.1,0,5,-5,-0.8399978558704028,-0.0099238347816712,43,43
917,relax_and_recompute,0.1,2,3,-1,26.34761393126834,0.2227207785283125,22,26
918,relax_and_recompute,0.1,0,0,0,0.0,0.0,15,14
919,relax_and_recompute,0.1,10,19,-9,5.648675414166,0.1018849030252861,36,48
920,relax_and_recompute,0.1,6,6,0,3.132031887299874,-0.366934867361315,30,37
921,relax_and_recompute,0.1,1,1,0,11.616152189123014,-0.2081405675796964,10,13
922,relax_and_recompute,0.1,0,0,0,0.0,0.0,12,11
923,relax_and_recompute,0.1,168,153,15,-1.4597591062543387,0.1638614131178267,55,105
924,relax_and_recompute,0.1,1,1,0,16.028380475211264,0.0421533847818661,13,17
925,relax_and_recompute,0.1,0,0,0,0.0,0.0,30,29
926,relax_and_recompute,0.1,3,4,-1,-9.905682406522075,-0.002170500293968,36,43
927,relax_and_recompute,0.1,36,40,-4,-3.781728400218512,-0.055822645815706,40,60
928,relax_and_recompute,0.1,0,0,0,0.0,0.0802672977734813,13,17
929,relax_and_recompute,0.1,6,8,-2,-4.960402959672933,-0.0115319394462201,23,30
930,relax_and_recompute,0.1,0,1,-1,-42.83711828492631,-0.075967346402093,12,16
931,relax_and_recompute,0.1,0,3,-3,-56.243046788228376,0.0779735480437637,26,26
932,relax_and_recompute,0.1,0,0,0,0.0,-0.0250790796226426,22,31
933,relax_and_recompute,0.1,0,0,0,0.0,0.0,68,68
934,relax_and_recompute,0.1,0,0,0,0.0,-0.0174814040660411,23,22
935,relax_and_recompute,0.1,0,0,0,0.0,-0.0349525596057489,43,42
936,relax_and_recompute,0.1,0,0,0,0.0,0.0,18,17
937,relax_and_recompute,0.1,3,1,2,16.774590073756514,-0.1297888041253873,28,42
938,relax_and_recompute,0.1,45,50,-5,1.8841541587735409,0.0156030402407787,21,44
939,relax_and_recompute,0.1,0,0,0,0.0,0.0,36,37
940,relax_and_recompute,0.1,0,0,0,0.0,0.0,15,14
941,relax_and_recompute,0.1,1,1,0,66.99851956452005,0.1736018005328949,14,16
942,relax_and_recompute,0.1,197,211,-14,1.6294158914226389,0.1952030013326532,61,119
943,relax_and_recompute,0.1,0,0,0,0.0,0.0058120147104488,19,20
944,relax_and_recompute,0.1,0,2,-2,-52.79175496631128,0.0259444423045324,22,22
945,relax_and_recompute,0.1,0,0,0,0.0,-0.0413225144380497,54,58
946,relax_and_recompute,0.1,651,651,0,0.0,0.0,65,135
947,relax_and_recompute,0.1,1,2,-1,14.33353360487856,0.1107316083006457,16,18
948,relax_and_recompute,0.1,7,8,-1,8.396787180550831,0.1080910940256584,17,27
949,relax_and_recompute,0.1,22,4,18,-18.61747849085588,0.1446288399504806,54,71
950,relax_and_recompute,0.1,0,2,-2,-69.51467976885004,-0.0285407675374049,23,22
951,relax_and_recompute,0.1,1,2,-1,29.01115049910844,-0.3825499618326466,13,16
952,relax_and_recompute,0.1,155,149,6,-2.794184228530185,-0.0034415506621975,85,131
953,relax_and_recompute,0.1,44,58,-14,6.627037203531586,0.0061263330641294,28,55
954,relax_and_recompute,0.1,4,4,0,17.431676694704336,-0.0893290688064797,18,24
955,relax_and_recompute,0.1,0,2,-2,-42.90819456532754,-0.0171451020274844,19,22
956,relax_and_recompute,0.1,0,1,-1,-82.00366620821269,0.0734444320361835,47,46
957,relax_and_recompute,0.1,21,21,0,-3.6879171991704425,0.0716976646866419,39,64
958,relax_and_recompute,0.1,0,0,0,0.0,0.0,17,18
959,relax_and_recompute,0.1,1,1,0,-3.0008060687584788,-0.26620686235521,23,24
960,relax_and_recompute,0.1,2,2,0,-2.1515607672736223,0.0826566971112059,13,16
961,relax_and_recompute,0.1,22,13,9,-0.7653465239512514,0.0480027811499798,40,56
962,relax_and_recompute,0.1,1,1,0,-6.456334298675088,-0.0400486519001042,10,15
963,relax_and_recompute,0.1,0,1,-1,-57.66922851609199,0.2540749528999112,21,20
964,relax_and_recompute,0.1,4,5,-1,20.74881945520164,-0.1306207019803847,30,35
965,relax_and_recompute,0.1,1,1,0,0.0,0.0,71,77
966,relax_one,0.1,0,0,0,0.0,0.0,17,18
967,relax_one,0.1,1,1,0,0.0,0.0,43,48
968,relax_one,0.1,3,3,0,0.0,0.0,38,45
969,relax_one,0.1,0,0,0,0.0,0.0,12,12
970,relax_one,0.1,20,18,2,-3.2752299140735204,0.0114158034923678,23,38
971,relax_one,0.1,0,1,-1,-78.11694026732484,-0.0295512202700576,19,22
972,relax_one,0.1,976,978,-2,0.1423455471242221,-0.0025418055405018,35,143
973,relax_one,0.1,0,1,-1,-50.19567681247512,-0.0041327022016595,92,91
974,relax_one,0.1,2,2,0,0.0,0.0,43,51
975,relax_one,0.1,1,1,0,0.0,0.0,35,36
976,relax_one,0.1,1,1,0,0.0,0.0,11,13
977,relax_one,0.1,22,20,2,-3.01441643358082,0.0082886474985522,10,25
978,relax_one,0.1,16,16,0,0.0,0.0,86,136
979,relax_one,0.1,0,0,0,0.0,0.0,10,12
980,relax_one,0.1,0,0,0,0.0,0.0,32,31
981,relax_one,0.1,2,2,0,4.970962038347736,-0.0904350603192869,20,26
982,relax_one,0.1,0,0,0,0.0,0.0,11,11
983,relax_one,0.1,2,2,0,0.0,0.0,34,42
984,relax_one,0.1,11,11,0,0.0,0.0,14,25
985,relax_one,0.1,8,7,1,13.99583228956454,0.1582030612456263,31,46
986,relax_one,0.1,0,0,0,0.0,0.0,42,45
987,relax_one,0.1,1265,1240,25,0.1009906236120983,0.0001682713719424,39,173
988,relax_one,0.1,11,11,0,0.0,0.0,14,24
989,relax_one,0.1,0,0,0,0.0,0.0,24,25
990,relax_one,0.1,2,2,0,0.0,0.0,12,19
991,relax_one,0.1,59,59,0,0.4609819410147793,0.0044552421238692,41,72
992,relax_one,0.1,182,191,-9,1.446975953367918,0.0358261975695221,59,115
993,relax_one,0.1,6,6,0,0.0,0.0,32,37
994,relax_one,0.1,1,1,0,0.0,0.0,20,20
995,relax_one,0.1,41,32,9,2.305146048931391,0.0775874222420341,12,31
996,relax_one,0.1,0,0,0,0.0,0.0,10,10
997,relax_one,0.1,0,0,0,0.0,0.0,20,21
998,relax_one,0.1,18,18,0,0.0,0.0,39,52
999,relax_one,0.1,378,395,-17,-0.4859193577000411,-0.0010324457545943,42,109
1000,relax_one,0.1,1,1,0,0.0,0.0,25,28
1001,relax_one,0.1,170,170,0,0.0,0.0,56,106
1002,relax_one,0.1,567,595,-28,0.7834114754025379,-0.002967395777259,87,189
1003,relax_one,0.1,41,41,0,-3.1762323320181167,-0.0099859384844429,56,82
1004,relax_one,0.1,2,2,0,0.0,0.0,13,15
1005,relax_one,0.1,104,88,16,-3.3995451437074067,-0.111275141568526,36,63
1006,relax_one,0.1,0,0,0,0.0,0.0,16,15
1007,relax_one,0.1,0,0,0,0.0,0.0,67,66
1008,relax_one,0.1,13,13,0,0.0,0.0,42,60
1009,relax_one,0.1,0,0,0,0.0,0.0,39,38
1010,relax_one,0.1,8,8,0,0.0,0.0,20,36
1011,relax_one,0.1,0,0,0,0.0,0.0,10,9
1012,relax_one,0.1,1,1,0,0.0,0.0,13,15
1013,relax_one,0.1,6,7,-1,12.522285729298716,0.0299062089849014,34,41
1014,relax_one,0.1,3,3,0,0.0,0.0,37,42
1015,relax_one,0.1,36,36,0,0.0,0.0,18,29
1016,relax_one,0.1,0,0,0,0.0,0.0,23,22
1017,relax_one,0.1,0,0,0,0.0,0.0,13,12
1018,relax_one,0.1,0,0,0,0.0,0.0,15,14
1019,relax_one,0.1,0,0,0,0.0,0.0,69,68
1020,relax_one,0.1,0,0,0,0.0,0.0,40,39
1021,relax_one,0.1,0,0,0,0.0,0.0,89,93
1022,relax_one,0.1,13,13,0,-2.975681235416161,-0.0847204542309565,20,32
1023,relax_one,0.1,2,2,0,0.0,0.0,69,83
1024,relax_one,0.1,2,2,0,0.0,0.0,12,15
1025,relax_one,0.1,0,0,0,0.0,0.0,15,14
1026,relax_one,0.1,0,0,0,0.0,0.0,23,26
1027,relax_one,0.1,2,2,0,0.0,0.0,12,20
1028,relax_one,0.1,201,201,0,0.0,0.0,64,122
1029,relax_one,0.1,7,7,0,0.0,0.0,58,71
1030,relax_one,0.1,0,0,0,0.0,0.0,20,19
1031,relax_one,0.1,510,510,0,0.0060639005596385,-0.0006916839131552,100,191
1032,relax_one,0.1,34,34,0,0.0,0.0,41,61
1033,relax_one,0.1,33,34,-1,-0.6264707699284884,0.0331924782664471,13,31
1034,relax_one,0.1,5,5,0,0.0,0.0,10,15
1035,relax_one,0.1,6,6,0,0.0,0.0,37,47
1036,relax_one,0.1,0,0,0,0.0,0.0,21,21
1037,relax_one,0.1,0,0,0,0.0,0.0,11,10
1038,relax_one,0.1,57,55,2,-1.1796960984034186,9.734149291917849e-05,44,80
1039,relax_one,0.1,6,6,0,0.0,0.0,12,21
1040,relax_one,0.1,2,2,0,42.15913628345388,-0.0181760816329957,37,43
1041,relax_one,0.1,6,6,0,0.0,0.0,41,52
1042,relax_one,0.1,0,0,0,0.0,0.0,90,89
1043,relax_one,0.1,0,0,0,0.0,0.0,22,21
1044,relax_one,0.1,1,1,0,-4.213527745425694,0.0417394626549948,37,43
1045,relax_one,0.1,0,0,0,0.0,0.0,47,47
1046,relax_one,0.1,4,4,0,0.0,0.0,12,20
1047,relax_one,0.1,114,114,0,0.0,0.0,84,124
1048,relax_one,0.1,0,0,0,0.0,0.0,88,92
1049,relax_one,0.1,380,377,3,-0.3714807714610657,-0.0025427242202904,59,122
1050,relax_one,0.1,4,4,0,0.0,0.0,26,31
1051,relax_one,0.1,0,0,0,0.0,0.0,28,27
1052,relax_one,0.1,6,6,0,0.0,0.0,18,26
1053,relax_one,0.1,1,1,0,0.0,0.0,23,26
1054,relax_one,0.1,0,0,0,0.0,0.0,43,43
1055,relax_one,0.1,2,2,0,0.0,0.0,22,26
1056,relax_one,0.1,0,0,0,0.0,0.0,15,14
1057,relax_one,0.1,10,17,-7,3.5874123628873704,0.0856058777554238,36,48
1058,relax_one,0.1,6,6,0,2.8016025522275783,-0.3535412006642752,30,37
1059,relax_one,0.1,1,1,0,0.0,0.0,10,13
1060,relax_one,0.1,0,0,0,0.0,0.0,12,11
1061,relax_one,0.1,168,167,1,-0.7965879277094672,0.0475430066924907,55,105
1062,relax_one,0.1,1,1,0,17.12164821735773,0.0578261695456346,13,17
1063,relax_one,0.1,0,0,0,0.0,0.0,30,29
1064,relax_one,0.1,3,3,0,0.0,0.0,36,43
1065,relax_one,0.1,36,36,0,0.0,0.0,40,60
1066,relax_one,0.1,0,0,0,0.0,0.0,13,17
1067,relax_one,0.1,6,7,-1,-5.27235869178908,0.0082826452568239,23,30
1068,relax_one,0.1,0,0,0,0.0,0.0,12,16
1069,relax_one,0.1,0,0,0,0.0,0.0,26,26
1070,relax_one,0.1,0,0,0,0.0,0.0,22,31
1071,relax_one,0.1,0,0,0,0.0,0.0,68,68
1072,relax_one,0.1,0,0,0,0.0,0.0,23,22
1073,relax_one,0.1,0,0,0,0.0,-0.0348129737608335,43,42
1074,relax_one,0.1,0,0,0,0.0,0.0,18,17
1075,relax_one,0.1,3,3,0,0.0,0.0,28,42
1076,relax_one,0.1,45,45,0,0.1036479088850654,-0.0041754562964496,21,44
1077,relax_one,0.1,0,0,0,0.0,0.0,36,37
1078,relax_one,0.1,0,0,0,0.0,0.0,15,14
1079,relax_one,0.1,1,1,0,0.0,0.0,14,16
1080,relax_one,0.1,197,204,-7,3.484436282689749,0.1757315340586914,61,119
1081,relax_one,0.1,0,0,0,0.0,0.0,19,20
1082,relax_one,0.1,0,0,0,0.0,0.0,22,22
1083,relax_one,0.1,0,0,0,0.0,0.0,54,58
1084,relax_one,0.1,651,651,0,0.0,0.0,65,135
1085,relax_one,0.1,1,1,0,0.0,0.0,16,18
1086,relax_one,0.1,7,7,0,0.0,0.0,17,27
1087,relax_one,0.1,22,4,18,-19.06910671434205,0.1469333863626725,54,71
1088,relax_one,0.1,0,2,-2,-59.99819093035041,-0.0131455917893484,23,22
1089,relax_one,0.1,1,0,1,76.88395716132196,-0.1491322016956315,13,16
1090,relax_one,0.1,155,146,9,-2.3741667241416664,-0.001397205031107,85,131
1091,relax_one,0.1,44,44,0,0.0,0.0,28,55
1092,relax_one,0.1,4,4,0,0.0,0.0,18,24
1093,relax_one,0.1,0,0,0,0.0,0.0,19,22
1094,relax_one,0.1,0,0,0,0.0,0.0,47,46
1095,relax_one,0.1,21,19,2,-6.356920988253222,0.0143956759658575,39,64
1096,relax_one,0.1,0,0,0,0.0,0.0,17,18
1097,relax_one,0.1,1,1,0,0.0,0.0,23,24
1098,relax_one,0.1,2,2,0,0.0,0.0,13,16
1099,relax_one,0.1,22,22,0,0.0,0.0,40,56
1100,relax_one,0.1,1,1,0,0.0,0.0,10,15
1101,relax_one,0.1,0,0,0,0.0,0.0,21,20
1102,relax_one,0.1,4,4,0,0.0,0.0,30,35
1103,relax_one,0.1,1,1,0,0.0,0.0,71,77
1104,just_relax,0.1,0,0,0,0.0,-0.0091692815110081,17,18
1105,just_relax,0.1,1,1,0,0.0009607869158827,0.0014628518031132,43,48
1106,just_relax,0.1,3,3,0,-0.0019521681741139,-7.679999619569777e-05,38,45
1107,just_relax,0.1,0,0,0,0.0,-0.0037600566419999,12,12
1108,just_relax,0.1,20,14,6,1.9891400956483096,0.1544148745043621,23,38
1109,just_relax,0.1,0,1,-1,-78.11694026732484,-0.0295512202700576,19,22
1110,just_relax,0.1,976,1188,-212,1.3106081233515638,0.0257948127350838,35,143
1111,just_relax,0.1,0,4,-4,-39.1818408082167,-0.0156618414823971,92,91
1112,just_relax,0.1,2,2,0,-0.00041775540015,-0.0002552385505018,43,51
1113,just_relax,0.1,1,1,0,-0.0016870080925173,6.40249009676297e-05,35,36
1114,just_relax,0.1,1,1,0,-0.000156439410091,0.0002508982184644,11,13
1115,just_relax,0.1,22,24,-2,-3.49415891827384,0.1000113687896936,10,25
1116,just_relax,0.1,16,13,3,0.2088785180214571,-2.2771107622610032e-05,86,136
1117,just_relax,0.1,0,0,0,0.0,-1.765503840900351e-06,10,12
1118,just_relax,0.1,0,0,0,0.0,-1.014518260578079e-05,32,31
1119,just_relax,0.1,2,2,0,4.970962038347736,-0.0904350603192869,20,26
1120,just_relax,0.1,0,0,0,0.0,0.000269092021105,11,11
1121,just_relax,0.1,2,2,0,0.0009292844165713,-0.0008610890242942,34,42
1122,just_relax,0.1,11,11,0,-0.0003616788843885,0.0005035529702898,14,25
1123,just_relax,0.1,8,7,1,13.99583228956454,0.1582030612456263,31,46
1124,just_relax,0.1,0,0,0,0.0,0.0042083907430441,42,45
1125,just_relax,0.1,1265,1285,-20,2.6849459664833404,-0.1292871249874528,39,173
1126,just_relax,0.1,11,11,0,0.0001627700527109,0.0015600944076981,14,24
1127,just_relax,0.1,0,0,0,0.0,-0.000608053012485,24,25
1128,just_relax,0.1,2,2,0,-2.981324638540173e-05,0.0001440646714581,12,19
1129,just_relax,0.1,59,59,0,0.4609819410147793,0.0044552421238692,41,72
1130,just_relax,0.1,182,178,4,0.0313317398119608,0.0970080713564147,59,115
1131,just_relax,0.1,6,6,0,-0.0020404096920856,0.0011964290694836,32,37
1132,just_relax,0.1,1,0,1,64.5674534074053,-0.0013228453280204,20,20
1133,just_relax,0.1,41,33,8,8.182357833947279,-0.009895766072516,12,31
1134,just_relax,0.1,0,0,0,0.0,-1.5942199658169898e-06,10,10
1135,just_relax,0.1,0,0,0,0.0,0.0018153466622625,20,21
1136,just_relax,0.1,18,18,0,0.0003589278580733,-0.0005865039043362,39,52
1137,just_relax,0.1,378,369,9,2.979528253482861,0.0835817869771829,42,109
1138,just_relax,0.1,1,1,0,-0.0010366044558338,-5.546321229055184e-05,25,28
1139,just_relax,0.1,170,170,0,-0.0002769762706833,-0.0005002245004087,56,106
1140,just_relax,0.1,567,521,46,-0.2657392120378574,0.1239070997048957,87,189
1141,just_relax,0.1,41,43,-2,2.499128887843675,-0.033528056765164,56,82
1142,just_relax,0.1,2,2,0,0.0004861774901456,1.2071037781558047e-06,13,15
1143,just_relax,0.1,104,86,18,5.26724471872344,-0.2840091449765524,36,63
1144,just_relax,0.1,0,0,0,0.0,4.3915154694929015e-06,16,15
1145,just_relax,0.1,0,0,0,0.0,-5.223096419815221e-07,67,66
1146,just_relax,0.1,13,13,0,0.0024384647237383,0.004260897920215,42,60
1147,just_relax,0.1,0,0,0,0.0,0.0005903979895692,39,38
1148,just_relax,0.1,8,8,0,-3.330899971842882e-05,0.0005334774465118,20,36
1149,just_relax,0.1,0,0,0,0.0,-0.0010596071395927,10,9
1150,just_relax,0.1,1,1,0,0.0009644178095271,-1.805181839154013e-05,13,15
1151,just_relax,0.1,6,7,-1,12.522285729298716,0.0299062089849014,34,41
1152,just_relax,0.1,3,3,0,-0.0014185667246167,0.0006213779664755,37,42
1153,just_relax,0.1,36,36,0,7.196136941445275e-06,5.025038399830706e-06,18,29
1154,just_relax,0.1,0,0,0,0.0,-0.0031405837993232,23,22
1155,just_relax,0.1,0,0,0,0.0,1.0504657718901632e-05,13,12
1156,just_relax,0.1,0,0,0,0.0,-0.0007613272869088,15,14
1157,just_relax,0.1,0,0,0,0.0,-0.0017207203528439,69,68
1158,just_relax,0.1,0,0,0,0.0,0.001934163275203,40,39
1159,just_relax,0.1,0,0,0,0.0,0.0016954512903432,89,93
1160,just_relax,0.1,13,13,0,1.511050374969713,-0.0878570612978808,20,32
1161,just_relax,0.1,2,3,-1,-4.120223819609976,0.0096644512108772,69,83
1162,just_relax,0.1,2,2,0,0.0006766545457281,-0.0007958153584334,12,15
1163,just_relax,0.1,0,0,0,0.0,-0.0009758471183408,15,14
1164,just_relax,0.1,0,0,0,0.0,-0.0007570529942456,23,26
1165,just_relax,0.1,2,2,0,-0.0004670837519427,-0.000552899751354,12,20
1166,just_relax,0.1,201,201,0,-5.927609844036397e-05,0.0001073571901385,64,122
1167,just_relax,0.1,7,7,0,-0.0099055150386959,0.0003544031231826,58,71
1168,just_relax,0.1,0,0,0,0.0,-0.0013086772972689,20,19
1169,just_relax,0.1,510,505,5,-0.1096058695008466,0.0001562332230281,100,191
1170,just_relax,0.1,34,34,0,0.0046498502251353,3.462795885833536e-05,41,61
1171,just_relax,0.1,33,21,12,-0.322372772893118,0.0487025778316814,13,31
1172,just_relax,0.1,5,5,0,0.0003476406123752,0.0002826333043987,10,15
1173,just_relax,0.1,6,6,0,-0.0004254358946269,0.0003115870201488,37,47
1174,just_relax,0.1,0,0,0,0.0,0.0007350584472026,21,21
1175,just_relax,0.1,0,0,0,0.0,9.621758975453254e-06,11,10
1176,just_relax,0.1,57,55,2,-1.1796960984034186,9.734149291917849e-05,44,80
1177,just_relax,0.1,6,6,0,0.0001929725905256,-1.6711583069151104e-05,12,21
1178,just_relax,0.1,2,5,-3,10.477360070400792,-0.0167672873232497,37,43
1179,just_relax,0.1,6,6,0,-9.27967616917158e-05,0.0005867078171852,41,52
1180,just_relax,0.1,0,0,0,0.0,0.0258238191424075,90,89
1181,just_relax,0.1,0,0,0,0.0,-0.0001762041220683,22,21
1182,just_relax,0.1,1,5,-4,-25.99394547658536,0.034397478016983,37,43
1183,just_relax,0.1,0,0,0,0.0,0.009279908390236,47,47
1184,just_relax,0.1,4,4,0,-0.0003372893218767,-9.212772776878708e-07,12,20
1185,just_relax,0.1,114,95,19,0.8287298242191525,-0.006531385777559,84,124
1186,just_relax,0.1,0,0,0,0.0,0.0016708237920683,88,92
1187,just_relax,0.1,380,332,48,-1.681066658089314,0.0270328691740772,59,122
1188,just_relax,0.1,4,4,0,2.0677824380754828e-05,-0.000363330475558,26,31
1189,just_relax,0.1,0,0,0,0.0,4.418930553695688e-06,28,27
1190,just_relax,0.1,6,6,0,0.0013890930604816,7.243956427815945e-06,18,26
1191,just_relax,0.1,1,1,0,-0.0014241348598034,0.001861633846505,23,26
1192,just_relax,0.1,0,0,0,0.0,0.0001814651838247,43,43
1193,just_relax,0.1,2,2,0,0.0004949068667485,0.0012137972461528,22,26
1194,just_relax,0.1,0,0,0,0.0,8.316094011640018e-06,15,14
1195,just_relax,0.1,10,17,-7,3.5874123628873704,0.0856058777554238,36,48
1196,just_relax,0.1,6,6,0,2.8016025522275783,-0.3535412006642752,30,37
1197,just_relax,0.1,1,1,0,5.455328151526828e-05,-4.433967369288361e-05,10,13
1198,just_relax,0.1,0,0,0,0.0,-0.0049855760382295,12,11
1199,just_relax,0.1,168,182,-14,1.1771250480206064,-0.0267800915114647,55,105
1200,just_relax,0.1,1,1,0,17.12164821735773,0.0578261695456346,13,17
1201,just_relax,0.1,0,0,0,0.0,0.0003329515887838,30,29
1202,just_relax,0.1,3,3,0,0.000583815366788,0.0008768881680062,36,43
1203,just_relax,0.1,36,36,0,0.0010314806767866,-5.393936385500453e-05,40,60
1204,just_relax,0.1,0,0,0,0.0,0.0017894746066188,13,17
1205,just_relax,0.1,6,7,-1,-5.27235869178908,0.0082826452568239,23,30
1206,just_relax,0.1,0,0,0,0.0,-2.940409977925107e-05,12,16
1207,just_relax,0.1,0,0,0,0.0,3.901708024223183e-06,26,26
1208,just_relax,0.1,0,0,0,0.0,-0.0031688166024113,22,31
1209,just_relax,0.1,0,0,0,0.0,0.0008768193667615,68,68
1210,just_relax,0.1,0,0,0,0.0,-7.938175057398134e-06,23,22
1211,just_relax,0.1,0,0,0,0.0,-0.065399188004364,43,42
1212,just_relax,0.1,0,0,0,0.0,-0.002899723134464,18,17
1213,just_relax,0.1,3,3,0,-0.003194586812441,0.0012605153222713,28,42
1214,just_relax,0.1,45,58,-13,0.9231299892006462,0.088218433779717,21,44
1215,just_relax,0.1,0,0,0,0.0,-0.0112811671875761,36,37
1216,just_relax,0.1,0,0,0,0.0,-3.4878924121017896e-05,15,14
1217,just_relax,0.1,1,1,0,-0.0014549239964907,-0.00058525619921,14,16
1218,just_relax,0.1,197,237,-40,1.3477492998050025,0.0885093784332623,61,119
1219,just_relax,0.1,0,0,0,0.0,-0.0038599581671643,19,20
1220,just_relax,0.1,0,0,0,0.0,-0.0006472841631984,22,22
1221,just_relax,0.1,0,0,0,0.0,-0.0011415137972972,54,58
1222,just_relax,0.1,651,651,0,-0.0003954210755097,0.0002252638081207,65,135
1223,just_relax,0.1,1,1,0,-0.0029471577812358,0.0001749400264638,16,18
1224,just_relax,0.1,7,7,0,0.0002013814076775,0.0006636994664107,17,27
1225,just_relax,0.1,22,7,15,-12.985895473169307,0.1330374466905183,54,71
1226,just_relax,0.1,0,2,-2,-59.99819093035041,-0.0131455917893484,23,22
1227,just_relax,0.1,1,0,1,76.88395716132196,-0.1491322016956315,13,16
1228,just_relax,0.1,155,185,-30,2.3843149677438973,-0.02495720013905,85,131
1229,just_relax,0.1,44,44,0,0.0003032918935019,0.0025857794052007,28,55
1230,just_relax,0.1,4,4,0,-0.0007096785766407,-5.4537984728875166e-05,18,24
1231,just_relax,0.1,0,0,0,0.0,-0.003226028074061,19,22
1232,just_relax,0.1,0,0,0,0.0,0.0048197166778652,47,46
1233,just_relax,0.1,21,27,-6,0.0602947270368474,-0.3310372682946312,39,64
1234,just_relax,0.1,0,0,0,0.0,-0.0037052423868473,17,18
1235,just_relax,0.1,1,1,0,0.0005119856857191,0.0004745196477359,23,24
1236,just_relax,0.1,2,2,0,0.0010275548569325,-0.004970471779609,13,16
1237,just_relax,0.1,22,22,0,0.0038770082111057,0.0004285387996507,40,56
1238,just_relax,0.1,1,1,0,-0.0002865966515059,-0.0003325971221349,10,15
1239,just_relax,0.1,0,0,0,0.0,0.0003384089422906,21,20
1240,just_relax,0.1,4,4,0,-0.0001029723687508,-0.0013906355929786,30,35
1241,just_relax,0.1,1,1,0,0.0051043410712594,-0.0056156512673798,71,77
1242,relax_and_recompute,0.15,0,0,0,0.0,0.0,17,18
1243,relax_and_recompute,0.15,1,3,-2,28.460357396396503,-0.2850059406919234,43,48
1244,relax_and_recompute,0.15,3,5,-2,9.88581419291326,0.0069193652867528,38,45
1245,relax_and_recompute,0.15,0,0,0,0.0,0.0,12,12
1246,relax_and_recompute,0.15,20,7,13,1.502478168846423,0.2029862696446577,23,38
1247,relax_and_recompute,0.15,0,4,-4,-48.30308812678022,-0.0347389939534301,19,22
1248,relax_and_recompute,0.15,976,1004,-28,-0.0620531910963606,-0.0009330148689207,35,143
1249,relax_and_recompute,0.15,0,0,0,0.0,-0.0046858462976494,92,91
1250,relax_and_recompute,0.15,2,2,0,0.0,0.0,43,51
1251,relax_and_recompute,0.15,1,1,0,0.0,0.0,35,36
1252,relax_and_recompute,0.15,1,1,0,0.0,0.0,11,13
1253,relax_and_recompute,0.15,22,19,3,-4.957652547927751,0.037406937188411,10,25
1254,relax_and_recompute,0.15,16,16,0,-1.2375805476415778,-0.0662978026850604,86,136
1255,relax_and_recompute,0.15,0,0,0,0.0,0.0,10,12
1256,relax_and_recompute,0.15,0,0,0,0.0,0.0,32,31
1257,relax_and_recompute,0.15,2,2,0,0.8097822186271628,0.0720915422264546,20,26
1258,relax_and_recompute,0.15,0,0,0,0.0,0.0,11,11
1259,relax_and_recompute,0.15,2,2,0,1.6133031779469889,-0.0013837411504996,34,42
1260,relax_and_recompute,0.15,11,10,1,1.5445267212396203,-0.0356816848306716,14,25
1261,relax_and_recompute,0.15,8,4,4,9.035240939106416,-0.2006547963227668,31,46
1262,relax_and_recompute,0.15,0,2,-2,-60.43825847577355,-0.1126466588104083,42,45
1263,relax_and_recompute,0.15,1265,1233,32,-0.0829886923942524,-0.0013136328692162,39,173
1264,relax_and_recompute,0.15,11,10,1,-0.9259083214164718,-0.0036589420660914,14,24
1265,relax_and_recompute,0.15,0,0,0,0.0,0.0,24,25
1266,relax_and_recompute,0.15,2,3,-1,18.97015617968725,0.1057791903370561,12,19
1267,relax_and_recompute,0.15,59,59,0,0.0004995248301611,-0.0021609985989152,41,72
1268,relax_and_recompute,0.15,182,192,-10,2.176227062990442,0.127488881317396,59,115
1269,relax_and_recompute,0.15,6,4,2,3.763676058520289,0.4612476699024008,32,37
1270,relax_and_recompute,0.15,1,0,1,64.5674534074053,-0.141219001604035,20,20
1271,relax_and_recompute,0.15,41,26,15,-1.6275846340626714,0.0729158968985802,12,31
1272,relax_and_recompute,0.15,0,0,0,0.0,0.0,10,10
1273,relax_and_recompute,0.15,0,0,0,0.0,0.0,20,21
1274,relax_and_recompute,0.15,18,21,-3,0.5719110189928784,0.3696791622426242,39,52
1275,relax_and_recompute,0.15,378,393,-15,0.6108526484877643,4.422482210819645e-05,42,109
1276,relax_and_recompute,0.15,1,9,-8,21.83036785786023,-0.009946187399486,25,28
1277,relax_and_recompute,0.15,170,157,13,-3.523679109137184,0.105536041898159,56,106
1278,relax_and_recompute,0.15,567,575,-8,0.4383057260994292,-0.0017656065849445,87,189
1279,relax_and_recompute,0.15,41,40,1,-2.249384452446378,-0.0072514307594979,56,82
1280,relax_and_recompute,0.15,2,2,0,-8.392740270897733,0.5389967143152127,13,15
1281,relax_and_recompute,0.15,104,88,16,-3.3995451437074067,-0.111275141568526,36,63
1282,relax_and_recompute,0.15,0,0,0,0.0,0.0,16,15
1283,relax_and_recompute,0.15,0,0,0,0.0,-0.0061884200170785,67,66
1284,relax_and_recompute,0.15,13,13,0,0.0,0.0,42,60
1285,relax_and_recompute,0.15,0,0,0,0.0,0.0,39,38
1286,relax_and_recompute,0.15,8,9,-1,8.482609675305326,-0.0246353290916525,20,36
1287,relax_and_recompute,0.15,0,0,0,0.0,0.0,10,9
1288,relax_and_recompute,0.15,1,1,0,0.0,0.0,13,15
1289,relax_and_recompute,0.15,6,14,-8,18.824286639655867,-0.0841754274640885,34,41
1290,relax_and_recompute,0.15,3,5,-2,3.41159566991864,0.101618768403258,37,42
1291,relax_and_recompute,0.15,36,36,0,0.0,0.0,18,29
1292,relax_and_recompute,0.15,0,0,0,0.0,0.0314532687439244,23,22
1293,relax_and_recompute,0.15,0,0,0,0.0,0.1253462347742774,13,12
1294,relax_and_recompute,0.15,0,0,0,0.0,0.0,15,14
1295,relax_and_recompute,0.15,0,0,0,0.0,0.0,69,68
1296,relax_and_recompute,0.15,0,0,0,0.0,0.0,40,39
1297,relax_and_recompute,0.15,0,0,0,0.0,0.0,89,93
1298,relax_and_recompute,0.15,13,12,1,-2.153586113029718,-0.0708055525167026,20,32
1299,relax_and_recompute,0.15,2,3,-1,-7.067084936198143,-0.0593654442548075,69,83
1300,relax_and_recompute,0.15,2,3,-1,27.20264453478205,-0.1015090195781462,12,15
1301,relax_and_recompute,0.15,0,0,0,0.0,0.0,15,14
1302,relax_and_recompute,0.15,0,1,-1,-73.35995106543365,-0.0661284376918611,23,26
1303,relax_and_recompute,0.15,2,2,0,7.435447086102371,0.0512250419227734,12,20
1304,relax_and_recompute,0.15,201,208,-7,-0.777546499391029,-0.0168449909220319,64,122
1305,relax_and_recompute,0.15,7,3,4,-15.3477275810384,-0.0042339303565398,58,71
1306,relax_and_recompute,0.15,0,0,0,0.0,-0.1147932957929044,20,19
1307,relax_and_recompute,0.15,510,512,-2,-0.0138388627329746,-0.001793654381577,100,191
1308,relax_and_recompute,0.15,34,34,0,0.0,0.0,41,61
1309,relax_and_recompute,0.15,33,34,-1,-0.5384989905164446,0.0398816997391653,13,31
1310,relax_and_recompute,0.15,5,3,2,12.118750923999592,-0.1168739524455244,10,15
1311,relax_and_recompute,0.15,6,5,1,2.3116501951879656,-0.0709648635201967,37,47
1312,relax_and_recompute,0.15,0,0,0,0.0,-0.0059846962189432,21,21
1313,relax_and_recompute,0.15,0,0,0,0.0,0.0,11,10
1314,relax_and_recompute,0.15,57,57,0,0.0064914760634735,-0.0077421754008314,44,80
1315,relax_and_recompute,0.15,6,6,0,0.0,0.0,12,21
1316,relax_and_recompute,0.15,2,2,0,40.57817790180843,-0.0379305285754828,37,43
1317,relax_and_recompute,0.15,6,8,-2,-0.1735310719531781,0.0463842795036362,41,52
1318,relax_and_recompute,0.15,0,0,0,0.0,0.0,90,89
1319,relax_and_recompute,0.15,0,0,0,0.0,0.0,22,21
1320,relax_and_recompute,0.15,1,6,-5,-12.824308725883805,-0.0280060439235303,37,43
1321,relax_and_recompute,0.15,0,1,-1,-89.65010094514068,0.1086179312853023,47,47
1322,relax_and_recompute,0.15,4,4,0,0.0,0.0,12,20
1323,relax_and_recompute,0.15,114,114,0,0.0,0.0,84,124
1324,relax_and_recompute,0.15,0,0,0,0.0,0.0,88,92
1325,relax_and_recompute,0.15,380,377,3,-0.3714807714610657,-0.0025427242202904,59,122
1326,relax_and_recompute,0.15,4,3,1,0.203280810508815,0.0446821006516815,26,31
1327,relax_and_recompute,0.15,0,0,0,0.0,0.0,28,27
1328,relax_and_recompute,0.15,6,6,0,0.0,0.0,18,26
1329,relax_and_recompute,0.15,1,3,-2,-12.914228578214503,0.0322817081119266,23,26
1330,relax_and_recompute,0.15,0,5,-5,-0.8399978558704028,-0.0099238347816712,43,43
1331,relax_and_recompute,0.15,2,3,-1,26.34761393126834,0.2227207785283125,22,26
1332,relax_and_recompute,0.15,0,0,0,0.0,0.0,15,14
1333,relax_and_recompute,0.15,10,19,-9,5.648675414166,0.1018849030252861,36,48
1334,relax_and_recompute,0.15,6,6,0,3.132031887299874,-0.366934867361315,30,37
1335,relax_and_recompute,0.15,1,1,0,11.616152189123014,-0.2081405675796964,10,13
1336,relax_and_recompute,0.15,0,0,0,0.0,0.0,12,11
1337,relax_and_recompute,0.15,168,153,15,-1.4597591062543387,0.1638614131178267,55,105
1338,relax_and_recompute,0.15,1,1,0,17.12164821735773,0.0578261695456346,13,17
1339,relax_and_recompute,0.15,0,0,0,0.0,0.0,30,29
1340,relax_and_recompute,0.15,3,4,-1,-9.905682406522075,-0.002170500293968,36,43
1341,relax_and_recompute,0.15,36,40,-4,-3.781728400218512,-0.055822645815706,40,60
1342,relax_and_recompute,0.15,0,0,0,0.0,0.0802672977734813,13,17
1343,relax_and_recompute,0.15,6,8,-2,-4.960402959672933,-0.0115319394462201,23,30
1344,relax_and_recompute,0.15,0,0,0,0.0,0.0,12,16
1345,relax_and_recompute,0.15,0,3,-3,-56.243046788228376,0.0779735480437637,26,26
1346,relax_and_recompute,0.15,0,0,0,0.0,-0.0250790796226426,22,31
1347,relax_and_recompute,0.15,0,0,0,0.0,0.0,68,68
1348,relax_and_recompute,0.15,0,0,0,0.0,0.0,23,22
1349,relax_and_recompute,0.15,0,0,0,0.0,-0.0349525596057489,43,42
1350,relax_and_recompute,0.15,0,0,0,0.0,0.0,18,17
1351,relax_and_recompute,0.15,3,1,2,16.774590073756514,-0.1297888041253873,28,42
1352,relax_and_recompute,0.15,45,50,-5,1.8841541587735409,0.0156030402407787,21,44
1353,relax_and_recompute,0.15,0,0,0,0.0,0.0,36,37
1354,relax_and_recompute,0.15,0,0,0,0.0,0.0,15,14
1355,relax_and_recompute,0.15,1,1,0,66.99851956452005,0.1736018005328949,14,16
1356,relax_and_recompute,0.15,197,211,-14,1.6294158914226389,0.1952030013326532,61,119
1357,relax_and_recompute,0.15,0,0,0,0.0,0.0,19,20
1358,relax_and_recompute,0.15,0,2,-2,-52.79175496631128,0.0259444423045324,22,22
1359,relax_and_recompute,0.15,0,0,0,0.0,-0.0413225144380497,54,58
1360,relax_and_recompute,0.15,651,651,0,0.0,0.0,65,135
1361,relax_and_recompute,0.15,1,1,0,0.0,0.0,16,18
1362,relax_and_recompute,0.15,7,8,-1,8.396787180550831,0.1080910940256584,17,27
1363,relax_and_recompute,0.15,22,4,18,-18.61747849085588,0.1446288399504806,54,71
1364,relax_and_recompute,0.15,0,2,-2,-69.51467976885004,-0.0285407675374049,23,22
1365,relax_and_recompute,0.15,1,2,-1,29.01115049910844,-0.3825499618326466,13,16
1366,relax_and_recompute,0.15,155,149,6,-2.794184228530185,-0.0034415506621975,85,131
1367,relax_and_recompute,0.15,44,58,-14,6.627037203531586,0.0061263330641294,28,55
1368,relax_and_recompute,0.15,4,4,0,17.431676694704336,-0.0893290688064797,18,24
1369,relax_and_recompute,0.15,0,0,0,0.0,0.0,19,22
1370,relax_and_recompute,0.15,0,1,-1,-82.00366620821269,0.0734444320361835,47,46
1371,relax_and_recompute,0.15,21,21,0,-3.6879171991704425,0.0716976646866419,39,64
1372,relax_and_recompute,0.15,0,0,0,0.0,0.0,17,18
1373,relax_and_recompute,0.15,1,1,0,0.0,0.0,23,24
1374,relax_and_recompute,0.15,2,2,0,-2.1515607672736223,0.0826566971112059,13,16
1375,relax_and_recompute,0.15,22,13,9,-0.7653465239512514,0.0480027811499798,40,56
1376,relax_and_recompute,0.15,1,1,0,-6.456334298675088,-0.0400486519001042,10,15
1377,relax_and_recompute,0.15,0,0,0,0.0,0.0,21,20
1378,relax_and_recompute,0.15,4,5,-1,20.74881945520164,-0.1306207019803847,30,35
1379,relax_and_recompute,0.15,1,1,0,0.0,0.0,71,77
1380,relax_one,0.15,0,0,0,0.0,0.0,17,18
1381,relax_one,0.15,1,1,0,0.0,0.0,43,48
1382,relax_one,0.15,3,3,0,0.0,0.0,38,45
1383,relax_one,0.15,0,0,0,0.0,0.0,12,12
1384,relax_one,0.15,20,18,2,-3.2752299140735204,0.0114158034923678,23,38
1385,relax_one,0.15,0,1,-1,-78.11694026732484,-0.0295512202700576,19,22
1386,relax_one,0.15,976,978,-2,0.1423455471242221,-0.0025418055405018,35,143
1387,relax_one,0.15,0,1,-1,-50.19567681247512,-0.0041327022016595,92,91
1388,relax_one,0.15,2,2,0,0.0,0.0,43,51
1389,relax_one,0.15,1,1,0,0.0,0.0,35,36
1390,relax_one,0.15,1,1,0,0.0,0.0,11,13
1391,relax_one,0.15,22,20,2,-3.01441643358082,0.0082886474985522,10,25
1392,relax_one,0.15,16,16,0,0.0,0.0,86,136
1393,relax_one,0.15,0,0,0,0.0,0.0,10,12
1394,relax_one,0.15,0,0,0,0.0,0.0,32,31
1395,relax_one,0.15,2,2,0,4.970962038347736,-0.0904350603192869,20,26
1396,relax_one,0.15,0,0,0,0.0,0.0,11,11
1397,relax_one,0.15,2,2,0,0.0,0.0,34,42
1398,relax_one,0.15,11,11,0,0.0,0.0,14,25
1399,relax_one,0.15,8,7,1,13.99583228956454,0.1582030612456263,31,46
1400,relax_one,0.15,0,0,0,0.0,0.0,42,45
1401,relax_one,0.15,1265,1240,25,0.1009906236120983,0.0001682713719424,39,173
1402,relax_one,0.15,11,11,0,0.0,0.0,14,24
1403,relax_one,0.15,0,0,0,0.0,0.0,24,25
1404,relax_one,0.15,2,2,0,0.0,0.0,12,19
1405,relax_one,0.15,59,59,0,0.4609819410147793,0.0044552421238692,41,72
1406,relax_one,0.15,182,191,-9,1.446975953367918,0.0358261975695221,59,115
1407,relax_one,0.15,6,6,0,0.0,0.0,32,37
1408,relax_one,0.15,1,1,0,0.0,0.0,20,20
1409,relax_one,0.15,41,32,9,2.305146048931391,0.0775874222420341,12,31
1410,relax_one,0.15,0,0,0,0.0,0.0,10,10
1411,relax_one,0.15,0,0,0,0.0,0.0,20,21
1412,relax_one,0.15,18,18,0,0.0,0.0,39,52
1413,relax_one,0.15,378,395,-17,-0.4859193577000411,-0.0010324457545943,42,109
1414,relax_one,0.15,1,1,0,0.0,0.0,25,28
1415,relax_one,0.15,170,170,0,0.0,0.0,56,106
1416,relax_one,0.15,567,595,-28,0.7834114754025379,-0.002967395777259,87,189
1417,relax_one,0.15,41,41,0,-3.1762323320181167,-0.0099859384844429,56,82
1418,relax_one,0.15,2,2,0,0.0,0.0,13,15
1419,relax_one,0.15,104,88,16,-3.3995451437074067,-0.111275141568526,36,63
1420,relax_one,0.15,0,0,0,0.0,0.0,16,15
1421,relax_one,0.15,0,0,0,0.0,0.0,67,66
1422,relax_one,0.15,13,13,0,0.0,0.0,42,60
1423,relax_one,0.15,0,0,0,0.0,0.0,39,38
1424,relax_one,0.15,8,8,0,0.0,0.0,20,36
1425,relax_one,0.15,0,0,0,0.0,0.0,10,9
1426,relax_one,0.15,1,1,0,0.0,0.0,13,15
1427,relax_one,0.15,6,7,-1,12.522285729298716,0.0299062089849014,34,41
1428,relax_one,0.15,3,3,0,0.0,0.0,37,42
1429,relax_one,0.15,36,36,0,0.0,0.0,18,29
1430,relax_one,0.15,0,0,0,0.0,0.0,23,22
1431,relax_one,0.15,0,0,0,0.0,0.0,13,12
1432,relax_one,0.15,0,0,0,0.0,0.0,15,14
1433,relax_one,0.15,0,0,0,0.0,0.0,69,68
1434,relax_one,0.15,0,0,0,0.0,0.0,40,39
1435,relax_one,0.15,0,0,0,0.0,0.0,89,93
1436,relax_one,0.15,13,13,0,-2.975681235416161,-0.0847204542309565,20,32
1437,relax_one,0.15,2,2,0,0.0,0.0,69,83
1438,relax_one,0.15,2,2,0,0.0,0.0,12,15
1439,relax_one,0.15,0,0,0,0.0,0.0,15,14
1440,relax_one,0.15,0,0,0,0.0,0.0,23,26
1441,relax_one,0.15,2,2,0,0.0,0.0,12,20
1442,relax_one,0.15,201,201,0,0.0,0.0,64,122
1443,relax_one,0.15,7,7,0,0.0,0.0,58,71
1444,relax_one,0.15,0,0,0,0.0,0.0,20,19
1445,relax_one,0.15,510,510,0,0.0060639005596385,-0.0006916839131552,100,191
1446,relax_one,0.15,34,34,0,0.0,0.0,41,61
1447,relax_one,0.15,33,34,-1,-0.6264707699284884,0.0331924782664471,13,31
1448,relax_one,0.15,5,5,0,0.0,0.0,10,15
1449,relax_one,0.15,6,6,0,0.0,0.0,37,47
1450,relax_one,0.15,0,0,0,0.0,0.0,21,21
1451,relax_one,0.15,0,0,0,0.0,0.0,11,10
1452,relax_one,0.15,57,55,2,-1.1796960984034186,9.734149291917849e-05,44,80
1453,relax_one,0.15,6,6,0,0.0,0.0,12,21
1454,relax_one,0.15,2,2,0,42.15913628345388,-0.0181760816329957,37,43
1455,relax_one,0.15,6,6,0,0.0,0.0,41,52
1456,relax_one,0.15,0,0,0,0.0,0.0,90,89
1457,relax_one,0.15,0,0,0,0.0,0.0,22,21
1458,relax_one,0.15,1,1,0,-4.213527745425694,0.0417394626549948,37,43
1459,relax_one,0.15,0,0,0,0.0,0.0,47,47
1460,relax_one,0.15,4,4,0,0.0,0.0,12,20
1461,relax_one,0.15,114,114,0,0.0,0.0,84,124
1462,relax_one,0.15,0,0,0,0.0,0.0,88,92
1463,relax_one,0.15,380,377,3,-0.3714807714610657,-0.0025427242202904,59,122
1464,relax_one,0.15,4,4,0,0.0,0.0,26,31
1465,relax_one,0.15,0,0,0,0.0,0.0,28,27
1466,relax_one,0.15,6,6,0,0.0,0.0,18,26
1467,relax_one,0.15,1,1,0,0.0,0.0,23,26
1468,relax_one,0.15,0,0,0,0.0,0.0,43,43
1469,relax_one,0.15,2,2,0,0.0,0.0,22,26
1470,relax_one,0.15,0,0,0,0.0,0.0,15,14
1471,relax_one,0.15,10,17,-7,3.5874123628873704,0.0856058777554238,36,48
1472,relax_one,0.15,6,6,0,2.8016025522275783,-0.3535412006642752,30,37
1473,relax_one,0.15,1,1,0,0.0,0.0,10,13
1474,relax_one,0.15,0,0,0,0.0,0.0,12,11
1475,relax_one,0.15,168,167,1,-0.7965879277094672,0.0475430066924907,55,105
1476,relax_one,0.15,1,1,0,17.12164821735773,0.0578261695456346,13,17
1477,relax_one,0.15,0,0,0,0.0,0.0,30,29
1478,relax_one,0.15,3,3,0,0.0,0.0,36,43
1479,relax_one,0.15,36,36,0,0.0,0.0,40,60
1480,relax_one,0.15,0,0,0,0.0,0.0,13,17
1481,relax_one,0.15,6,7,-1,-5.27235869178908,0.0082826452568239,23,30
1482,relax_one,0.15,0,0,0,0.0,0.0,12,16
1483,relax_one,0.15,0,0,0,0.0,0.0,26,26
1484,relax_one,0.15,0,0,0,0.0,0.0,22,31
1485,relax_one,0.15,0,0,0,0.0,0.0,68,68
1486,relax_one,0.15,0,0,0,0.0,0.0,23,22
1487,relax_one,0.15,0,0,0,0.0,-0.0348129737608335,43,42
1488,relax_one,0.15,0,0,0,0.0,0.0,18,17
1489,relax_one,0.15,3,3,0,0.0,0.0,28,42
1490,relax_one,0.15,45,45,0,0.1036479088850654,-0.0041754562964496,21,44
1491,relax_one,0.15,0,0,0,0.0,0.0,36,37
1492,relax_one,0.15,0,0,0,0.0,0.0,15,14
1493,relax_one,0.15,1,1,0,0.0,0.0,14,16
1494,relax_one,0.15,197,204,-7,3.484436282689749,0.1757315340586914,61,119
1495,relax_one,0.15,0,0,0,0.0,0.0,19,20
1496,relax_one,0.15,0,0,0,0.0,0.0,22,22
1497,relax_one,0.15,0,0,0,0.0,0.0,54,58
1498,relax_one,0.15,651,651,0,0.0,0.0,65,135
1499,relax_one,0.15,1,1,0,0.0,0.0,16,18
1500,relax_one,0.15,7,7,0,0.0,0.0,17,27
1501,relax_one,0.15,22,4,18,-19.06910671434205,0.1469333863626725,54,71
1502,relax_one,0.15,0,2,-2,-59.99819093035041,-0.0131455917893484,23,22
1503,relax_one,0.15,1,0,1,76.88395716132196,-0.1491322016956315,13,16
1504,relax_one,0.15,155,146,9,-2.3741667241416664,-0.001397205031107,85,131
1505,relax_one,0.15,44,44,0,0.0,0.0,28,55
1506,relax_one,0.15,4,4,0,0.0,0.0,18,24
1507,relax_one,0.15,0,0,0,0.0,0.0,19,22
1508,relax_one,0.15,0,0,0,0.0,0.0,47,46
1509,relax_one,0.15,21,19,2,-6.356920988253222,0.0143956759658575,39,64
1510,relax_one,0.15,0,0,0,0.0,0.0,17,18
1511,relax_one,0.15,1,1,0,0.0,0.0,23,24
1512,relax_one,0.15,2,2,0,0.0,0.0,13,16
1513,relax_one,0.15,22,22,0,0.0,0.0,40,56
1514,relax_one,0.15,1,1,0,0.0,0.0,10,15
1515,relax_one,0.15,0,0,0,0.0,0.0,21,20
1516,relax_one,0.15,4,4,0,0.0,0.0,30,35
1517,relax_one,0.15,1,1,0,0.0,0.0,71,77
1518,just_relax,0.15,0,0,0,0.0,-0.0091692815110081,17,18
1519,just_relax,0.15,1,1,0,0.0009607869158827,0.0014628518031132,43,48
1520,just_relax,0.15,3,3,0,-0.0019521681741139,-7.679999619569777e-05,38,45
1521,just_relax,0.15,0,0,0,0.0,-0.0037600566419999,12,12
1522,just_relax,0.15,20,14,6,1.9891400956483096,0.1544148745043621,23,38
1523,just_relax,0.15,0,1,-1,-78.11694026732484,-0.0295512202700576,19,22
1524,just_relax,0.15,976,1188,-212,1.3106081233515638,0.0257948127350838,35,143
1525,just_relax,0.15,0,4,-4,-39.1818408082167,-0.0156618414823971,92,91
1526,just_relax,0.15,2,2,0,-0.00041775540015,-0.0002552385505018,43,51
1527,just_relax,0.15,1,1,0,-0.0016870080925173,6.40249009676297e-05,35,36
1528,just_relax,0.15,1,1,0,-0.000156439410091,0.0002508982184644,11,13
1529,just_relax,0.15,22,24,-2,-3.49415891827384,0.1000113687896936,10,25
1530,just_relax,0.15,16,13,3,0.2088785180214571,-2.2771107622610032e-05,86,136
1531,just_relax,0.15,0,0,0,0.0,-1.765503840900351e-06,10,12
1532,just_relax,0.15,0,0,0,0.0,-1.014518260578079e-05,32,31
1533,just_relax,0.15,2,2,0,4.970962038347736,-0.0904350603192869,20,26
1534,just_relax,0.15,0,0,0,0.0,0.000269092021105,11,11
1535,just_relax,0.15,2,2,0,0.0009292844165713,-0.0008610890242942,34,42
1536,just_relax,0.15,11,11,0,-0.0003616788843885,0.0005035529702898,14,25
1537,just_relax,0.15,8,7,1,13.99583228956454,0.1582030612456263,31,46
1538,just_relax,0.15,0,0,0,0.0,0.0042083907430441,42,45
1539,just_relax,0.15,1265,1285,-20,2.6849459664833404,-0.1292871249874528,39,173
1540,just_relax,0.15,11,11,0,0.0001627700527109,0.0015600944076981,14,24
1541,just_relax,0.15,0,0,0,0.0,-0.000608053012485,24,25
1542,just_relax,0.15,2,2,0,-2.981324638540173e-05,0.0001440646714581,12,19
1543,just_relax,0.15,59,59,0,0.4609819410147793,0.0044552421238692,41,72
1544,just_relax,0.15,182,178,4,0.0313317398119608,0.0970080713564147,59,115
1545,just_relax,0.15,6,6,0,-0.0020404096920856,0.0011964290694836,32,37
1546,just_relax,0.15,1,0,1,64.5674534074053,-0.0013228453280204,20,20
1547,just_relax,0.15,41,33,8,8.182357833947279,-0.009895766072516,12,31
1548,just_relax,0.15,0,0,0,0.0,-1.5942199658169898e-06,10,10
1549,just_relax,0.15,0,0,0,0.0,0.0018153466622625,20,21
1550,just_relax,0.15,18,18,0,0.0003589278580733,-0.0005865039043362,39,52
1551,just_relax,0.15,378,369,9,2.979528253482861,0.0835817869771829,42,109
1552,just_relax,0.15,1,1,0,-0.0010366044558338,-5.546321229055184e-05,25,28
1553,just_relax,0.15,170,170,0,-0.0002769762706833,-0.0005002245004087,56,106
1554,just_relax,0.15,567,521,46,-0.2657392120378574,0.1239070997048957,87,189
1555,just_relax,0.15,41,43,-2,2.499128887843675,-0.033528056765164,56,82
1556,just_relax,0.15,2,2,0,0.0004861774901456,1.2071037781558047e-06,13,15
1557,just_relax,0.15,104,86,18,5.26724471872344,-0.2840091449765524,36,63
1558,just_relax,0.15,0,0,0,0.0,4.3915154694929015e-06,16,15
1559,just_relax,0.15,0,0,0,0.0,-5.223096419815221e-07,67,66
1560,just_relax,0.15,13,13,0,0.0024384647237383,0.004260897920215,42,60
1561,just_relax,0.15,0,0,0,0.0,0.0005903979895692,39,38
1562,just_relax,0.15,8,8,0,-3.330899971842882e-05,0.0005334774465118,20,36
1563,just_relax,0.15,0,0,0,0.0,-0.0010596071395927,10,9
1564,just_relax,0.15,1,1,0,0.0009644178095271,-1.805181839154013e-05,13,15
1565,just_relax,0.15,6,7,-1,12.522285729298716,0.0299062089849014,34,41
1566,just_relax,0.15,3,3,0,-0.0014185667246167,0.0006213779664755,37,42
1567,just_relax,0.15,36,36,0,7.196136941445275e-06,5.025038399830706e-06,18,29
1568,just_relax,0.15,0,0,0,0.0,-0.0031405837993232,23,22
1569,just_relax,0.15,0,0,0,0.0,1.0504657718901632e-05,13,12
1570,just_relax,0.15,0,0,0,0.0,-0.0007613272869088,15,14
1571,just_relax,0.15,0,0,0,0.0,-0.0017207203528439,69,68
1572,just_relax,0.15,0,0,0,0.0,0.001934163275203,40,39
1573,just_relax,0.15,0,0,0,0.0,0.0016954512903432,89,93
1574,just_relax,0.15,13,13,0,1.511050374969713,-0.0878570612978808,20,32
1575,just_relax,0.15,2,3,-1,-4.120223819609976,0.0096644512108772,69,83
1576,just_relax,0.15,2,2,0,0.0006766545457281,-0.0007958153584334,12,15
1577,just_relax,0.15,0,0,0,0.0,-0.0009758471183408,15,14
1578,just_relax,0.15,0,0,0,0.0,-0.0007570529942456,23,26
1579,just_relax,0.15,2,2,0,-0.0004670837519427,-0.000552899751354,12,20
1580,just_relax,0.15,201,201,0,-5.927609844036397e-05,0.0001073571901385,64,122
1581,just_relax,0.15,7,7,0,-0.0099055150386959,0.0003544031231826,58,71
1582,just_relax,0.15,0,0,0,0.0,-0.0013086772972689,20,19
1583,just_relax,0.15,510,505,5,-0.1096058695008466,0.0001562332230281,100,191
1584,just_relax,0.15,34,34,0,0.0046498502251353,3.462795885833536e-05,41,61
1585,just_relax,0.15,33,21,12,-0.322372772893118,0.0487025778316814,13,31
1586,just_relax,0.15,5,5,0,0.0003476406123752,0.0002826333043987,10,15
1587,just_relax,0.15,6,6,0,-0.0004254358946269,0.0003115870201488,37,47
1588,just_relax,0.15,0,0,0,0.0,0.0007350584472026,21,21
1589,just_relax,0.15,0,0,0,0.0,9.621758975453254e-06,11,10
1590,just_relax,0.15,57,55,2,-1.1796960984034186,9.734149291917849e-05,44,80
1591,just_relax,0.15,6,6,0,0.0001929725905256,-1.6711583069151104e-05,12,21
1592,just_relax,0.15,2,5,-3,10.477360070400792,-0.0167672873232497,37,43
1593,just_relax,0.15,6,6,0,-9.27967616917158e-05,0.0005867078171852,41,52
1594,just_relax,0.15,0,0,0,0.0,0.0258238191424075,90,89
1595,just_relax,0.15,0,0,0,0.0,-0.0001762041220683,22,21
1596,just_relax,0.15,1,5,-4,-25.99394547658536,0.034397478016983,37,43
1597,just_relax,0.15,0,0,0,0.0,0.009279908390236,47,47
1598,just_relax,0.15,4,4,0,-0.0003372893218767,-9.212772776878708e-07,12,20
1599,just_relax,0.15,114,95,19,0.8287298242191525,-0.006531385777559,84,124
1600,just_relax,0.15,0,0,0,0.0,0.0016708237920683,88,92
1601,just_relax,0.15,380,332,48,-1.681066658089314,0.0270328691740772,59,122
1602,just_relax,0.15,4,4,0,2.0677824380754828e-05,-0.000363330475558,26,31
1603,just_relax,0.15,0,0,0,0.0,4.418930553695688e-06,28,27
1604,just_relax,0.15,6,6,0,0.0013890930604816,7.243956427815945e-06,18,26
1605,just_relax,0.15,1,1,0,-0.0014241348598034,0.001861633846505,23,26
1606,just_relax,0.15,0,0,0,0.0,0.0001814651838247,43,43
1607,just_relax,0.15,2,2,0,0.0004949068667485,0.0012137972461528,22,26
1608,just_relax,0.15,0,0,0,0.0,8.316094011640018e-06,15,14
1609,just_relax,0.15,10,17,-7,3.5874123628873704,0.0856058777554238,36,48
1610,just_relax,0.15,6,6,0,2.8016025522275783,-0.3535412006642752,30,37
1611,just_relax,0.15,1,1,0,5.455328151526828e-05,-4.433967369288361e-05,10,13
1612,just_relax,0.15,0,0,0,0.0,-0.0049855760382295,12,11
1613,just_relax,0.15,168,182,-14,1.1771250480206064,-0.0267800915114647,55,105
1614,just_relax,0.15,1,1,0,17.12164821735773,0.0578261695456346,13,17
1615,just_relax,0.15,0,0,0,0.0,0.0003329515887838,30,29
1616,just_relax,0.15,3,3,0,0.000583815366788,0.0008768881680062,36,43
1617,just_relax,0.15,36,36,0,0.0010314806767866,-5.393936385500453e-05,40,60
1618,just_relax,0.15,0,0,0,0.0,0.0017894746066188,13,17
1619,just_relax,0.15,6,7,-1,-5.27235869178908,0.0082826452568239,23,30
1620,just_relax,0.15,0,0,0,0.0,-2.940409977925107e-05,12,16
1621,just_relax,0.15,0,0,0,0.0,3.901708024223183e-06,26,26
1622,just_relax,0.15,0,0,0,0.0,-0.0031688166024113,22,31
1623,just_relax,0.15,0,0,0,0.0,0.0008768193667615,68,68
1624,just_relax,0.15,0,0,0,0.0,-7.938175057398134e-06,23,22
1625,just_relax,0.15,0,0,0,0.0,-0.065399188004364,43,42
1626,just_relax,0.15,0,0,0,0.0,-0.002899723134464,18,17
1627,just_relax,0.15,3,3,0,-0.003194586812441,0.0012605153222713,28,42
1628,just_relax,0.15,45,58,-13,0.9231299892006462,0.088218433779717,21,44
1629,just_relax,0.15,0,0,0,0.0,-0.0112811671875761,36,37
1630,just_relax,0.15,0,0,0,0.0,-3.4878924121017896e-05,15,14
1631,just_relax,0.15,1,1,0,-0.0014549239964907,-0.00058525619921,14,16
1632,just_relax,0.15,197,237,-40,1.3477492998050025,0.0885093784332623,61,119
1633,just_relax,0.15,0,0,0,0.0,-0.0038599581671643,19,20
1634,just_relax,0.15,0,0,0,0.0,-0.0006472841631984,22,22
1635,just_relax,0.15,0,0,0,0.0,-0.0011415137972972,54,58
1636,just_relax,0.15,651,651,0,-0.0003954210755097,0.0002252638081207,65,135
1637,just_relax,0.15,1,1,0,-0.0029471577812358,0.0001749400264638,16,18
1638,just_relax,0.15,7,7,0,0.0002013814076775,0.0006636994664107,17,27
1639,just_relax,0.15,22,7,15,-12.985895473169307,0.1330374466905183,54,71
1640,just_relax,0.15,0,2,-2,-59.99819093035041,-0.0131455917893484,23,22
1641,just_relax,0.15,1,0,1,76.88395716132196,-0.1491322016956315,13,16
1642,just_relax,0.15,155,185,-30,2.3843149677438973,-0.02495720013905,85,131
1643,just_relax,0.15,44,44,0,0.0003032918935019,0.0025857794052007,28,55
1644,just_relax,0.15,4,4,0,-0.0007096785766407,-5.4537984728875166e-05,18,24
1645,just_relax,0.15,0,0,0,0.0,-0.003226028074061,19,22
1646,just_relax,0.15,0,0,0,0.0,0.0048197166778652,47,46
1647,just_relax,0.15,21,27,-6,0.0602947270368474,-0.3310372682946312,39,64
1648,just_relax,0.15,0,0,0,0.0,-0.0037052423868473,17,18
1649,just_relax,0.15,1,1,0,0.0005119856857191,0.0004745196477359,23,24
1650,just_relax,0.15,2,2,0,0.0010275548569325,-0.004970471779609,13,16
1651,just_relax,0.15,22,22,0,0.0038770082111057,0.0004285387996507,40,56
1652,just_relax,0.15,1,1,0,-0.0002865966515059,-0.0003325971221349,10,15
1653,just_relax,0.15,0,0,0,0.0,0.0003384089422906,21,20
1654,just_relax,0.15,4,4,0,-0.0001029723687508,-0.0013906355929786,30,35
1655,just_relax,0.15,1,1,0,0.0051043410712594,-0.0056156512673798,71,77
1656,relax_and_recompute,0.2,0,0,0,0.0,0.0,17,18
1657,relax_and_recompute,0.2,1,3,-2,28.460357396396503,-0.2850059406919234,43,48
1658,relax_and_recompute,0.2,3,5,-2,9.88581419291326,0.0069193652867528,38,45
1659,relax_and_recompute,0.2,0,0,0,0.0,0.0,12,12
1660,relax_and_recompute,0.2,20,7,13,1.502478168846423,0.2029862696446577,23,38
1661,relax_and_recompute,0.2,0,4,-4,-48.30308812678022,-0.0347389939534301,19,22
1662,relax_and_recompute,0.2,976,1004,-28,-0.0620531910963606,-0.0009330148689207,35,143
1663,relax_and_recompute,0.2,0,0,0,0.0,-0.0046858462976494,92,91
1664,relax_and_recompute,0.2,2,2,0,0.0,0.0,43,51
1665,relax_and_recompute,0.2,1,1,0,0.0,0.0,35,36
1666,relax_and_recompute,0.2,1,1,0,0.0,0.0,11,13
1667,relax_and_recompute,0.2,22,19,3,-4.957652547927751,0.037406937188411,10,25
1668,relax_and_recompute,0.2,16,16,0,-1.2375805476415778,-0.0662978026850604,86,136
1669,relax_and_recompute,0.2,0,0,0,0.0,0.0,10,12
1670,relax_and_recompute,0.2,0,0,0,0.0,0.0,32,31
1671,relax_and_recompute,0.2,2,2,0,0.8097822186271628,0.0720915422264546,20,26
1672,relax_and_recompute,0.2,0,0,0,0.0,0.0,11,11
1673,relax_and_recompute,0.2,2,2,0,1.6133031779469889,-0.0013837411504996,34,42
1674,relax_and_recompute,0.2,11,10,1,1.5445267212396203,-0.0356816848306716,14,25
1675,relax_and_recompute,0.2,8,4,4,9.035240939106416,-0.2006547963227668,31,46
1676,relax_and_recompute,0.2,0,2,-2,-60.43825847577355,-0.1126466588104083,42,45
1677,relax_and_recompute,0.2,1265,1233,32,-0.0829886923942524,-0.0013136328692162,39,173
1678,relax_and_recompute,0.2,11,10,1,-0.9259083214164718,-0.0036589420660914,14,24
1679,relax_and_recompute,0.2,0,0,0,0.0,0.0,24,25
1680,relax_and_recompute,0.2,2,3,-1,18.97015617968725,0.1057791903370561,12,19
1681,relax_and_recompute,0.2,59,59,0,0.0004995248301611,-0.0021609985989152,41,72
1682,relax_and_recompute,0.2,182,192,-10,2.176227062990442,0.127488881317396,59,115
1683,relax_and_recompute,0.2,6,4,2,3.758843121777289,0.465210734665941,32,37
1684,relax_and_recompute,0.2,1,0,1,64.5674534074053,-0.1072594416335612,20,20
1685,relax_and_recompute,0.2,41,26,15,-1.6275846340626714,0.0729158968985802,12,31
1686,relax_and_recompute,0.2,0,0,0,0.0,0.0,10,10
1687,relax_and_recompute,0.2,0,0,0,0.0,0.0,20,21
1688,relax_and_recompute,0.2,18,21,-3,0.5719110189928784,0.3696791622426242,39,52
1689,relax_and_recompute,0.2,378,393,-15,0.6108526484877643,4.422482210819645e-05,42,109
1690,relax_and_recompute,0.2,1,9,-8,21.83036785786023,-0.009946187399486,25,28
1691,relax_and_recompute,0.2,170,157,13,-3.523679109137184,0.105536041898159,56,106
1692,relax_and_recompute,0.2,567,575,-8,0.4383057260994292,-0.0017656065849445,87,189
1693,relax_and_recompute,0.2,41,40,1,-2.249384452446378,-0.0072514307594979,56,82
1694,relax_and_recompute,0.2,2,2,0,-8.392740270897733,0.5389967143152127,13,15
1695,relax_and_recompute,0.2,104,88,16,-3.3995451437074067,-0.111275141568526,36,63
1696,relax_and_recompute,0.2,0,0,0,0.0,0.0,16,15
1697,relax_and_recompute,0.2,0,0,0,0.0,-0.0061884200170785,67,66
1698,relax_and_recompute,0.2,13,13,0,0.0,0.0,42,60
1699,relax_and_recompute,0.2,0,0,0,0.0,0.0,39,38
1700,relax_and_recompute,0.2,8,9,-1,8.482609675305326,-0.0246353290916525,20,36
1701,relax_and_recompute,0.2,0,0,0,0.0,0.0,10,9
1702,relax_and_recompute,0.2,1,1,0,0.0,0.0,13,15
1703,relax_and_recompute,0.2,6,14,-8,18.824286639655867,-0.0841754274640885,34,41
1704,relax_and_recompute,0.2,3,5,-2,3.41159566991864,0.101618768403258,37,42
1705,relax_and_recompute,0.2,36,36,0,0.0,0.0,18,29
1706,relax_and_recompute,0.2,0,0,0,0.0,0.0314532687439244,23,22
1707,relax_and_recompute,0.2,0,0,0,0.0,0.1253462347742774,13,12
1708,relax_and_recompute,0.2,0,0,0,0.0,0.0,15,14
1709,relax_and_recompute,0.2,0,0,0,0.0,0.0,69,68
1710,relax_and_recompute,0.2,0,0,0,0.0,0.0,40,39
1711,relax_and_recompute,0.2,0,0,0,0.0,0.0,89,93
1712,relax_and_recompute,0.2,13,12,1,-2.153586113029718,-0.0708055525167026,20,32
1713,relax_and_recompute,0.2,2,3,-1,-7.067084936198143,-0.0593654442548075,69,83
1714,relax_and_recompute,0.2,2,3,-1,27.20264453478205,-0.1015090195781462,12,15
1715,relax_and_recompute,0.2,0,0,0,0.0,0.0,15,14
1716,relax_and_recompute,0.2,0,0,0,0.0,-0.0791999079911643,23,26
1717,relax_and_recompute,0.2,2,2,0,0.0,0.0,12,20
1718,relax_and_recompute,0.2,201,208,-7,-0.777546499391029,-0.0168449909220319,64,122
1719,relax_and_recompute,0.2,7,3,4,-15.3477275810384,-0.0042339303565398,58,71
1720,relax_and_recompute,0.2,0,0,0,0.0,-0.1147932957929044,20,19
1721,relax_and_recompute,0.2,510,512,-2,-0.0138388627329746,-0.001793654381577,100,191
1722,relax_and_recompute,0.2,34,34,0,0.0,0.0,41,61
1723,relax_and_recompute,0.2,33,34,-1,-0.5384989905164446,0.0398816997391653,13,31
1724,relax_and_recompute,0.2,5,3,2,12.118750923999592,-0.1168739524455244,10,15
1725,relax_and_recompute,0.2,6,5,1,2.3116501951879656,-0.0709648635201967,37,47
1726,relax_and_recompute,0.2,0,0,0,0.0,-0.0059846962189432,21,21
1727,relax_and_recompute,0.2,0,0,0,0.0,0.0,11,10
1728,relax_and_recompute,0.2,57,57,0,0.0064914760634735,-0.0077421754008314,44,80
1729,relax_and_recompute,0.2,6,6,0,0.0,0.0,12,21
1730,relax_and_recompute,0.2,2,2,0,40.57817790180843,-0.0379305285754828,37,43
1731,relax_and_recompute,0.2,6,8,-2,-0.1735310719531781,0.0463842795036362,41,52
1732,relax_and_recompute,0.2,0,0,0,0.0,0.0,90,89
1733,relax_and_recompute,0.2,0,0,0,0.0,0.0,22,21
1734,relax_and_recompute,0.2,1,6,-5,-12.824308725883805,-0.0280060439235303,37,43
1735,relax_and_recompute,0.2,0,1,-1,-89.65010094514068,0.1086179312853023,47,47
1736,relax_and_recompute,0.2,4,4,0,0.0,0.0,12,20
1737,relax_and_recompute,0.2,114,114,0,0.0,0.0,84,124
1738,relax_and_recompute,0.2,0,0,0,0.0,0.0,88,92
1739,relax_and_recompute,0.2,380,377,3,-0.3714807714610657,-0.0025427242202904,59,122
1740,relax_and_recompute,0.2,4,3,1,0.203280810508815,0.0446821006516815,26,31
1741,relax_and_recompute,0.2,0,0,0,0.0,0.0,28,27
1742,relax_and_recompute,0.2,6,6,0,0.0,0.0,18,26
1743,relax_and_recompute,0.2,1,3,-2,-12.914228578214503,0.0322817081119266,23,26
1744,relax_and_recompute,0.2,0,0,0,0.0,0.0245394465672463,43,43
1745,relax_and_recompute,0.2,2,3,-1,21.88435388865216,0.1514871415624002,22,26
1746,relax_and_recompute,0.2,0,0,0,0.0,0.0,15,14
1747,relax_and_recompute,0.2,10,19,-9,5.648675414166,0.1018849030252861,36,48
1748,relax_and_recompute,0.2,6,6,0,3.132031887299874,-0.366934867361315,30,37
1749,relax_and_recompute,0.2,1,1,0,0.0,0.0,10,13
1750,relax_and_recompute,0.2,0,0,0,0.0,0.0,12,11
1751,relax_and_recompute,0.2,168,153,15,-1.4597591062543387,0.1638614131178267,55,105
1752,relax_and_recompute,0.2,1,1,0,17.12164821735773,0.0578261695456346,13,17
1753,relax_and_recompute,0.2,0,0,0,0.0,0.0,30,29
1754,relax_and_recompute,0.2,3,4,-1,-9.905682406522075,-0.002170500293968,36,43
1755,relax_and_recompute,0.2,36,40,-4,-3.781728400218512,-0.055822645815706,40,60
1756,relax_and_recompute,0.2,0,0,0,0.0,0.0,13,17
1757,relax_and_recompute,0.2,6,8,-2,-4.960402959672933,-0.0115319394462201,23,30
1758,relax_and_recompute,0.2,0,0,0,0.0,0.0,12,16
1759,relax_and_recompute,0.2,0,0,0,0.0,0.0,26,26
1760,relax_and_recompute,0.2,0,0,0,0.0,0.0,22,31
1761,relax_and_recompute,0.2,0,0,0,0.0,0.0,68,68
1762,relax_and_recompute,0.2,0,0,0,0.0,0.0,23,22
1763,relax_and_recompute,0.2,0,0,0,0.0,-0.0349525596057489,43,42
1764,relax_and_recompute,0.2,0,0,0,0.0,0.0,18,17
1765,relax_and_recompute,0.2,3,1,2,16.774590073756514,-0.1297888041253873,28,42
1766,relax_and_recompute,0.2,45,50,-5,1.8841541587735409,0.0156030402407787,21,44
1767,relax_and_recompute,0.2,0,0,0,0.0,0.0,36,37
1768,relax_and_recompute,0.2,0,0,0,0.0,0.0,15,14
1769,relax_and_recompute,0.2,1,1,0,0.0,0.0,14,16
1770,relax_and_recompute,0.2,197,211,-14,1.6294158914226389,0.1952030013326532,61,119
1771,relax_and_recompute,0.2,0,0,0,0.0,0.0,19,20
1772,relax_and_recompute,0.2,0,2,-2,-52.79175496631128,0.0259444423045324,22,22
1773,relax_and_recompute,0.2,0,0,0,0.0,-0.0413225144380497,54,58
1774,relax_and_recompute,0.2,651,651,0,0.0,0.0,65,135
1775,relax_and_recompute,0.2,1,1,0,0.0,0.0,16,18
1776,relax_and_recompute,0.2,7,8,-1,8.396787180550831,0.1080910940256584,17,27
1777,relax_and_recompute,0.2,22,4,18,-18.61747849085588,0.1446288399504806,54,71
1778,relax_and_recompute,0.2,0,2,-2,-69.51467976885004,-0.0285407675374049,23,22
1779,relax_and_recompute,0.2,1,0,1,76.88395716132196,-0.1491322016956315,13,16
1780,relax_and_recompute,0.2,155,149,6,-2.794184228530185,-0.0034415506621975,85,131
1781,relax_and_recompute,0.2,44,58,-14,6.627037203531586,0.0061263330641294,28,55
1782,relax_and_recompute,0.2,4,4,0,17.431676694704336,-0.0893290688064797,18,24
1783,relax_and_recompute,0.2,0,0,0,0.0,0.0,19,22
1784,relax_and_recompute,0.2,0,1,-1,-82.00366620821269,0.0734444320361835,47,46
1785,relax_and_recompute,0.2,21,21,0,-3.6879171991704425,0.0716976646866419,39,64
1786,relax_and_recompute,0.2,0,0,0,0.0,0.0,17,18
1787,relax_and_recompute,0.2,1,1,0,0.0,0.0,23,24
1788,relax_and_recompute,0.2,2,2,0,-2.1515607672736223,0.0826566971112059,13,16
1789,relax_and_recompute,0.2,22,13,9,-0.7653465239512514,0.0480027811499798,40,56
1790,relax_and_recompute,0.2,1,1,0,-6.456334298675088,-0.0400486519001042,10,15
1791,relax_and_recompute,0.2,0,0,0,0.0,0.0,21,20
1792,relax_and_recompute,0.2,4,3,1,12.912434556136668,-0.146669221012796,30,35
1793,relax_and_recompute,0.2,1,1,0,0.0,0.0,71,77
1794,relax_one,0.2,0,0,0,0.0,0.0,17,18
1795,relax_one,0.2,1,1,0,0.0,0.0,43,48
1796,relax_one,0.2,3,3,0,0.0,0.0,38,45
1797,relax_one,0.2,0,0,0,0.0,0.0,12,12
1798,relax_one,0.2,20,18,2,-3.2752299140735204,0.0114158034923678,23,38
1799,relax_one,0.2,0,1,-1,-78.11694026732484,-0.0295512202700576,19,22
1800,relax_one,0.2,976,978,-2,0.1423455471242221,-0.0025418055405018,35,143
1801,relax_one,0.2,0,1,-1,-50.19567681247512,-0.0041327022016595,92,91
1802,relax_one,0.2,2,2,0,0.0,0.0,43,51
1803,relax_one,0.2,1,1,0,0.0,0.0,35,36
1804,relax_one,0.2,1,1,0,0.0,0.0,11,13
1805,relax_one,0.2,22,20,2,-3.01441643358082,0.0082886474985522,10,25
1806,relax_one,0.2,16,16,0,0.0,0.0,86,136
1807,relax_one,0.2,0,0,0,0.0,0.0,10,12
1808,relax_one,0.2,0,0,0,0.0,0.0,32,31
1809,relax_one,0.2,2,2,0,4.970962038347736,-0.0904350603192869,20,26
1810,relax_one,0.2,0,0,0,0.0,0.0,11,11
1811,relax_one,0.2,2,2,0,0.0,0.0,34,42
1812,relax_one,0.2,11,11,0,0.0,0.0,14,25
1813,relax_one,0.2,8,7,1,13.99583228956454,0.1582030612456263,31,46
1814,relax_one,0.2,0,0,0,0.0,0.0,42,45
1815,relax_one,0.2,1265,1240,25,0.1009906236120983,0.0001682713719424,39,173
1816,relax_one,0.2,11,11,0,0.0,0.0,14,24
1817,relax_one,0.2,0,0,0,0.0,0.0,24,25
1818,relax_one,0.2,2,2,0,0.0,0.0,12,19
1819,relax_one,0.2,59,59,0,0.4609819410147793,0.0044552421238692,41,72
1820,relax_one,0.2,182,191,-9,1.446975953367918,0.0358261975695221,59,115
1821,relax_one,0.2,6,6,0,0.0,0.0,32,37
1822,relax_one,0.2,1,1,0,0.0,0.0,20,20
1823,relax_one,0.2,41,32,9,2.305146048931391,0.0775874222420341,12,31
1824,relax_one,0.2,0,0,0,0.0,0.0,10,10
1825,relax_one,0.2,0,0,0,0.0,0.0,20,21
1826,relax_one,0.2,18,18,0,0.0,0.0,39,52
1827,relax_one,0.2,378,395,-17,-0.4859193577000411,-0.0010324457545943,42,109
1828,relax_one,0.2,1,1,0,0.0,0.0,25,28
1829,relax_one,0.2,170,170,0,0.0,0.0,56,106
1830,relax_one,0.2,567,595,-28,0.7834114754025379,-0.002967395777259,87,189
1831,relax_one,0.2,41,41,0,-3.1762323320181167,-0.0099859384844429,56,82
1832,relax_one,0.2,2,2,0,0.0,0.0,13,15
1833,relax_one,0.2,104,88,16,-3.3995451437074067,-0.111275141568526,36,63
1834,relax_one,0.2,0,0,0,0.0,0.0,16,15
1835,relax_one,0.2,0,0,0,0.0,0.0,67,66
1836,relax_one,0.2,13,13,0,0.0,0.0,42,60
1837,relax_one,0.2,0,0,0,0.0,0.0,39,38
1838,relax_one,0.2,8,8,0,0.0,0.0,20,36
1839,relax_one,0.2,0,0,0,0.0,0.0,10,9
1840,relax_one,0.2,1,1,0,0.0,0.0,13,15
1841,relax_one,0.2,6,7,-1,12.522285729298716,0.0299062089849014,34,41
1842,relax_one,0.2,3,3,0,0.0,0.0,37,42
1843,relax_one,0.2,36,36,0,0.0,0.0,18,29
1844,relax_one,0.2,0,0,0,0.0,0.0,23,22
1845,relax_one,0.2,0,0,0,0.0,0.0,13,12
1846,relax_one,0.2,0,0,0,0.0,0.0,15,14
1847,relax_one,0.2,0,0,0,0.0,0.0,69,68
1848,relax_one,0.2,0,0,0,0.0,0.0,40,39
1849,relax_one,0.2,0,0,0,0.0,0.0,89,93
1850,relax_one,0.2,13,13,0,-2.975681235416161,-0.0847204542309565,20,32
1851,relax_one,0.2,2,2,0,0.0,0.0,69,83
1852,relax_one,0.2,2,2,0,0.0,0.0,12,15
1853,relax_one,0.2,0,0,0,0.0,0.0,15,14
1854,relax_one,0.2,0,0,0,0.0,0.0,23,26
1855,relax_one,0.2,2,2,0,0.0,0.0,12,20
1856,relax_one,0.2,201,201,0,0.0,0.0,64,122
1857,relax_one,0.2,7,7,0,0.0,0.0,58,71
1858,relax_one,0.2,0,0,0,0.0,0.0,20,19
1859,relax_one,0.2,510,510,0,0.0060639005596385,-0.0006916839131552,100,191
1860,relax_one,0.2,34,34,0,0.0,0.0,41,61
1861,relax_one,0.2,33,34,-1,-0.6264707699284884,0.0331924782664471,13,31
1862,relax_one,0.2,5,5,0,0.0,0.0,10,15
1863,relax_one,0.2,6,6,0,0.0,0.0,37,47
1864,relax_one,0.2,0,0,0,0.0,0.0,21,21
1865,relax_one,0.2,0,0,0,0.0,0.0,11,10
1866,relax_one,0.2,57,55,2,-1.1796960984034186,9.734149291917849e-05,44,80
1867,relax_one,0.2,6,6,0,0.0,0.0,12,21
1868,relax_one,0.2,2,2,0,42.15913628345388,-0.0181760816329957,37,43
1869,relax_one,0.2,6,6,0,0.0,0.0,41,52
1870,relax_one,0.2,0,0,0,0.0,0.0,90,89
1871,relax_one,0.2,0,0,0,0.0,0.0,22,21
1872,relax_one,0.2,1,1,0,-4.213527745425694,0.0417394626549948,37,43
1873,relax_one,0.2,0,0,0,0.0,0.0,47,47
1874,relax_one,0.2,4,4,0,0.0,0.0,12,20
1875,relax_one,0.2,114,114,0,0.0,0.0,84,124
1876,relax_one,0.2,0,0,0,0.0,0.0,88,92
1877,relax_one,0.2,380,377,3,-0.3714807714610657,-0.0025427242202904,59,122
1878,relax_one,0.2,4,4,0,0.0,0.0,26,31
1879,relax_one,0.2,0,0,0,0.0,0.0,28,27
1880,relax_one,0.2,6,6,0,0.0,0.0,18,26
1881,relax_one,0.2,1,1,0,0.0,0.0,23,26
1882,relax_one,0.2,0,0,0,0.0,0.0,43,43
1883,relax_one,0.2,2,2,0,0.0,0.0,22,26
1884,relax_one,0.2,0,0,0,0.0,0.0,15,14
1885,relax_one,0.2,10,17,-7,3.5874123628873704,0.0856058777554238,36,48
1886,relax_one,0.2,6,6,0,2.8016025522275783,-0.3535412006642752,30,37
1887,relax_one,0.2,1,1,0,0.0,0.0,10,13
1888,relax_one,0.2,0,0,0,0.0,0.0,12,11
1889,relax_one,0.2,168,167,1,-0.7965879277094672,0.0475430066924907,55,105
1890,relax_one,0.2,1,1,0,17.12164821735773,0.0578261695456346,13,17
1891,relax_one,0.2,0,0,0,0.0,0.0,30,29
1892,relax_one,0.2,3,3,0,0.0,0.0,36,43
1893,relax_one,0.2,36,36,0,0.0,0.0,40,60
1894,relax_one,0.2,0,0,0,0.0,0.0,13,17
1895,relax_one,0.2,6,7,-1,-5.27235869178908,0.0082826452568239,23,30
1896,relax_one,0.2,0,0,0,0.0,0.0,12,16
1897,relax_one,0.2,0,0,0,0.0,0.0,26,26
1898,relax_one,0.2,0,0,0,0.0,0.0,22,31
1899,relax_one,0.2,0,0,0,0.0,0.0,68,68
1900,relax_one,0.2,0,0,0,0.0,0.0,23,22
1901,relax_one,0.2,0,0,0,0.0,-0.0348129737608335,43,42
1902,relax_one,0.2,0,0,0,0.0,0.0,18,17
1903,relax_one,0.2,3,3,0,0.0,0.0,28,42
1904,relax_one,0.2,45,45,0,0.1036479088850654,-0.0041754562964496,21,44
1905,relax_one,0.2,0,0,0,0.0,0.0,36,37
1906,relax_one,0.2,0,0,0,0.0,0.0,15,14
1907,relax_one,0.2,1,1,0,0.0,0.0,14,16
1908,relax_one,0.2,197,204,-7,3.484436282689749,0.1757315340586914,61,119
1909,relax_one,0.2,0,0,0,0.0,0.0,19,20
1910,relax_one,0.2,0,0,0,0.0,0.0,22,22
1911,relax_one,0.2,0,0,0,0.0,0.0,54,58
1912,relax_one,0.2,651,651,0,0.0,0.0,65,135
1913,relax_one,0.2,1,1,0,0.0,0.0,16,18
1914,relax_one,0.2,7,7,0,0.0,0.0,17,27
1915,relax_one,0.2,22,4,18,-19.06910671434205,0.1469333863626725,54,71
1916,relax_one,0.2,0,2,-2,-59.99819093035041,-0.0131455917893484,23,22
1917,relax_one,0.2,1,0,1,76.88395716132196,-0.1491322016956315,13,16
1918,relax_one,0.2,155,146,9,-2.3741667241416664,-0.001397205031107,85,131
1919,relax_one,0.2,44,44,0,0.0,0.0,28,55
1920,relax_one,0.2,4,4,0,0.0,0.0,18,24
1921,relax_one,0.2,0,0,0,0.0,0.0,19,22
1922,relax_one,0.2,0,0,0,0.0,0.0,47,46
1923,relax_one,0.2,21,19,2,-6.356920988253222,0.0143956759658575,39,64
1924,relax_one,0.2,0,0,0,0.0,0.0,17,18
1925,relax_one,0.2,1,1,0,0.0,0.0,23,24
1926,relax_one,0.2,2,2,0,0.0,0.0,13,16
1927,relax_one,0.2,22,22,0,0.0,0.0,40,56
1928,relax_one,0.2,1,1,0,0.0,0.0,10,15
1929,relax_one,0.2,0,0,0,0.0,0.0,21,20
1930,relax_one,0.2,4,4,0,0.0,0.0,30,35
1931,relax_one,0.2,1,1,0,0.0,0.0,71,77
1932,just_relax,0.2,0,0,0,0.0,-0.0091692815110081,17,18
1933,just_relax,0.2,1,1,0,0.0009607869158827,0.0014628518031132,43,48
1934,just_relax,0.2,3,3,0,-0.0019521681741139,-7.679999619569777e-05,38,45
1935,just_relax,0.2,0,0,0,0.0,-0.0037600566419999,12,12
1936,just_relax,0.2,20,14,6,1.9891400956483096,0.1544148745043621,23,38
1937,just_relax,0.2,0,1,-1,-78.11694026732484,-0.0295512202700576,19,22
1938,just_relax,0.2,976,1188,-212,1.3106081233515638,0.0257948127350838,35,143
1939,just_relax,0.2,0,4,-4,-39.1818408082167,-0.0156618414823971,92,91
1940,just_relax,0.2,2,2,0,-0.00041775540015,-0.0002552385505018,43,51
1941,just_relax,0.2,1,1,0,-0.0016870080925173,6.40249009676297e-05,35,36
1942,just_relax,0.2,1,1,0,-0.000156439410091,0.0002508982184644,11,13
1943,just_relax,0.2,22,24,-2,-3.49415891827384,0.1000113687896936,10,25
1944,just_relax,0.2,16,13,3,0.2088785180214571,-2.2771107622610032e-05,86,136
1945,just_relax,0.2,0,0,0,0.0,-1.765503840900351e-06,10,12
1946,just_relax,0.2,0,0,0,0.0,-1.014518260578079e-05,32,31
1947,just_relax,0.2,2,2,0,4.970962038347736,-0.0904350603192869,20,26
1948,just_relax,0.2,0,0,0,0.0,0.000269092021105,11,11
1949,just_relax,0.2,2,2,0,0.0009292844165713,-0.0008610890242942,34,42
1950,just_relax,0.2,11,11,0,-0.0003616788843885,0.0005035529702898,14,25
1951,just_relax,0.2,8,7,1,13.99583228956454,0.1582030612456263,31,46
1952,just_relax,0.2,0,0,0,0.0,0.0042083907430441,42,45
1953,just_relax,0.2,1265,1285,-20,2.6849459664833404,-0.1292871249874528,39,173
1954,just_relax,0.2,11,11,0,0.0001627700527109,0.0015600944076981,14,24
1955,just_relax,0.2,0,0,0,0.0,-0.000608053012485,24,25
1956,just_relax,0.2,2,2,0,-2.981324638540173e-05,0.0001440646714581,12,19
1957,just_relax,0.2,59,59,0,0.4609819410147793,0.0044552421238692,41,72
1958,just_relax,0.2,182,178,4,0.0313317398119608,0.0970080713564147,59,115
1959,just_relax,0.2,6,6,0,-0.0020404096920856,0.0011964290694836,32,37
1960,just_relax,0.2,1,0,1,64.5674534074053,-0.0013228453280204,20,20
1961,just_relax,0.2,41,33,8,8.182357833947279,-0.009895766072516,12,31
1962,just_relax,0.2,0,0,0,0.0,-1.5942199658169898e-06,10,10
1963,just_relax,0.2,0,0,0,0.0,0.0018153466622625,20,21
1964,just_relax,0.2,18,18,0,0.0003589278580733,-0.0005865039043362,39,52
1965,just_relax,0.2,378,369,9,2.979528253482861,0.0835817869771829,42,109
1966,just_relax,0.2,1,1,0,-0.0010366044558338,-5.546321229055184e-05,25,28
1967,just_relax,0.2,170,170,0,-0.0002769762706833,-0.0005002245004087,56,106
1968,just_relax,0.2,567,521,46,-0.2657392120378574,0.1239070997048957,87,189
1969,just_relax,0.2,41,43,-2,2.499128887843675,-0.033528056765164,56,82
1970,just_relax,0.2,2,2,0,0.0004861774901456,1.2071037781558047e-06,13,15
1971,just_relax,0.2,104,86,18,5.26724471872344,-0.2840091449765524,36,63
1972,just_relax,0.2,0,0,0,0.0,4.3915154694929015e-06,16,15
1973,just_relax,0.2,0,0,0,0.0,-5.223096419815221e-07,67,66
1974,just_relax,0.2,13,13,0,0.0024384647237383,0.004260897920215,42,60
1975,just_relax,0.2,0,0,0,0.0,0.0005903979895692,39,38
1976,just_relax,0.2,8,8,0,-3.330899971842882e-05,0.0005334774465118,20,36
1977,just_relax,0.2,0,0,0,0.0,-0.0010596071395927,10,9
1978,just_relax,0.2,1,1,0,0.0009644178095271,-1.805181839154013e-05,13,15
1979,just_relax,0.2,6,7,-1,12.522285729298716,0.0299062089849014,34,41
1980,just_relax,0.2,3,3,0,-0.0014185667246167,0.0006213779664755,37,42
1981,just_relax,0.2,36,36,0,7.196136941445275e-06,5.025038399830706e-06,18,29
1982,just_relax,0.2,0,0,0,0.0,-0.0031405837993232,23,22
1983,just_relax,0.2,0,0,0,0.0,1.0504657718901632e-05,13,12
1984,just_relax,0.2,0,0,0,0.0,-0.0007613272869088,15,14
1985,just_relax,0.2,0,0,0,0.0,-0.0017207203528439,69,68
1986,just_relax,0.2,0,0,0,0.0,0.001934163275203,40,39
1987,just_relax,0.2,0,0,0,0.0,0.0016954512903432,89,93
1988,just_relax,0.2,13,13,0,1.511050374969713,-0.0878570612978808,20,32
1989,just_relax,0.2,2,3,-1,-4.120223819609976,0.0096644512108772,69,83
1990,just_relax,0.2,2,2,0,0.0006766545457281,-0.0007958153584334,12,15
1991,just_relax,0.2,0,0,0,0.0,-0.0009758471183408,15,14
1992,just_relax,0.2,0,0,0,0.0,-0.0007570529942456,23,26
1993,just_relax,0.2,2,2,0,-0.0004670837519427,-0.000552899751354,12,20
1994,just_relax,0.2,201,201,0,-5.927609844036397e-05,0.0001073571901385,64,122
1995,just_relax,0.2,7,7,0,-0.0099055150386959,0.0003544031231826,58,71
1996,just_relax,0.2,0,0,0,0.0,-0.0013086772972689,20,19
1997,just_relax,0.2,510,505,5,-0.1096058695008466,0.0001562332230281,100,191
1998,just_relax,0.2,34,34,0,0.0046498502251353,3.462795885833536e-05,41,61
1999,just_relax,0.2,33,21,12,-0.322372772893118,0.0487025778316814,13,31
2000,just_relax,0.2,5,5,0,0.0003476406123752,0.0002826333043987,10,15
2001,just_relax,0.2,6,6,0,-0.0004254358946269,0.0003115870201488,37,47
2002,just_relax,0.2,0,0,0,0.0,0.0007350584472026,21,21
2003,just_relax,0.2,0,0,0,0.0,9.621758975453254e-06,11,10
2004,just_relax,0.2,57,55,2,-1.1796960984034186,9.734149291917849e-05,44,80
2005,just_relax,0.2,6,6,0,0.0001929725905256,-1.6711583069151104e-05,12,21
2006,just_relax,0.2,2,5,-3,10.477360070400792,-0.0167672873232497,37,43
2007,just_relax,0.2,6,6,0,-9.27967616917158e-05,0.0005867078171852,41,52
2008,just_relax,0.2,0,0,0,0.0,0.0258238191424075,90,89
2009,just_relax,0.2,0,0,0,0.0,-0.0001762041220683,22,21
2010,just_relax,0.2,1,5,-4,-25.99394547658536,0.034397478016983,37,43
2011,just_relax,0.2,0,0,0,0.0,0.009279908390236,47,47
2012,just_relax,0.2,4,4,0,-0.0003372893218767,-9.212772776878708e-07,12,20
2013,just_relax,0.2,114,95,19,0.8287298242191525,-0.006531385777559,84,124
2014,just_relax,0.2,0,0,0,0.0,0.0016708237920683,88,92
2015,just_relax,0.2,380,332,48,-1.681066658089314,0.0270328691740772,59,122
2016,just_relax,0.2,4,4,0,2.0677824380754828e-05,-0.000363330475558,26,31
2017,just_relax,0.2,0,0,0,0.0,4.418930553695688e-06,28,27
2018,just_relax,0.2,6,6,0,0.0013890930604816,7.243956427815945e-06,18,26
2019,just_relax,0.2,1,1,0,-0.0014241348598034,0.001861633846505,23,26
2020,just_relax,0.2,0,0,0,0.0,0.0001814651838247,43,43
2021,just_relax,0.2,2,2,0,0.0004949068667485,0.0012137972461528,22,26
2022,just_relax,0.2,0,0,0,0.0,8.316094011640018e-06,15,14
2023,just_relax,0.2,10,17,-7,3.5874123628873704,0.0856058777554238,36,48
2024,just_relax,0.2,6,6,0,2.8016025522275783,-0.3535412006642752,30,37
2025,just_relax,0.2,1,1,0,5.455328151526828e-05,-4.433967369288361e-05,10,13
2026,just_relax,0.2,0,0,0,0.0,-0.0049855760382295,12,11
2027,just_relax,0.2,168,182,-14,1.1771250480206064,-0.0267800915114647,55,105
2028,just_relax,0.2,1,1,0,17.12164821735773,0.0578261695456346,13,17
2029,just_relax,0.2,0,0,0,0.0,0.0003329515887838,30,29
2030,just_relax,0.2,3,3,0,0.000583815366788,0.0008768881680062,36,43
2031,just_relax,0.2,36,36,0,0.0010314806767866,-5.393936385500453e-05,40,60
2032,just_relax,0.2,0,0,0,0.0,0.0017894746066188,13,17
2033,just_relax,0.2,6,7,-1,-5.27235869178908,0.0082826452568239,23,30
2034,just_relax,0.2,0,0,0,0.0,-2.940409977925107e-05,12,16
2035,just_relax,0.2,0,0,0,0.0,3.901708024223183e-06,26,26
2036,just_relax,0.2,0,0,0,0.0,-0.0031688166024113,22,31
2037,just_relax,0.2,0,0,0,0.0,0.0008768193667615,68,68
2038,just_relax,0.2,0,0,0,0.0,-7.938175057398134e-06,23,22
2039,just_relax,0.2,0,0,0,0.0,-0.065399188004364,43,42
2040,just_relax,0.2,0,0,0,0.0,-0.002899723134464,18,17
2041,just_relax,0.2,3,3,0,-0.003194586812441,0.0012605153222713,28,42
2042,just_relax,0.2,45,58,-13,0.9231299892006462,0.088218433779717,21,44
2043,just_relax,0.2,0,0,0,0.0,-0.0112811671875761,36,37
2044,just_relax,0.2,0,0,0,0.0,-3.4878924121017896e-05,15,14
2045,just_relax,0.2,1,1,0,-0.0014549239964907,-0.00058525619921,14,16
2046,just_relax,0.2,197,237,-40,1.3477492998050025,0.0885093784332623,61,119
2047,just_relax,0.2,0,0,0,0.0,-0.0038599581671643,19,20
2048,just_relax,0.2,0,0,0,0.0,-0.0006472841631984,22,22
2049,just_relax,0.2,0,0,0,0.0,-0.0011415137972972,54,58
2050,just_relax,0.2,651,651,0,-0.0003954210755097,0.0002252638081207,65,135
2051,just_relax,0.2,1,1,0,-0.0029471577812358,0.0001749400264638,16,18
2052,just_relax,0.2,7,7,0,0.0002013814076775,0.0006636994664107,17,27
2053,just_relax,0.2,22,7,15,-12.985895473169307,0.1330374466905183,54,71
2054,just_relax,0.2,0,2,-2,-59.99819093035041,-0.0131455917893484,23,22
2055,just_relax,0.2,1,0,1,76.88395716132196,-0.1491322016956315,13,16
2056,just_relax,0.2,155,185,-30,2.3843149677438973,-0.02495720013905,85,131
2057,just_relax,0.2,44,44,0,0.0003032918935019,0.0025857794052007,28,55
2058,just_relax,0.2,4,4,0,-0.0007096785766407,-5.4537984728875166e-05,18,24
2059,just_relax,0.2,0,0,0,0.0,-0.003226028074061,19,22
2060,just_relax,0.2,0,0,0,0.0,0.0048197166778652,47,46
2061,just_relax,0.2,21,27,-6,0.0602947270368474,-0.3310372682946312,39,64
2062,just_relax,0.2,0,0,0,0.0,-0.0037052423868473,17,18
2063,just_relax,0.2,1,1,0,0.0005119856857191,0.0004745196477359,23,24
2064,just_relax,0.2,2,2,0,0.0010275548569325,-0.004970471779609,13,16
2065,just_relax,0.2,22,22,0,0.0038770082111057,0.0004285387996507,40,56
2066,just_relax,0.2,1,1,0,-0.0002865966515059,-0.0003325971221349,10,15
2067,just_relax,0.2,0,0,0,0.0,0.0003384089422906,21,20
2068,just_relax,0.2,4,4,0,-0.0001029723687508,-0.0013906355929786,30,35
2069,just_relax,0.2,1,1,0,0.0051043410712594,-0.0056156512673798,71,77
2070,relax_and_recompute,0.25,0,0,0,0.0,0.0,17,18
2071,relax_and_recompute,0.25,1,1,0,33.913834292408055,-0.0319366967583969,43,48
2072,relax_and_recompute,0.25,3,5,-2,9.88581419291326,0.0069193652867528,38,45
2073,relax_and_recompute,0.25,0,0,0,0.0,0.0,12,12
2074,relax_and_recompute,0.25,20,7,13,1.502478168846423,0.2029862696446577,23,38
2075,relax_and_recompute,0.25,0,1,-1,-78.11694026732484,-0.0295512202700576,19,22
2076,relax_and_recompute,0.25,976,1004,-28,-0.0620531910963606,-0.0009330148689207,35,143
2077,relax_and_recompute,0.25,0,0,0,0.0,-0.0046858462976494,92,91
2078,relax_and_recompute,0.25,2,2,0,0.0,0.0,43,51
2079,relax_and_recompute,0.25,1,1,0,0.0,0.0,35,36
2080,relax_and_recompute,0.25,1,1,0,0.0,0.0,11,13
2081,relax_and_recompute,0.25,22,19,3,-4.957652547927751,0.037406937188411,10,25
2082,relax_and_recompute,0.25,16,16,0,-1.2375805476415778,-0.0662978026850604,86,136
2083,relax_and_recompute,0.25,0,0,0,0.0,0.0,10,12
2084,relax_and_recompute,0.25,0,0,0,0.0,0.0,32,31
2085,relax_and_recompute,0.25,2,2,0,0.8097822186271628,0.0720915422264546,20,26
2086,relax_and_recompute,0.25,0,0,0,0.0,0.0,11,11
2087,relax_and_recompute,0.25,2,2,0,1.6133031779469889,-0.0013837411504996,34,42
2088,relax_and_recompute,0.25,11,10,1,1.5445267212396203,-0.0356816848306716,14,25
2089,relax_and_recompute,0.25,8,4,4,9.035240939106416,-0.2006547963227668,31,46
2090,relax_and_recompute,0.25,0,2,-2,-60.43825847577355,-0.1126466588104083,42,45
2091,relax_and_recompute,0.25,1265,1233,32,-0.0829886923942524,-0.0013136328692162,39,173
2092,relax_and_recompute,0.25,11,10,1,-0.9259083214164718,-0.0036589420660914,14,24
2093,relax_and_recompute,0.25,0,0,0,0.0,0.0,24,25
2094,relax_and_recompute,0.25,2,2,0,0.0,0.0,12,19
2095,relax_and_recompute,0.25,59,59,0,0.0004995248301611,-0.0021609985989152,41,72
2096,relax_and_recompute,0.25,182,192,-10,2.176227062990442,0.127488881317396,59,115
2097,relax_and_recompute,0.25,6,4,2,3.758843121777289,0.465210734665941,32,37
2098,relax_and_recompute,0.25,1,0,1,64.5674534074053,-0.1072594416335612,20,20
2099,relax_and_recompute,0.25,41,26,15,-1.6275846340626714,0.0729158968985802,12,31
2100,relax_and_recompute,0.25,0,0,0,0.0,0.0,10,10
2101,relax_and_recompute,0.25,0,0,0,0.0,0.0,20,21
2102,relax_and_recompute,0.25,18,21,-3,0.5719110189928784,0.3696791622426242,39,52
2103,relax_and_recompute,0.25,378,393,-15,0.6108526484877643,4.422482210819645e-05,42,109
2104,relax_and_recompute,0.25,1,9,-8,21.83036785786023,-0.009946187399486,25,28
2105,relax_and_recompute,0.25,170,157,13,-3.523679109137184,0.105536041898159,56,106
2106,relax_and_recompute,0.25,567,575,-8,0.4383057260994292,-0.0017656065849445,87,189
2107,relax_and_recompute,0.25,41,40,1,-2.249384452446378,-0.0072514307594979,56,82
2108,relax_and_recompute,0.25,2,2,0,-8.392740270897733,0.5389967143152127,13,15
2109,relax_and_recompute,0.25,104,88,16,-3.3995451437074067,-0.111275141568526,36,63
2110,relax_and_recompute,0.25,0,0,0,0.0,0.0,16,15
2111,relax_and_recompute,0.25,0,0,0,0.0,-0.0061884200170785,67,66
2112,relax_and_recompute,0.25,13,13,0,0.0,0.0,42,60
2113,relax_and_recompute,0.25,0,0,0,0.0,0.0,39,38
2114,relax_and_recompute,0.25,8,9,-1,8.482609675305326,-0.0246353290916525,20,36
2115,relax_and_recompute,0.25,0,0,0,0.0,0.0,10,9
2116,relax_and_recompute,0.25,1,1,0,0.0,0.0,13,15
2117,relax_and_recompute,0.25,6,14,-8,18.824286639655867,-0.0841754274640885,34,41
2118,relax_and_recompute,0.25,3,5,-2,3.41159566991864,0.101618768403258,37,42
2119,relax_and_recompute,0.25,36,36,0,0.0,0.0,18,29
2120,relax_and_recompute,0.25,0,0,0,0.0,0.0248357687538134,23,22
2121,relax_and_recompute,0.25,0,0,0,0.0,0.0,13,12
2122,relax_and_recompute,0.25,0,0,0,0.0,0.0,15,14
2123,relax_and_recompute,0.25,0,0,0,0.0,0.0,69,68
2124,relax_and_recompute,0.25,0,0,0,0.0,0.0,40,39
2125,relax_and_recompute,0.25,0,0,0,0.0,0.0,89,93
2126,relax_and_recompute,0.25,13,12,1,-2.153586113029718,-0.0708055525167026,20,32
2127,relax_and_recompute,0.25,2,3,-1,-7.067084936198143,-0.0593654442548075,69,83
2128,relax_and_recompute,0.25,2,2,0,0.0,0.0,12,15
2129,relax_and_recompute,0.25,0,0,0,0.0,0.0,15,14
2130,relax_and_recompute,0.25,0,0,0,0.0,0.0,23,26
2131,relax_and_recompute,0.25,2,2,0,0.0,0.0,12,20
2132,relax_and_recompute,0.25,201,208,-7,-0.777546499391029,-0.0168449909220319,64,122
2133,relax_and_recompute,0.25,7,3,4,-15.3477275810384,-0.0042339303565398,58,71
2134,relax_and_recompute,0.25,0,0,0,0.0,-0.1147932957929044,20,19
2135,relax_and_recompute,0.25,510,512,-2,-0.0138388627329746,-0.001793654381577,100,191
2136,relax_and_recompute,0.25,34,34,0,0.0,0.0,41,61
2137,relax_and_recompute,0.25,33,34,-1,-0.5384989905164446,0.0398816997391653,13,31
2138,relax_and_recompute,0.25,5,3,2,12.118750923999592,-0.1168739524455244,10,15
2139,relax_and_recompute,0.25,6,5,1,2.3116501951879656,-0.0709648635201967,37,47
2140,relax_and_recompute,0.25,0,0,0,0.0,-0.0059846962189432,21,21
2141,relax_and_recompute,0.25,0,0,0,0.0,0.0,11,10
2142,relax_and_recompute,0.25,57,57,0,0.0064914760634735,-0.0077421754008314,44,80
2143,relax_and_recompute,0.25,6,6,0,0.0,0.0,12,21
2144,relax_and_recompute,0.25,2,2,0,40.57817790180843,-0.0379305285754828,37,43
2145,relax_and_recompute,0.25,6,8,-2,-0.1735310719531781,0.0463842795036362,41,52
2146,relax_and_recompute,0.25,0,0,0,0.0,0.0,90,89
2147,relax_and_recompute,0.25,0,0,0,0.0,0.0,22,21
2148,relax_and_recompute,0.25,1,6,-5,-12.824308725883805,-0.0280060439235303,37,43
2149,relax_and_recompute,0.25,0,1,-1,-89.65010094514068,0.1086179312853023,47,47
2150,relax_and_recompute,0.25,4,4,0,0.0,0.0,12,20
2151,relax_and_recompute,0.25,114,114,0,0.0,0.0,84,124
2152,relax_and_recompute,0.25,0,0,0,0.0,0.0,88,92
2153,relax_and_recompute,0.25,380,377,3,-0.3714807714610657,-0.0025427242202904,59,122
2154,relax_and_recompute,0.25,4,3,1,0.203280810508815,0.0446821006516815,26,31
2155,relax_and_recompute,0.25,0,0,0,0.0,0.0,28,27
2156,relax_and_recompute,0.25,6,6,0,0.0,0.0,18,26
2157,relax_and_recompute,0.25,1,3,-2,-12.914228578214503,0.0322817081119266,23,26
2158,relax_and_recompute,0.25,0,0,0,0.0,0.0,43,43
2159,relax_and_recompute,0.25,2,3,-1,21.88435388865216,0.1514871415624002,22,26
2160,relax_and_recompute,0.25,0,0,0,0.0,0.0,15,14
2161,relax_and_recompute,0.25,10,19,-9,5.648675414166,0.1018849030252861,36,48
2162,relax_and_recompute,0.25,6,6,0,3.132031887299874,-0.366934867361315,30,37
2163,relax_and_recompute,0.25,1,1,0,0.0,0.0,10,13
2164,relax_and_recompute,0.25,0,0,0,0.0,0.0,12,11
2165,relax_and_recompute,0.25,168,153,15,-1.4597591062543387,0.1638614131178267,55,105
2166,relax_and_recompute,0.25,1,1,0,17.12164821735773,0.0578261695456346,13,17
2167,relax_and_recompute,0.25,0,0,0,0.0,0.0,30,29
2168,relax_and_recompute,0.25,3,4,-1,-9.905682406522075,-0.002170500293968,36,43
2169,relax_and_recompute,0.25,36,40,-4,-3.781728400218512,-0.055822645815706,40,60
2170,relax_and_recompute,0.25,0,0,0,0.0,0.0,13,17
2171,relax_and_recompute,0.25,6,8,-2,-4.960402959672933,-0.0115319394462201,23,30
2172,relax_and_recompute,0.25,0,0,0,0.0,0.0,12,16
2173,relax_and_recompute,0.25,0,0,0,0.0,0.0,26,26
2174,relax_and_recompute,0.25,0,0,0,0.0,0.0,22,31
2175,relax_and_recompute,0.25,0,0,0,0.0,0.0,68,68
2176,relax_and_recompute,0.25,0,0,0,0.0,0.0,23,22
2177,relax_and_recompute,0.25,0,0,0,0.0,-0.0349525596057489,43,42
2178,relax_and_recompute,0.25,0,0,0,0.0,0.0,18,17
2179,relax_and_recompute,0.25,3,1,2,16.774590073756514,-0.1297888041253873,28,42
2180,relax_and_recompute,0.25,45,50,-5,1.8841541587735409,0.0156030402407787,21,44
2181,relax_and_recompute,0.25,0,0,0,0.0,0.0,36,37
2182,relax_and_recompute,0.25,0,0,0,0.0,0.0,15,14
2183,relax_and_recompute,0.25,1,1,0,0.0,0.0,14,16
2184,relax_and_recompute,0.25,197,211,-14,1.6294158914226389,0.1952030013326532,61,119
2185,relax_and_recompute,0.25,0,0,0,0.0,0.0,19,20
2186,relax_and_recompute,0.25,0,2,-2,-52.79175496631128,0.0259444423045324,22,22
2187,relax_and_recompute,0.25,0,0,0,0.0,-0.0413225144380497,54,58
2188,relax_and_recompute,0.25,651,651,0,0.0,0.0,65,135
2189,relax_and_recompute,0.25,1,1,0,0.0,0.0,16,18
2190,relax_and_recompute,0.25,7,7,0,1.8691234648716488,0.0445121885028382,17,27
2191,relax_and_recompute,0.25,22,4,18,-18.61747849085588,0.1446288399504806,54,71
2192,relax_and_recompute,0.25,0,2,-2,-69.51467976885004,-0.0285407675374049,23,22
2193,relax_and_recompute,0.25,1,0,1,76.88395716132196,-0.1491322016956315,13,16
2194,relax_and_recompute,0.25,155,149,6,-2.794184228530185,-0.0034415506621975,85,131
2195,relax_and_recompute,0.25,44,58,-14,6.627037203531586,0.0061263330641294,28,55
2196,relax_and_recompute,0.25,4,4,0,17.431676694704336,-0.0893290688064797,18,24
2197,relax_and_recompute,0.25,0,0,0,0.0,0.0,19,22
2198,relax_and_recompute,0.25,0,0,0,0.0,0.0,47,46
2199,relax_and_recompute,0.25,21,21,0,-3.6879171991704425,0.0716976646866419,39,64
2200,relax_and_recompute,0.25,0,0,0,0.0,0.0,17,18
2201,relax_and_recompute,0.25,1,1,0,0.0,0.0,23,24
2202,relax_and_recompute,0.25,2,2,0,-2.1515607672736223,0.0826566971112059,13,16
2203,relax_and_recompute,0.25,22,13,9,-2.489023448459861,-0.0668838434847596,40,56
2204,relax_and_recompute,0.25,1,1,0,0.0,0.0,10,15
2205,relax_and_recompute,0.25,0,0,0,0.0,0.0,21,20
2206,relax_and_recompute,0.25,4,3,1,12.912434556136668,-0.146669221012796,30,35
2207,relax_and_recompute,0.25,1,1,0,0.0,0.0,71,77
2208,relax_one,0.25,0,0,0,0.0,0.0,17,18
2209,relax_one,0.25,1,1,0,0.0,0.0,43,48
2210,relax_one,0.25,3,3,0,0.0,0.0,38,45
2211,relax_one,0.25,0,0,0,0.0,0.0,12,12
2212,relax_one,0.25,20,18,2,-3.2752299140735204,0.0114158034923678,23,38
2213,relax_one,0.25,0,1,-1,-78.11694026732484,-0.0295512202700576,19,22
2214,relax_one,0.25,976,978,-2,0.1423455471242221,-0.0025418055405018,35,143
2215,relax_one,0.25,0,1,-1,-50.19567681247512,-0.0041327022016595,92,91
2216,relax_one,0.25,2,2,0,0.0,0.0,43,51
2217,relax_one,0.25,1,1,0,0.0,0.0,35,36
2218,relax_one,0.25,1,1,0,0.0,0.0,11,13
2219,relax_one,0.25,22,20,2,-3.01441643358082,0.0082886474985522,10,25
2220,relax_one,0.25,16,16,0,0.0,0.0,86,136
2221,relax_one,0.25,0,0,0,0.0,0.0,10,12
2222,relax_one,0.25,0,0,0,0.0,0.0,32,31
2223,relax_one,0.25,2,2,0,4.970962038347736,-0.0904350603192869,20,26
2224,relax_one,0.25,0,0,0,0.0,0.0,11,11
2225,relax_one,0.25,2,2,0,0.0,0.0,34,42
2226,relax_one,0.25,11,11,0,0.0,0.0,14,25
2227,relax_one,0.25,8,7,1,13.99583228956454,0.1582030612456263,31,46
2228,relax_one,0.25,0,0,0,0.0,0.0,42,45
2229,relax_one,0.25,1265,1240,25,0.1009906236120983,0.0001682713719424,39,173
2230,relax_one,0.25,11,11,0,0.0,0.0,14,24
2231,relax_one,0.25,0,0,0,0.0,0.0,24,25
2232,relax_one,0.25,2,2,0,0.0,0.0,12,19
2233,relax_one,0.25,59,59,0,0.4609819410147793,0.0044552421238692,41,72
2234,relax_one,0.25,182,191,-9,1.446975953367918,0.0358261975695221,59,115
2235,relax_one,0.25,6,6,0,0.0,0.0,32,37
2236,relax_one,0.25,1,1,0,0.0,0.0,20,20
2237,relax_one,0.25,41,32,9,2.305146048931391,0.0775874222420341,12,31
2238,relax_one,0.25,0,0,0,0.0,0.0,10,10
2239,relax_one,0.25,0,0,0,0.0,0.0,20,21
2240,relax_one,0.25,18,18,0,0.0,0.0,39,52
2241,relax_one,0.25,378,395,-17,-0.4859193577000411,-0.0010324457545943,42,109
2242,relax_one,0.25,1,1,0,0.0,0.0,25,28
2243,relax_one,0.25,170,170,0,0.0,0.0,56,106
2244,relax_one,0.25,567,595,-28,0.7834114754025379,-0.002967395777259,87,189
2245,relax_one,0.25,41,41,0,-3.1762323320181167,-0.0099859384844429,56,82
2246,relax_one,0.25,2,2,0,0.0,0.0,13,15
2247,relax_one,0.25,104,88,16,-3.3995451437074067,-0.111275141568526,36,63
2248,relax_one,0.25,0,0,0,0.0,0.0,16,15
2249,relax_one,0.25,0,0,0,0.0,0.0,67,66
2250,relax_one,0.25,13,13,0,0.0,0.0,42,60
2251,relax_one,0.25,0,0,0,0.0,0.0,39,38
2252,relax_one,0.25,8,8,0,0.0,0.0,20,36
2253,relax_one,0.25,0,0,0,0.0,0.0,10,9
2254,relax_one,0.25,1,1,0,0.0,0.0,13,15
2255,relax_one,0.25,6,7,-1,12.522285729298716,0.0299062089849014,34,41
2256,relax_one,0.25,3,3,0,0.0,0.0,37,42
2257,relax_one,0.25,36,36,0,0.0,0.0,18,29
2258,relax_one,0.25,0,0,0,0.0,0.0,23,22
2259,relax_one,0.25,0,0,0,0.0,0.0,13,12
2260,relax_one,0.25,0,0,0,0.0,0.0,15,14
2261,relax_one,0.25,0,0,0,0.0,0.0,69,68
2262,relax_one,0.25,0,0,0,0.0,0.0,40,39
2263,relax_one,0.25,0,0,0,0.0,0.0,89,93
2264,relax_one,0.25,13,13,0,-2.975681235416161,-0.0847204542309565,20,32
2265,relax_one,0.25,2,2,0,0.0,0.0,69,83
2266,relax_one,0.25,2,2,0,0.0,0.0,12,15
2267,relax_one,0.25,0,0,0,0.0,0.0,15,14
2268,relax_one,0.25,0,0,0,0.0,0.0,23,26
2269,relax_one,0.25,2,2,0,0.0,0.0,12,20
2270,relax_one,0.25,201,201,0,0.0,0.0,64,122
2271,relax_one,0.25,7,7,0,0.0,0.0,58,71
2272,relax_one,0.25,0,0,0,0.0,0.0,20,19
2273,relax_one,0.25,510,510,0,0.0060639005596385,-0.0006916839131552,100,191
2274,relax_one,0.25,34,34,0,0.0,0.0,41,61
2275,relax_one,0.25,33,34,-1,-0.6264707699284884,0.0331924782664471,13,31
2276,relax_one,0.25,5,5,0,0.0,0.0,10,15
2277,relax_one,0.25,6,6,0,0.0,0.0,37,47
2278,relax_one,0.25,0,0,0,0.0,0.0,21,21
2279,relax_one,0.25,0,0,0,0.0,0.0,11,10
2280,relax_one,0.25,57,55,2,-1.1796960984034186,9.734149291917849e-05,44,80
2281,relax_one,0.25,6,6,0,0.0,0.0,12,21
2282,relax_one,0.25,2,2,0,42.15913628345388,-0.0181760816329957,37,43
2283,relax_one,0.25,6,6,0,0.0,0.0,41,52
2284,relax_one,0.25,0,0,0,0.0,0.0,90,89
2285,relax_one,0.25,0,0,0,0.0,0.0,22,21
2286,relax_one,0.25,1,1,0,-4.213527745425694,0.0417394626549948,37,43
2287,relax_one,0.25,0,0,0,0.0,0.0,47,47
2288,relax_one,0.25,4,4,0,0.0,0.0,12,20
2289,relax_one,0.25,114,114,0,0.0,0.0,84,124
2290,relax_one,0.25,0,0,0,0.0,0.0,88,92
2291,relax_one,0.25,380,377,3,-0.3714807714610657,-0.0025427242202904,59,122
2292,relax_one,0.25,4,4,0,0.0,0.0,26,31
2293,relax_one,0.25,0,0,0,0.0,0.0,28,27
2294,relax_one,0.25,6,6,0,0.0,0.0,18,26
2295,relax_one,0.25,1,1,0,0.0,0.0,23,26
2296,relax_one,0.25,0,0,0,0.0,0.0,43,43
2297,relax_one,0.25,2,2,0,0.0,0.0,22,26
2298,relax_one,0.25,0,0,0,0.0,0.0,15,14
2299,relax_one,0.25,10,17,-7,3.5874123628873704,0.0856058777554238,36,48
2300,relax_one,0.25,6,6,0,2.8016025522275783,-0.3535412006642752,30,37
2301,relax_one,0.25,1,1,0,0.0,0.0,10,13
2302,relax_one,0.25,0,0,0,0.0,0.0,12,11
2303,relax_one,0.25,168,167,1,-0.7965879277094672,0.0475430066924907,55,105
2304,relax_one,0.25,1,1,0,17.12164821735773,0.0578261695456346,13,17
2305,relax_one,0.25,0,0,0,0.0,0.0,30,29
2306,relax_one,0.25,3,3,0,0.0,0.0,36,43
2307,relax_one,0.25,36,36,0,0.0,0.0,40,60
2308,relax_one,0.25,0,0,0,0.0,0.0,13,17
2309,relax_one,0.25,6,7,-1,-5.27235869178908,0.0082826452568239,23,30
2310,relax_one,0.25,0,0,0,0.0,0.0,12,16
2311,relax_one,0.25,0,0,0,0.0,0.0,26,26
2312,relax_one,0.25,0,0,0,0.0,0.0,22,31
2313,relax_one,0.25,0,0,0,0.0,0.0,68,68
2314,relax_one,0.25,0,0,0,0.0,0.0,23,22
2315,relax_one,0.25,0,0,0,0.0,-0.0348129737608335,43,42
2316,relax_one,0.25,0,0,0,0.0,0.0,18,17
2317,relax_one,0.25,3,3,0,0.0,0.0,28,42
2318,relax_one,0.25,45,45,0,0.1036479088850654,-0.0041754562964496,21,44
2319,relax_one,0.25,0,0,0,0.0,0.0,36,37
2320,relax_one,0.25,0,0,0,0.0,0.0,15,14
2321,relax_one,0.25,1,1,0,0.0,0.0,14,16
2322,relax_one,0.25,197,204,-7,3.484436282689749,0.1757315340586914,61,119
2323,relax_one,0.25,0,0,0,0.0,0.0,19,20
2324,relax_one,0.25,0,0,0,0.0,0.0,22,22
2325,relax_one,0.25,0,0,0,0.0,0.0,54,58
2326,relax_one,0.25,651,651,0,0.0,0.0,65,135
2327,relax_one,0.25,1,1,0,0.0,0.0,16,18
2328,relax_one,0.25,7,7,0,0.0,0.0,17,27
2329,relax_one,0.25,22,4,18,-19.06910671434205,0.1469333863626725,54,71
2330,relax_one,0.25,0,2,-2,-59.99819093035041,-0.0131455917893484,23,22
2331,relax_one,0.25,1,0,1,76.88395716132196,-0.1491322016956315,13,16
2332,relax_one,0.25,155,146,9,-2.3741667241416664,-0.001397205031107,85,131
2333,relax_one,0.25,44,44,0,0.0,0.0,28,55
2334,relax_one,0.25,4,4,0,0.0,0.0,18,24
2335,relax_one,0.25,0,0,0,0.0,0.0,19,22
2336,relax_one,0.25,0,0,0,0.0,0.0,47,46
2337,relax_one,0.25,21,19,2,-6.356920988253222,0.0143956759658575,39,64
2338,relax_one,0.25,0,0,0,0.0,0.0,17,18
2339,relax_one,0.25,1,1,0,0.0,0.0,23,24
2340,relax_one,0.25,2,2,0,0.0,0.0,13,16
2341,relax_one,0.25,22,22,0,0.0,0.0,40,56
2342,relax_one,0.25,1,1,0,0.0,0.0,10,15
2343,relax_one,0.25,0,0,0,0.0,0.0,21,20
2344,relax_one,0.25,4,4,0,0.0,0.0,30,35
2345,relax_one,0.25,1,1,0,0.0,0.0,71,77
2346,just_relax,0.25,0,0,0,0.0,-0.0091692815110081,17,18
2347,just_relax,0.25,1,1,0,0.0009607869158827,0.0014628518031132,43,48
2348,just_relax,0.25,3,3,0,-0.0019521681741139,-7.679999619569777e-05,38,45
2349,just_relax,0.25,0,0,0,0.0,-0.0037600566419999,12,12
2350,just_relax,0.25,20,14,6,1.9891400956483096,0.1544148745043621,23,38
2351,just_relax,0.25,0,1,-1,-78.11694026732484,-0.0295512202700576,19,22
2352,just_relax,0.25,976,1188,-212,1.3106081233515638,0.0257948127350838,35,143
2353,just_relax,0.25,0,4,-4,-39.1818408082167,-0.0156618414823971,92,91
2354,just_relax,0.25,2,2,0,-0.00041775540015,-0.0002552385505018,43,51
2355,just_relax,0.25,1,1,0,-0.0016870080925173,6.40249009676297e-05,35,36
2356,just_relax,0.25,1,1,0,-0.000156439410091,0.0002508982184644,11,13
2357,just_relax,0.25,22,24,-2,-3.49415891827384,0.1000113687896936,10,25
2358,just_relax,0.25,16,13,3,0.2088785180214571,-2.2771107622610032e-05,86,136
2359,just_relax,0.25,0,0,0,0.0,-1.765503840900351e-06,10,12
2360,just_relax,0.25,0,0,0,0.0,-1.014518260578079e-05,32,31
2361,just_relax,0.25,2,2,0,4.970962038347736,-0.0904350603192869,20,26
2362,just_relax,0.25,0,0,0,0.0,0.000269092021105,11,11
2363,just_relax,0.25,2,2,0,0.0009292844165713,-0.0008610890242942,34,42
2364,just_relax,0.25,11,11,0,-0.0003616788843885,0.0005035529702898,14,25
2365,just_relax,0.25,8,7,1,13.99583228956454,0.1582030612456263,31,46
2366,just_relax,0.25,0,0,0,0.0,0.0042083907430441,42,45
2367,just_relax,0.25,1265,1285,-20,2.6849459664833404,-0.1292871249874528,39,173
2368,just_relax,0.25,11,11,0,0.0001627700527109,0.0015600944076981,14,24
2369,just_relax,0.25,0,0,0,0.0,-0.000608053012485,24,25
2370,just_relax,0.25,2,2,0,-2.981324638540173e-05,0.0001440646714581,12,19
2371,just_relax,0.25,59,59,0,0.4609819410147793,0.0044552421238692,41,72
2372,just_relax,0.25,182,178,4,0.0313317398119608,0.0970080713564147,59,115
2373,just_relax,0.25,6,6,0,-0.0020404096920856,0.0011964290694836,32,37
2374,just_relax,0.25,1,0,1,64.5674534074053,-0.0013228453280204,20,20
2375,just_relax,0.25,41,33,8,8.182357833947279,-0.009895766072516,12,31
2376,just_relax,0.25,0,0,0,0.0,-1.5942199658169898e-06,10,10
2377,just_relax,0.25,0,0,0,0.0,0.0018153466622625,20,21
2378,just_relax,0.25,18,18,0,0.0003589278580733,-0.0005865039043362,39,52
2379,just_relax,0.25,378,369,9,2.979528253482861,0.0835817869771829,42,109
2380,just_relax,0.25,1,1,0,-0.0010366044558338,-5.546321229055184e-05,25,28
2381,just_relax,0.25,170,170,0,-0.0002769762706833,-0.0005002245004087,56,106
2382,just_relax,0.25,567,521,46,-0.2657392120378574,0.1239070997048957,87,189
2383,just_relax,0.25,41,43,-2,2.499128887843675,-0.033528056765164,56,82
2384,just_relax,0.25,2,2,0,0.0004861774901456,1.2071037781558047e-06,13,15
2385,just_relax,0.25,104,86,18,5.26724471872344,-0.2840091449765524,36,63
2386,just_relax,0.25,0,0,0,0.0,4.3915154694929015e-06,16,15
2387,just_relax,0.25,0,0,0,0.0,-5.223096419815221e-07,67,66
2388,just_relax,0.25,13,13,0,0.0024384647237383,0.004260897920215,42,60
2389,just_relax,0.25,0,0,0,0.0,0.0005903979895692,39,38
2390,just_relax,0.25,8,8,0,-3.330899971842882e-05,0.0005334774465118,20,36
2391,just_relax,0.25,0,0,0,0.0,-0.0010596071395927,10,9
2392,just_relax,0.25,1,1,0,0.0009644178095271,-1.805181839154013e-05,13,15
2393,just_relax,0.25,6,7,-1,12.522285729298716,0.0299062089849014,34,41
2394,just_relax,0.25,3,3,0,-0.0014185667246167,0.0006213779664755,37,42
2395,just_relax,0.25,36,36,0,7.196136941445275e-06,5.025038399830706e-06,18,29
2396,just_relax,0.25,0,0,0,0.0,-0.0031405837993232,23,22
2397,just_relax,0.25,0,0,0,0.0,1.0504657718901632e-05,13,12
2398,just_relax,0.25,0,0,0,0.0,-0.0007613272869088,15,14
2399,just_relax,0.25,0,0,0,0.0,-0.0017207203528439,69,68
2400,just_relax,0.25,0,0,0,0.0,0.001934163275203,40,39
2401,just_relax,0.25,0,0,0,0.0,0.0016954512903432,89,93
2402,just_relax,0.25,13,13,0,1.511050374969713,-0.0878570612978808,20,32
2403,just_relax,0.25,2,3,-1,-4.120223819609976,0.0096644512108772,69,83
2404,just_relax,0.25,2,2,0,0.0006766545457281,-0.0007958153584334,12,15
2405,just_relax,0.25,0,0,0,0.0,-0.0009758471183408,15,14
2406,just_relax,0.25,0,0,0,0.0,-0.0007570529942456,23,26
2407,just_relax,0.25,2,2,0,-0.0004670837519427,-0.000552899751354,12,20
2408,just_relax,0.25,201,201,0,-5.927609844036397e-05,0.0001073571901385,64,122
2409,just_relax,0.25,7,7,0,-0.0099055150386959,0.0003544031231826,58,71
2410,just_relax,0.25,0,0,0,0.0,-0.0013086772972689,20,19
2411,just_relax,0.25,510,505,5,-0.1096058695008466,0.0001562332230281,100,191
2412,just_relax,0.25,34,34,0,0.0046498502251353,3.462795885833536e-05,41,61
2413,just_relax,0.25,33,21,12,-0.322372772893118,0.0487025778316814,13,31
2414,just_relax,0.25,5,5,0,0.0003476406123752,0.0002826333043987,10,15
2415,just_relax,0.25,6,6,0,-0.0004254358946269,0.0003115870201488,37,47
2416,just_relax,0.25,0,0,0,0.0,0.0007350584472026,21,21
2417,just_relax,0.25,0,0,0,0.0,9.621758975453254e-06,11,10
2418,just_relax,0.25,57,55,2,-1.1796960984034186,9.734149291917849e-05,44,80
2419,just_relax,0.25,6,6,0,0.0001929725905256,-1.6711583069151104e-05,12,21
2420,just_relax,0.25,2,5,-3,10.477360070400792,-0.0167672873232497,37,43
2421,just_relax,0.25,6,6,0,-9.27967616917158e-05,0.0005867078171852,41,52
2422,just_relax,0.25,0,0,0,0.0,0.0258238191424075,90,89
2423,just_relax,0.25,0,0,0,0.0,-0.0001762041220683,22,21
2424,just_relax,0.25,1,5,-4,-25.99394547658536,0.034397478016983,37,43
2425,just_relax,0.25,0,0,0,0.0,0.009279908390236,47,47
2426,just_relax,0.25,4,4,0,-0.0003372893218767,-9.212772776878708e-07,12,20
2427,just_relax,0.25,114,95,19,0.8287298242191525,-0.006531385777559,84,124
2428,just_relax,0.25,0,0,0,0.0,0.0016708237920683,88,92
2429,just_relax,0.25,380,332,48,-1.681066658089314,0.0270328691740772,59,122
2430,just_relax,0.25,4,4,0,2.0677824380754828e-05,-0.000363330475558,26,31
2431,just_relax,0.25,0,0,0,0.0,4.418930553695688e-06,28,27
2432,just_relax,0.25,6,6,0,0.0013890930604816,7.243956427815945e-06,18,26
2433,just_relax,0.25,1,1,0,-0.0014241348598034,0.001861633846505,23,26
2434,just_relax,0.25,0,0,0,0.0,0.0001814651838247,43,43
2435,just_relax,0.25,2,2,0,0.0004949068667485,0.0012137972461528,22,26
2436,just_relax,0.25,0,0,0,0.0,8.316094011640018e-06,15,14
2437,just_relax,0.25,10,17,-7,3.5874123628873704,0.0856058777554238,36,48
2438,just_relax,0.25,6,6,0,2.8016025522275783,-0.3535412006642752,30,37
2439,just_relax,0.25,1,1,0,5.455328151526828e-05,-4.433967369288361e-05,10,13
2440,just_relax,0.25,0,0,0,0.0,-0.0049855760382295,12,11
2441,just_relax,0.25,168,182,-14,1.1771250480206064,-0.0267800915114647,55,105
2442,just_relax,0.25,1,1,0,17.12164821735773,0.0578261695456346,13,17
2443,just_relax,0.25,0,0,0,0.0,0.0003329515887838,30,29
2444,just_relax,0.25,3,3,0,0.000583815366788,0.0008768881680062,36,43
2445,just_relax,0.25,36,36,0,0.0010314806767866,-5.393936385500453e-05,40,60
2446,just_relax,0.25,0,0,0,0.0,0.0017894746066188,13,17
2447,just_relax,0.25,6,7,-1,-5.27235869178908,0.0082826452568239,23,30
2448,just_relax,0.25,0,0,0,0.0,-2.940409977925107e-05,12,16
2449,just_relax,0.25,0,0,0,0.0,3.901708024223183e-06,26,26
2450,just_relax,0.25,0,0,0,0.0,-0.0031688166024113,22,31
2451,just_relax,0.25,0,0,0,0.0,0.0008768193667615,68,68
2452,just_relax,0.25,0,0,0,0.0,-7.938175057398134e-06,23,22
2453,just_relax,0.25,0,0,0,0.0,-0.065399188004364,43,42
2454,just_relax,0.25,0,0,0,0.0,-0.002899723134464,18,17
2455,just_relax,0.25,3,3,0,-0.003194586812441,0.0012605153222713,28,42
2456,just_relax,0.25,45,58,-13,0.9231299892006462,0.088218433779717,21,44
2457,just_relax,0.25,0,0,0,0.0,-0.0112811671875761,36,37
2458,just_relax,0.25,0,0,0,0.0,-3.4878924121017896e-05,15,14
2459,just_relax,0.25,1,1,0,-0.0014549239964907,-0.00058525619921,14,16
2460,just_relax,0.25,197,237,-40,1.3477492998050025,0.0885093784332623,61,119
2461,just_relax,0.25,0,0,0,0.0,-0.0038599581671643,19,20
2462,just_relax,0.25,0,0,0,0.0,-0.0006472841631984,22,22
2463,just_relax,0.25,0,0,0,0.0,-0.0011415137972972,54,58
2464,just_relax,0.25,651,651,0,-0.0003954210755097,0.0002252638081207,65,135
2465,just_relax,0.25,1,1,0,-0.0029471577812358,0.0001749400264638,16,18
2466,just_relax,0.25,7,7,0,0.0002013814076775,0.0006636994664107,17,27
2467,just_relax,0.25,22,7,15,-12.985895473169307,0.1330374466905183,54,71
2468,just_relax,0.25,0,2,-2,-59.99819093035041,-0.0131455917893484,23,22
2469,just_relax,0.25,1,0,1,76.88395716132196,-0.1491322016956315,13,16
2470,just_relax,0.25,155,185,-30,2.3843149677438973,-0.02495720013905,85,131
2471,just_relax,0.25,44,44,0,0.0003032918935019,0.0025857794052007,28,55
2472,just_relax,0.25,4,4,0,-0.0007096785766407,-5.4537984728875166e-05,18,24
2473,just_relax,0.25,0,0,0,0.0,-0.003226028074061,19,22
2474,just_relax,0.25,0,0,0,0.0,0.0048197166778652,47,46
2475,just_relax,0.25,21,27,-6,0.0602947270368474,-0.3310372682946312,39,64
2476,just_relax,0.25,0,0,0,0.0,-0.0037052423868473,17,18
2477,just_relax,0.25,1,1,0,0.0005119856857191,0.0004745196477359,23,24
2478,just_relax,0.25,2,2,0,0.0010275548569325,-0.004970471779609,13,16
2479,just_relax,0.25,22,22,0,0.0038770082111057,0.0004285387996507,40,56
2480,just_relax,0.25,1,1,0,-0.0002865966515059,-0.0003325971221349,10,15
2481,just_relax,0.25,0,0,0,0.0,0.0003384089422906,21,20
2482,just_relax,0.25,4,4,0,-0.0001029723687508,-0.0013906355929786,30,35
2483,just_relax,0.25,1,1,0,0.0051043410712594,-0.0056156512673798,71,77
2484,relax_and_recompute,0.3,0,0,0,0.0,0.0,17,18
2485,relax_and_recompute,0.3,1,1,0,33.913834292408055,-0.0319366967583969,43,48
2486,relax_and_recompute,0.3,3,5,-2,9.88581419291326,0.0069193652867528,38,45
2487,relax_and_recompute,0.3,0,0,0,0.0,0.0,12,12
2488,relax_and_recompute,0.3,20,7,13,1.502478168846423,0.2029862696446577,23,38
2489,relax_and_recompute,0.3,0,1,-1,-78.11694026732484,-0.0295512202700576,19,22
2490,relax_and_recompute,0.3,976,1004,-28,-0.0620531910963606,-0.0009330148689207,35,143
2491,relax_and_recompute,0.3,0,0,0,0.0,-0.0046858462976494,92,91
2492,relax_and_recompute,0.3,2,2,0,0.0,0.0,43,51
2493,relax_and_recompute,0.3,1,1,0,0.0,0.0,35,36
2494,relax_and_recompute,0.3,1,1,0,0.0,0.0,11,13
2495,relax_and_recompute,0.3,22,19,3,-4.957652547927751,0.037406937188411,10,25
2496,relax_and_recompute,0.3,16,16,0,-1.2375805476415778,-0.0662978026850604,86,136
2497,relax_and_recompute,0.3,0,0,0,0.0,0.0,10,12
2498,relax_and_recompute,0.3,0,0,0,0.0,0.0,32,31
2499,relax_and_recompute,0.3,2,2,0,0.8097822186271628,0.0720915422264546,20,26
2500,relax_and_recompute,0.3,0,0,0,0.0,0.0,11,11
2501,relax_and_recompute,0.3,2,2,0,1.367633487266943,0.0927805838803178,34,42
2502,relax_and_recompute,0.3,11,10,1,1.5445267212396203,-0.0356816848306716,14,25
2503,relax_and_recompute,0.3,8,4,4,9.035240939106416,-0.2006547963227668,31,46
2504,relax_and_recompute,0.3,0,2,-2,-60.43825847577355,-0.1126466588104083,42,45
2505,relax_and_recompute,0.3,1265,1233,32,-0.0829886923942524,-0.0013136328692162,39,173
2506,relax_and_recompute,0.3,11,11,0,1.9748795248467983,-9.737546353227876e-05,14,24
2507,relax_and_recompute,0.3,0,0,0,0.0,0.0,24,25
2508,relax_and_recompute,0.3,2,2,0,0.0,0.0,12,19
2509,relax_and_recompute,0.3,59,59,0,0.0004995248301611,-0.0021609985989152,41,72
2510,relax_and_recompute,0.3,182,192,-10,2.176227062990442,0.127488881317396,59,115
2511,relax_and_recompute,0.3,6,4,2,3.758843121777289,0.465210734665941,32,37
2512,relax_and_recompute,0.3,1,0,1,64.5674534074053,-0.1072594416335612,20,20
2513,relax_and_recompute,0.3,41,26,15,-1.6275846340626714,0.0729158968985802,12,31
2514,relax_and_recompute,0.3,0,0,0,0.0,0.0,10,10
2515,relax_and_recompute,0.3,0,0,0,0.0,0.0,20,21
2516,relax_and_recompute,0.3,18,21,-3,0.5719110189928784,0.3696791622426242,39,52
2517,relax_and_recompute,0.3,378,393,-15,0.6108526484877643,4.422482210819645e-05,42,109
2518,relax_and_recompute,0.3,1,1,0,41.29601841034655,-0.0645366457148105,25,28
2519,relax_and_recompute,0.3,170,157,13,-3.523679109137184,0.105536041898159,56,106
2520,relax_and_recompute,0.3,567,575,-8,0.4383057260994292,-0.0017656065849445,87,189
2521,relax_and_recompute,0.3,41,40,1,-2.249384452446378,-0.0072514307594979,56,82
2522,relax_and_recompute,0.3,2,2,0,0.0,0.0,13,15
2523,relax_and_recompute,0.3,104,88,16,-3.3995451437074067,-0.111275141568526,36,63
2524,relax_and_recompute,0.3,0,0,0,0.0,0.0,16,15
2525,relax_and_recompute,0.3,0,0,0,0.0,-0.0061884200170785,67,66
2526,relax_and_recompute,0.3,13,13,0,0.0,0.0,42,60
2527,relax_and_recompute,0.3,0,0,0,0.0,0.0,39,38
2528,relax_and_recompute,0.3,8,8,0,0.0,0.0,20,36
2529,relax_and_recompute,0.3,0,0,0,0.0,0.0,10,9
2530,relax_and_recompute,0.3,1,1,0,0.0,0.0,13,15
2531,relax_and_recompute,0.3,6,14,-8,18.824286639655867,-0.0841754274640885,34,41
2532,relax_and_recompute,0.3,3,5,-2,3.41159566991864,0.101618768403258,37,42
2533,relax_and_recompute,0.3,36,36,0,0.0,0.0,18,29
2534,relax_and_recompute,0.3,0,0,0,0.0,0.0248357687538134,23,22
2535,relax_and_recompute,0.3,0,0,0,0.0,0.0,13,12
2536,relax_and_recompute,0.3,0,0,0,0.0,0.0,15,14
2537,relax_and_recompute,0.3,0,0,0,0.0,0.0,69,68
2538,relax_and_recompute,0.3,0,0,0,0.0,0.0,40,39
2539,relax_and_recompute,0.3,0,0,0,0.0,0.0,89,93
2540,relax_and_recompute,0.3,13,12,1,-2.153586113029718,-0.0708055525167026,20,32
2541,relax_and_recompute,0.3,2,3,-1,-7.067084936198143,-0.0593654442548075,69,83
2542,relax_and_recompute,0.3,2,2,0,0.0,0.0,12,15
2543,relax_and_recompute,0.3,0,0,0,0.0,0.0,15,14
2544,relax_and_recompute,0.3,0,0,0,0.0,0.0,23,26
2545,relax_and_recompute,0.3,2,2,0,0.0,0.0,12,20
2546,relax_and_recompute,0.3,201,208,-7,-0.777546499391029,-0.0168449909220319,64,122
2547,relax_and_recompute,0.3,7,3,4,-15.3477275810384,-0.0042339303565398,58,71
2548,relax_and_recompute,0.3,0,0,0,0.0,-0.1147932957929044,20,19
2549,relax_and_recompute,0.3,510,512,-2,-0.0138388627329746,-0.001793654381577,100,191
2550,relax_and_recompute,0.3,34,34,0,0.0,0.0,41,61
2551,relax_and_recompute,0.3,33,34,-1,-0.5384989905164446,0.0398816997391653,13,31
2552,relax_and_recompute,0.3,5,3,2,12.118750923999592,-0.1168739524455244,10,15
2553,relax_and_recompute,0.3,6,5,1,-0.8387168161295051,-0.0584437188666191,37,47
2554,relax_and_recompute,0.3,0,0,0,0.0,-0.0047120123517853,21,21
2555,relax_and_recompute,0.3,0,0,0,0.0,0.0,11,10
2556,relax_and_recompute,0.3,57,57,0,0.0064914760634735,-0.0077421754008314,44,80
2557,relax_and_recompute,0.3,6,6,0,0.0,0.0,12,21
2558,relax_and_recompute,0.3,2,2,0,40.57817790180843,-0.0379305285754828,37,43
2559,relax_and_recompute,0.3,6,8,-2,-0.1735310719531781,0.0463842795036362,41,52
2560,relax_and_recompute,0.3,0,0,0,0.0,0.0,90,89
2561,relax_and_recompute,0.3,0,0,0,0.0,0.0,22,21
2562,relax_and_recompute,0.3,1,6,-5,-12.824308725883805,-0.0280060439235303,37,43
2563,relax_and_recompute,0.3,0,0,0,0.0,0.0128582487775385,47,47
2564,relax_and_recompute,0.3,4,4,0,0.0,0.0,12,20
2565,relax_and_recompute,0.3,114,114,0,0.0,0.0,84,124
2566,relax_and_recompute,0.3,0,0,0,0.0,0.0,88,92
2567,relax_and_recompute,0.3,380,377,3,-0.3714807714610657,-0.0025427242202904,59,122
2568,relax_and_recompute,0.3,4,3,1,0.4891171975223898,0.0326572897182014,26,31
2569,relax_and_recompute,0.3,0,0,0,0.0,0.0,28,27
2570,relax_and_recompute,0.3,6,6,0,0.0,0.0,18,26
2571,relax_and_recompute,0.3,1,3,-2,-12.914228578214503,0.0322817081119266,23,26
2572,relax_and_recompute,0.3,0,0,0,0.0,0.0,43,43
2573,relax_and_recompute,0.3,2,2,0,0.0,0.0,22,26
2574,relax_and_recompute,0.3,0,0,0,0.0,0.0,15,14
2575,relax_and_recompute,0.3,10,19,-9,5.648675414166,0.1018849030252861,36,48
2576,relax_and_recompute,0.3,6,6,0,2.8016025522275783,-0.3535412006642752,30,37
2577,relax_and_recompute,0.3,1,1,0,0.0,0.0,10,13
2578,relax_and_recompute,0.3,0,0,0,0.0,0.0,12,11
2579,relax_and_recompute,0.3,168,153,15,-1.4597591062543387,0.1638614131178267,55,105
2580,relax_and_recompute,0.3,1,1,0,17.12164821735773,0.0578261695456346,13,17
2581,relax_and_recompute,0.3,0,0,0,0.0,0.0,30,29
2582,relax_and_recompute,0.3,3,4,-1,-9.905682406522075,-0.002170500293968,36,43
2583,relax_and_recompute,0.3,36,40,-4,-3.781728400218512,-0.055822645815706,40,60
2584,relax_and_recompute,0.3,0,0,0,0.0,0.0,13,17
2585,relax_and_recompute,0.3,6,8,-2,-4.960402959672933,-0.0115319394462201,23,30
2586,relax_and_recompute,0.3,0,0,0,0.0,0.0,12,16
2587,relax_and_recompute,0.3,0,0,0,0.0,0.0,26,26
2588,relax_and_recompute,0.3,0,0,0,0.0,0.0,22,31
2589,relax_and_recompute,0.3,0,0,0,0.0,0.0,68,68
2590,relax_and_recompute,0.3,0,0,0,0.0,0.0,23,22
2591,relax_and_recompute,0.3,0,0,0,0.0,-0.0349525596057489,43,42
2592,relax_and_recompute,0.3,0,0,0,0.0,0.0,18,17
2593,relax_and_recompute,0.3,3,1,2,16.774590073756514,-0.1297888041253873,28,42
2594,relax_and_recompute,0.3,45,50,-5,1.8841541587735409,0.0156030402407787,21,44
2595,relax_and_recompute,0.3,0,0,0,0.0,0.0,36,37
2596,relax_and_recompute,0.3,0,0,0,0.0,0.0,15,14
2597,relax_and_recompute,0.3,1,1,0,0.0,0.0,14,16
2598,relax_and_recompute,0.3,197,211,-14,1.6294158914226389,0.1952030013326532,61,119
2599,relax_and_recompute,0.3,0,0,0,0.0,0.0,19,20
2600,relax_and_recompute,0.3,0,0,0,0.0,0.0,22,22
2601,relax_and_recompute,0.3,0,0,0,0.0,-0.0413225144380497,54,58
2602,relax_and_recompute,0.3,651,651,0,0.0,0.0,65,135
2603,relax_and_recompute,0.3,1,1,0,0.0,0.0,16,18
2604,relax_and_recompute,0.3,7,7,0,1.8691234648716488,0.0445121885028382,17,27
2605,relax_and_recompute,0.3,22,4,18,-18.61747849085588,0.1446288399504806,54,71
2606,relax_and_recompute,0.3,0,2,-2,-69.51467976885004,-0.0285407675374049,23,22
2607,relax_and_recompute,0.3,1,0,1,76.88395716132196,-0.1491322016956315,13,16
2608,relax_and_recompute,0.3,155,149,6,-2.794184228530185,-0.0034415506621975,85,131
2609,relax_and_recompute,0.3,44,58,-14,6.627037203531586,0.0061263330641294,28,55
2610,relax_and_recompute,0.3,4,4,0,0.0,0.0,18,24
2611,relax_and_recompute,0.3,0,0,0,0.0,0.0,19,22
2612,relax_and_recompute,0.3,0,0,0,0.0,0.0,47,46
2613,relax_and_recompute,0.3,21,21,0,-3.6879171991704425,0.0716976646866419,39,64
2614,relax_and_recompute,0.3,0,0,0,0.0,0.0,17,18
2615,relax_and_recompute,0.3,1,1,0,0.0,0.0,23,24
2616,relax_and_recompute,0.3,2,2,0,-2.1513476699157508,-0.0283592430201563,13,16
2617,relax_and_recompute,0.3,22,13,9,-2.489023448459861,-0.0668838434847596,40,56
2618,relax_and_recompute,0.3,1,1,0,0.0,0.0,10,15
2619,relax_and_recompute,0.3,0,0,0,0.0,0.0,21,20
2620,relax_and_recompute,0.3,4,4,0,0.0,0.0,30,35
2621,relax_and_recompute,0.3,1,1,0,0.0,0.0,71,77
2622,relax_one,0.3,0,0,0,0.0,0.0,17,18
2623,relax_one,0.3,1,1,0,0.0,0.0,43,48
2624,relax_one,0.3,3,3,0,0.0,0.0,38,45
2625,relax_one,0.3,0,0,0,0.0,0.0,12,12
2626,relax_one,0.3,20,18,2,-3.2752299140735204,0.0114158034923678,23,38
2627,relax_one,0.3,0,1,-1,-78.11694026732484,-0.0295512202700576,19,22
2628,relax_one,0.3,976,978,-2,0.1423455471242221,-0.0025418055405018,35,143
2629,relax_one,0.3,0,1,-1,-50.19567681247512,-0.0041327022016595,92,91
2630,relax_one,0.3,2,2,0,0.0,0.0,43,51
2631,relax_one,0.3,1,1,0,0.0,0.0,35,36
2632,relax_one,0.3,1,1,0,0.0,0.0,11,13
2633,relax_one,0.3,22,20,2,-3.01441643358082,0.0082886474985522,10,25
2634,relax_one,0.3,16,16,0,0.0,0.0,86,136
2635,relax_one,0.3,0,0,0,0.0,0.0,10,12
2636,relax_one,0.3,0,0,0,0.0,0.0,32,31
2637,relax_one,0.3,2,2,0,4.970962038347736,-0.0904350603192869,20,26
2638,relax_one,0.3,0,0,0,0.0,0.0,11,11
2639,relax_one,0.3,2,2,0,0.0,0.0,34,42
2640,relax_one,0.3,11,11,0,0.0,0.0,14,25
2641,relax_one,0.3,8,7,1,13.99583228956454,0.1582030612456263,31,46
2642,relax_one,0.3,0,0,0,0.0,0.0,42,45
2643,relax_one,0.3,1265,1240,25,0.1009906236120983,0.0001682713719424,39,173
2644,relax_one,0.3,11,11,0,0.0,0.0,14,24
2645,relax_one,0.3,0,0,0,0.0,0.0,24,25
2646,relax_one,0.3,2,2,0,0.0,0.0,12,19
2647,relax_one,0.3,59,59,0,0.4609819410147793,0.0044552421238692,41,72
2648,relax_one,0.3,182,191,-9,1.446975953367918,0.0358261975695221,59,115
2649,relax_one,0.3,6,6,0,0.0,0.0,32,37
2650,relax_one,0.3,1,1,0,0.0,0.0,20,20
2651,relax_one,0.3,41,32,9,2.305146048931391,0.0775874222420341,12,31
2652,relax_one,0.3,0,0,0,0.0,0.0,10,10
2653,relax_one,0.3,0,0,0,0.0,0.0,20,21
2654,relax_one,0.3,18,18,0,0.0,0.0,39,52
2655,relax_one,0.3,378,395,-17,-0.4859193577000411,-0.0010324457545943,42,109
2656,relax_one,0.3,1,1,0,0.0,0.0,25,28
2657,relax_one,0.3,170,170,0,0.0,0.0,56,106
2658,relax_one,0.3,567,595,-28,0.7834114754025379,-0.002967395777259,87,189
2659,relax_one,0.3,41,41,0,-3.1762323320181167,-0.0099859384844429,56,82
2660,relax_one,0.3,2,2,0,0.0,0.0,13,15
2661,relax_one,0.3,104,88,16,-3.3995451437074067,-0.111275141568526,36,63
2662,relax_one,0.3,0,0,0,0.0,0.0,16,15
2663,relax_one,0.3,0,0,0,0.0,0.0,67,66
2664,relax_one,0.3,13,13,0,0.0,0.0,42,60
2665,relax_one,0.3,0,0,0,0.0,0.0,39,38
2666,relax_one,0.3,8,8,0,0.0,0.0,20,36
2667,relax_one,0.3,0,0,0,0.0,0.0,10,9
2668,relax_one,0.3,1,1,0,0.0,0.0,13,15
2669,relax_one,0.3,6,7,-1,12.522285729298716,0.0299062089849014,34,41
2670,relax_one,0.3,3,3,0,0.0,0.0,37,42
2671,relax_one,0.3,36,36,0,0.0,0.0,18,29
2672,relax_one,0.3,0,0,0,0.0,0.0,23,22
2673,relax_one,0.3,0,0,0,0.0,0.0,13,12
2674,relax_one,0.3,0,0,0,0.0,0.0,15,14
2675,relax_one,0.3,0,0,0,0.0,0.0,69,68
2676,relax_one,0.3,0,0,0,0.0,0.0,40,39
2677,relax_one,0.3,0,0,0,0.0,0.0,89,93
2678,relax_one,0.3,13,13,0,-2.975681235416161,-0.0847204542309565,20,32
2679,relax_one,0.3,2,2,0,0.0,0.0,69,83
2680,relax_one,0.3,2,2,0,0.0,0.0,12,15
2681,relax_one,0.3,0,0,0,0.0,0.0,15,14
2682,relax_one,0.3,0,0,0,0.0,0.0,23,26
2683,relax_one,0.3,2,2,0,0.0,0.0,12,20
2684,relax_one,0.3,201,201,0,0.0,0.0,64,122
2685,relax_one,0.3,7,7,0,0.0,0.0,58,71
2686,relax_one,0.3,0,0,0,0.0,0.0,20,19
2687,relax_one,0.3,510,510,0,0.0060639005596385,-0.0006916839131552,100,191
2688,relax_one,0.3,34,34,0,0.0,0.0,41,61
2689,relax_one,0.3,33,34,-1,-0.6264707699284884,0.0331924782664471,13,31
2690,relax_one,0.3,5,5,0,0.0,0.0,10,15
2691,relax_one,0.3,6,6,0,0.0,0.0,37,47
2692,relax_one,0.3,0,0,0,0.0,0.0,21,21
2693,relax_one,0.3,0,0,0,0.0,0.0,11,10
2694,relax_one,0.3,57,55,2,-1.1796960984034186,9.734149291917849e-05,44,80
2695,relax_one,0.3,6,6,0,0.0,0.0,12,21
2696,relax_one,0.3,2,2,0,42.15913628345388,-0.0181760816329957,37,43
2697,relax_one,0.3,6,6,0,0.0,0.0,41,52
2698,relax_one,0.3,0,0,0,0.0,0.0,90,89
2699,relax_one,0.3,0,0,0,0.0,0.0,22,21
2700,relax_one,0.3,1,1,0,-4.213527745425694,0.0417394626549948,37,43
2701,relax_one,0.3,0,0,0,0.0,0.0,47,47
2702,relax_one,0.3,4,4,0,0.0,0.0,12,20
2703,relax_one,0.3,114,114,0,0.0,0.0,84,124
2704,relax_one,0.3,0,0,0,0.0,0.0,88,92
2705,relax_one,0.3,380,377,3,-0.3714807714610657,-0.0025427242202904,59,122
2706,relax_one,0.3,4,4,0,0.0,0.0,26,31
2707,relax_one,0.3,0,0,0,0.0,0.0,28,27
2708,relax_one,0.3,6,6,0,0.0,0.0,18,26
2709,relax_one,0.3,1,1,0,0.0,0.0,23,26
2710,relax_one,0.3,0,0,0,0.0,0.0,43,43
2711,relax_one,0.3,2,2,0,0.0,0.0,22,26
2712,relax_one,0.3,0,0,0,0.0,0.0,15,14
2713,relax_one,0.3,10,17,-7,3.5874123628873704,0.0856058777554238,36,48
2714,relax_one,0.3,6,6,0,2.8016025522275783,-0.3535412006642752,30,37
2715,relax_one,0.3,1,1,0,0.0,0.0,10,13
2716,relax_one,0.3,0,0,0,0.0,0.0,12,11
2717,relax_one,0.3,168,167,1,-0.7965879277094672,0.0475430066924907,55,105
2718,relax_one,0.3,1,1,0,17.12164821735773,0.0578261695456346,13,17
2719,relax_one,0.3,0,0,0,0.0,0.0,30,29
2720,relax_one,0.3,3,3,0,0.0,0.0,36,43
2721,relax_one,0.3,36,36,0,0.0,0.0,40,60
2722,relax_one,0.3,0,0,0,0.0,0.0,13,17
2723,relax_one,0.3,6,7,-1,-5.27235869178908,0.0082826452568239,23,30
2724,relax_one,0.3,0,0,0,0.0,0.0,12,16
2725,relax_one,0.3,0,0,0,0.0,0.0,26,26
2726,relax_one,0.3,0,0,0,0.0,0.0,22,31
2727,relax_one,0.3,0,0,0,0.0,0.0,68,68
2728,relax_one,0.3,0,0,0,0.0,0.0,23,22
2729,relax_one,0.3,0,0,0,0.0,-0.0348129737608335,43,42
2730,relax_one,0.3,0,0,0,0.0,0.0,18,17
2731,relax_one,0.3,3,3,0,0.0,0.0,28,42
2732,relax_one,0.3,45,45,0,0.1036479088850654,-0.0041754562964496,21,44
2733,relax_one,0.3,0,0,0,0.0,0.0,36,37
2734,relax_one,0.3,0,0,0,0.0,0.0,15,14
2735,relax_one,0.3,1,1,0,0.0,0.0,14,16
2736,relax_one,0.3,197,204,-7,3.484436282689749,0.1757315340586914,61,119
2737,relax_one,0.3,0,0,0,0.0,0.0,19,20
2738,relax_one,0.3,0,0,0,0.0,0.0,22,22
2739,relax_one,0.3,0,0,0,0.0,0.0,54,58
2740,relax_one,0.3,651,651,0,0.0,0.0,65,135
2741,relax_one,0.3,1,1,0,0.0,0.0,16,18
2742,relax_one,0.3,7,7,0,0.0,0.0,17,27
2743,relax_one,0.3,22,4,18,-19.06910671434205,0.1469333863626725,54,71
2744,relax_one,0.3,0,2,-2,-59.99819093035041,-0.0131455917893484,23,22
2745,relax_one,0.3,1,0,1,76.88395716132196,-0.1491322016956315,13,16
2746,relax_one,0.3,155,146,9,-2.3741667241416664,-0.001397205031107,85,131
2747,relax_one,0.3,44,44,0,0.0,0.0,28,55
2748,relax_one,0.3,4,4,0,0.0,0.0,18,24
2749,relax_one,0.3,0,0,0,0.0,0.0,19,22
2750,relax_one,0.3,0,0,0,0.0,0.0,47,46
2751,relax_one,0.3,21,19,2,-6.356920988253222,0.0143956759658575,39,64
2752,relax_one,0.3,0,0,0,0.0,0.0,17,18
2753,relax_one,0.3,1,1,0,0.0,0.0,23,24
2754,relax_one,0.3,2,2,0,0.0,0.0,13,16
2755,relax_one,0.3,22,22,0,0.0,0.0,40,56
2756,relax_one,0.3,1,1,0,0.0,0.0,10,15
2757,relax_one,0.3,0,0,0,0.0,0.0,21,20
2758,relax_one,0.3,4,4,0,0.0,0.0,30,35
2759,relax_one,0.3,1,1,0,0.0,0.0,71,77
2760,just_relax,0.3,0,0,0,0.0,-0.0091692815110081,17,18
2761,just_relax,0.3,1,1,0,0.0009607869158827,0.0014628518031132,43,48
2762,just_relax,0.3,3,3,0,-0.0019521681741139,-7.679999619569777e-05,38,45
2763,just_relax,0.3,0,0,0,0.0,-0.0037600566419999,12,12
2764,just_relax,0.3,20,14,6,1.9891400956483096,0.1544148745043621,23,38
2765,just_relax,0.3,0,1,-1,-78.11694026732484,-0.0295512202700576,19,22
2766,just_relax,0.3,976,1188,-212,1.3106081233515638,0.0257948127350838,35,143
2767,just_relax,0.3,0,4,-4,-39.1818408082167,-0.0156618414823971,92,91
2768,just_relax,0.3,2,2,0,-0.00041775540015,-0.0002552385505018,43,51
2769,just_relax,0.3,1,1,0,-0.0016870080925173,6.40249009676297e-05,35,36
2770,just_relax,0.3,1,1,0,-0.000156439410091,0.0002508982184644,11,13
2771,just_relax,0.3,22,24,-2,-3.49415891827384,0.1000113687896936,10,25
2772,just_relax,0.3,16,13,3,0.2088785180214571,-2.2771107622610032e-05,86,136
2773,just_relax,0.3,0,0,0,0.0,-1.765503840900351e-06,10,12
2774,just_relax,0.3,0,0,0,0.0,-1.014518260578079e-05,32,31
2775,just_relax,0.3,2,2,0,4.970962038347736,-0.0904350603192869,20,26
2776,just_relax,0.3,0,0,0,0.0,0.000269092021105,11,11
2777,just_relax,0.3,2,2,0,0.0009292844165713,-0.0008610890242942,34,42
2778,just_relax,0.3,11,11,0,-0.0003616788843885,0.0005035529702898,14,25
2779,just_relax,0.3,8,7,1,13.99583228956454,0.1582030612456263,31,46
2780,just_relax,0.3,0,0,0,0.0,0.0042083907430441,42,45
2781,just_relax,0.3,1265,1285,-20,2.6849459664833404,-0.1292871249874528,39,173
2782,just_relax,0.3,11,11,0,0.0001627700527109,0.0015600944076981,14,24
2783,just_relax,0.3,0,0,0,0.0,-0.000608053012485,24,25
2784,just_relax,0.3,2,2,0,-2.981324638540173e-05,0.0001440646714581,12,19
2785,just_relax,0.3,59,59,0,0.4609819410147793,0.0044552421238692,41,72
2786,just_relax,0.3,182,178,4,0.0313317398119608,0.0970080713564147,59,115
2787,just_relax,0.3,6,6,0,-0.0020404096920856,0.0011964290694836,32,37
2788,just_relax,0.3,1,0,1,64.5674534074053,-0.0013228453280204,20,20
2789,just_relax,0.3,41,33,8,8.182357833947279,-0.009895766072516,12,31
2790,just_relax,0.3,0,0,0,0.0,-1.5942199658169898e-06,10,10
2791,just_relax,0.3,0,0,0,0.0,0.0018153466622625,20,21
2792,just_relax,0.3,18,18,0,0.0003589278580733,-0.0005865039043362,39,52
2793,just_relax,0.3,378,369,9,2.979528253482861,0.0835817869771829,42,109
2794,just_relax,0.3,1,1,0,-0.0010366044558338,-5.546321229055184e-05,25,28
2795,just_relax,0.3,170,170,0,-0.0002769762706833,-0.0005002245004087,56,106
2796,just_relax,0.3,567,521,46,-0.2657392120378574,0.1239070997048957,87,189
2797,just_relax,0.3,41,43,-2,2.499128887843675,-0.033528056765164,56,82
2798,just_relax,0.3,2,2,0,0.0004861774901456,1.2071037781558047e-06,13,15
2799,just_relax,0.3,104,86,18,5.26724471872344,-0.2840091449765524,36,63
2800,just_relax,0.3,0,0,0,0.0,4.3915154694929015e-06,16,15
2801,just_relax,0.3,0,0,0,0.0,-5.223096419815221e-07,67,66
2802,just_relax,0.3,13,13,0,0.0024384647237383,0.004260897920215,42,60
2803,just_relax,0.3,0,0,0,0.0,0.0005903979895692,39,38
2804,just_relax,0.3,8,8,0,-3.330899971842882e-05,0.0005334774465118,20,36
2805,just_relax,0.3,0,0,0,0.0,-0.0010596071395927,10,9
2806,just_relax,0.3,1,1,0,0.0009644178095271,-1.805181839154013e-05,13,15
2807,just_relax,0.3,6,7,-1,12.522285729298716,0.0299062089849014,34,41
2808,just_relax,0.3,3,3,0,-0.0014185667246167,0.0006213779664755,37,42
2809,just_relax,0.3,36,36,0,7.196136941445275e-06,5.025038399830706e-06,18,29
2810,just_relax,0.3,0,0,0,0.0,-0.0031405837993232,23,22
2811,just_relax,0.3,0,0,0,0.0,1.0504657718901632e-05,13,12
2812,just_relax,0.3,0,0,0,0.0,-0.0007613272869088,15,14
2813,just_relax,0.3,0,0,0,0.0,-0.0017207203528439,69,68
2814,just_relax,0.3,0,0,0,0.0,0.001934163275203,40,39
2815,just_relax,0.3,0,0,0,0.0,0.0016954512903432,89,93
2816,just_relax,0.3,13,13,0,1.511050374969713,-0.0878570612978808,20,32
2817,just_relax,0.3,2,3,-1,-4.120223819609976,0.0096644512108772,69,83
2818,just_relax,0.3,2,2,0,0.0006766545457281,-0.0007958153584334,12,15
2819,just_relax,0.3,0,0,0,0.0,-0.0009758471183408,15,14
2820,just_relax,0.3,0,0,0,0.0,-0.0007570529942456,23,26
2821,just_relax,0.3,2,2,0,-0.0004670837519427,-0.000552899751354,12,20
2822,just_relax,0.3,201,201,0,-5.927609844036397e-05,0.0001073571901385,64,122
2823,just_relax,0.3,7,7,0,-0.0099055150386959,0.0003544031231826,58,71
2824,just_relax,0.3,0,0,0,0.0,-0.0013086772972689,20,19
2825,just_relax,0.3,510,505,5,-0.1096058695008466,0.0001562332230281,100,191
2826,just_relax,0.3,34,34,0,0.0046498502251353,3.462795885833536e-05,41,61
2827,just_relax,0.3,33,21,12,-0.322372772893118,0.0487025778316814,13,31
2828,just_relax,0.3,5,5,0,0.0003476406123752,0.0002826333043987,10,15
2829,just_relax,0.3,6,6,0,-0.0004254358946269,0.0003115870201488,37,47
2830,just_relax,0.3,0,0,0,0.0,0.0007350584472026,21,21
2831,just_relax,0.3,0,0,0,0.0,9.621758975453254e-06,11,10
2832,just_relax,0.3,57,55,2,-1.1796960984034186,9.734149291917849e-05,44,80
2833,just_relax,0.3,6,6,0,0.0001929725905256,-1.6711583069151104e-05,12,21
2834,just_relax,0.3,2,5,-3,10.477360070400792,-0.0167672873232497,37,43
2835,just_relax,0.3,6,6,0,-9.27967616917158e-05,0.0005867078171852,41,52
2836,just_relax,0.3,0,0,0,0.0,0.0258238191424075,90,89
2837,just_relax,0.3,0,0,0,0.0,-0.0001762041220683,22,21
2838,just_relax,0.3,1,5,-4,-25.99394547658536,0.034397478016983,37,43
2839,just_relax,0.3,0,0,0,0.0,0.009279908390236,47,47
2840,just_relax,0.3,4,4,0,-0.0003372893218767,-9.212772776878708e-07,12,20
2841,just_relax,0.3,114,95,19,0.8287298242191525,-0.006531385777559,84,124
2842,just_relax,0.3,0,0,0,0.0,0.0016708237920683,88,92
2843,just_relax,0.3,380,332,48,-1.681066658089314,0.0270328691740772,59,122
2844,just_relax,0.3,4,4,0,2.0677824380754828e-05,-0.000363330475558,26,31
2845,just_relax,0.3,0,0,0,0.0,4.418930553695688e-06,28,27
2846,just_relax,0.3,6,6,0,0.0013890930604816,7.243956427815945e-06,18,26
2847,just_relax,0.3,1,1,0,-0.0014241348598034,0.001861633846505,23,26
2848,just_relax,0.3,0,0,0,0.0,0.0001814651838247,43,43
2849,just_relax,0.3,2,2,0,0.0004949068667485,0.0012137972461528,22,26
2850,just_relax,0.3,0,0,0,0.0,8.316094011640018e-06,15,14
2851,just_relax,0.3,10,17,-7,3.5874123628873704,0.0856058777554238,36,48
2852,just_relax,0.3,6,6,0,2.8016025522275783,-0.3535412006642752,30,37
2853,just_relax,0.3,1,1,0,5.455328151526828e-05,-4.433967369288361e-05,10,13
2854,just_relax,0.3,0,0,0,0.0,-0.0049855760382295,12,11
2855,just_relax,0.3,168,182,-14,1.1771250480206064,-0.0267800915114647,55,105
2856,just_relax,0.3,1,1,0,17.12164821735773,0.0578261695456346,13,17
2857,just_relax,0.3,0,0,0,0.0,0.0003329515887838,30,29
2858,just_relax,0.3,3,3,0,0.000583815366788,0.0008768881680062,36,43
2859,just_relax,0.3,36,36,0,0.0010314806767866,-5.393936385500453e-05,40,60
2860,just_relax,0.3,0,0,0,0.0,0.0017894746066188,13,17
2861,just_relax,0.3,6,7,-1,-5.27235869178908,0.0082826452568239,23,30
2862,just_relax,0.3,0,0,0,0.0,-2.940409977925107e-05,12,16
2863,just_relax,0.3,0,0,0,0.0,3.901708024223183e-06,26,26
2864,just_relax,0.3,0,0,0,0.0,-0.0031688166024113,22,31
2865,just_relax,0.3,0,0,0,0.0,0.0008768193667615,68,68
2866,just_relax,0.3,0,0,0,0.0,-7.938175057398134e-06,23,22
2867,just_relax,0.3,0,0,0,0.0,-0.065399188004364,43,42
2868,just_relax,0.3,0,0,0,0.0,-0.002899723134464,18,17
2869,just_relax,0.3,3,3,0,-0.003194586812441,0.0012605153222713,28,42
2870,just_relax,0.3,45,58,-13,0.9231299892006462,0.088218433779717,21,44
2871,just_relax,0.3,0,0,0,0.0,-0.0112811671875761,36,37
2872,just_relax,0.3,0,0,0,0.0,-3.4878924121017896e-05,15,14
2873,just_relax,0.3,1,1,0,-0.0014549239964907,-0.00058525619921,14,16
2874,just_relax,0.3,197,237,-40,1.3477492998050025,0.0885093784332623,61,119
2875,just_relax,0.3,0,0,0,0.0,-0.0038599581671643,19,20
2876,just_relax,0.3,0,0,0,0.0,-0.0006472841631984,22,22
2877,just_relax,0.3,0,0,0,0.0,-0.0011415137972972,54,58
2878,just_relax,0.3,651,651,0,-0.0003954210755097,0.0002252638081207,65,135
2879,just_relax,0.3,1,1,0,-0.0029471577812358,0.0001749400264638,16,18
2880,just_relax,0.3,7,7,0,0.0002013814076775,0.0006636994664107,17,27
2881,just_relax,0.3,22,7,15,-12.985895473169307,0.1330374466905183,54,71
2882,just_relax,0.3,0,2,-2,-59.99819093035041,-0.0131455917893484,23,22
2883,just_relax,0.3,1,0,1,76.88395716132196,-0.1491322016956315,13,16
2884,just_relax,0.3,155,185,-30,2.3843149677438973,-0.02495720013905,85,131
2885,just_relax,0.3,44,44,0,0.0003032918935019,0.0025857794052007,28,55
2886,just_relax,0.3,4,4,0,-0.0007096785766407,-5.4537984728875166e-05,18,24
2887,just_relax,0.3,0,0,0,0.0,-0.003226028074061,19,22
2888,just_relax,0.3,0,0,0,0.0,0.0048197166778652,47,46
2889,just_relax,0.3,21,27,-6,0.0602947270368474,-0.3310372682946312,39,64
2890,just_relax,0.3,0,0,0,0.0,-0.0037052423868473,17,18
2891,just_relax,0.3,1,1,0,0.0005119856857191,0.0004745196477359,23,24
2892,just_relax,0.3,2,2,0,0.0010275548569325,-0.004970471779609,13,16
2893,just_relax,0.3,22,22,0,0.0038770082111057,0.0004285387996507,40,56
2894,just_relax,0.3,1,1,0,-0.0002865966515059,-0.0003325971221349,10,15
2895,just_relax,0.3,0,0,0,0.0,0.0003384089422906,21,20
2896,just_relax,0.3,4,4,0,-0.0001029723687508,-0.0013906355929786,30,35
2897,just_relax,0.3,1,1,0,0.0051043410712594,-0.0056156512673798,71,77
2898,relax_and_recompute,0.35,0,0,0,0.0,0.0,17,18
2899,relax_and_recompute,0.35,1,1,0,0.0,0.0,43,48
2900,relax_and_recompute,0.35,3,5,-2,9.88581419291326,0.0069193652867528,38,45
2901,relax_and_recompute,0.35,0,0,0,0.0,0.0,12,12
2902,relax_and_recompute,0.35,20,7,13,1.502478168846423,0.2029862696446577,23,38
2903,relax_and_recompute,0.35,0,1,-1,-78.11694026732484,-0.0295512202700576,19,22
2904,relax_and_recompute,0.35,976,1004,-28,-0.0620531910963606,-0.0009330148689207,35,143
2905,relax_and_recompute,0.35,0,0,0,0.0,-0.0046858462976494,92,91
2906,relax_and_recompute,0.35,2,2,0,0.0,0.0,43,51
2907,relax_and_recompute,0.35,1,1,0,0.0,0.0,35,36
2908,relax_and_recompute,0.35,1,1,0,0.0,0.0,11,13
2909,relax_and_recompute,0.35,22,19,3,-4.957652547927751,0.037406937188411,10,25
2910,relax_and_recompute,0.35,16,16,0,-1.2375805476415778,-0.0662978026850604,86,136
2911,relax_and_recompute,0.35,0,0,0,0.0,0.0,10,12
2912,relax_and_recompute,0.35,0,0,0,0.0,0.0,32,31
2913,relax_and_recompute,0.35,2,2,0,0.8097822186271628,0.0720915422264546,20,26
2914,relax_and_recompute,0.35,0,0,0,0.0,0.0,11,11
2915,relax_and_recompute,0.35,2,2,0,0.0,0.0,34,42
2916,relax_and_recompute,0.35,11,10,1,1.5445267212396203,-0.0356816848306716,14,25
2917,relax_and_recompute,0.35,8,4,4,9.035240939106416,-0.2006547963227668,31,46
2918,relax_and_recompute,0.35,0,2,-2,-60.43825847577355,-0.1126466588104083,42,45
2919,relax_and_recompute,0.35,1265,1233,32,-0.0829886923942524,-0.0013136328692162,39,173
2920,relax_and_recompute,0.35,11,11,0,0.0,0.0,14,24
2921,relax_and_recompute,0.35,0,0,0,0.0,0.0,24,25
2922,relax_and_recompute,0.35,2,2,0,0.0,0.0,12,19
2923,relax_and_recompute,0.35,59,59,0,0.0004995248301611,-0.0021609985989152,41,72
2924,relax_and_recompute,0.35,182,192,-10,2.176227062990442,0.127488881317396,59,115
2925,relax_and_recompute,0.35,6,4,2,3.758843121777289,0.465210734665941,32,37
2926,relax_and_recompute,0.35,1,1,0,0.0,0.0,20,20
2927,relax_and_recompute,0.35,41,26,15,-1.6275846340626714,0.0729158968985802,12,31
2928,relax_and_recompute,0.35,0,0,0,0.0,0.0,10,10
2929,relax_and_recompute,0.35,0,0,0,0.0,0.0,20,21
2930,relax_and_recompute,0.35,18,21,-3,0.5719110189928784,0.3696791622426242,39,52
2931,relax_and_recompute,0.35,378,393,-15,0.6108526484877643,4.422482210819645e-05,42,109
2932,relax_and_recompute,0.35,1,1,0,41.29601841034655,-0.0645366457148105,25,28
2933,relax_and_recompute,0.35,170,157,13,-3.523679109137184,0.105536041898159,56,106
2934,relax_and_recompute,0.35,567,575,-8,0.4383057260994292,-0.0017656065849445,87,189
2935,relax_and_recompute,0.35,41,40,1,-2.249384452446378,-0.0072514307594979,56,82
2936,relax_and_recompute,0.35,2,2,0,0.0,0.0,13,15
2937,relax_and_recompute,0.35,104,88,16,-3.3995451437074067,-0.111275141568526,36,63
2938,relax_and_recompute,0.35,0,0,0,0.0,0.0,16,15
2939,relax_and_recompute,0.35,0,0,0,0.0,0.0,67,66
2940,relax_and_recompute,0.35,13,13,0,0.0,0.0,42,60
2941,relax_and_recompute,0.35,0,0,0,0.0,0.0,39,38
2942,relax_and_recompute,0.35,8,8,0,0.0,0.0,20,36
2943,relax_and_recompute,0.35,0,0,0,0.0,0.0,10,9
2944,relax_and_recompute,0.35,1,1,0,0.0,0.0,13,15
2945,relax_and_recompute,0.35,6,14,-8,18.824286639655867,-0.0841754274640885,34,41
2946,relax_and_recompute,0.35,3,5,-2,3.41159566991864,0.101618768403258,37,42
2947,relax_and_recompute,0.35,36,36,0,0.0,0.0,18,29
2948,relax_and_recompute,0.35,0,0,0,0.0,0.0,23,22
2949,relax_and_recompute,0.35,0,0,0,0.0,0.0,13,12
2950,relax_and_recompute,0.35,0,0,0,0.0,0.0,15,14
2951,relax_and_recompute,0.35,0,0,0,0.0,0.0,69,68
2952,relax_and_recompute,0.35,0,0,0,0.0,0.0,40,39
2953,relax_and_recompute,0.35,0,0,0,0.0,0.0,89,93
2954,relax_and_recompute,0.35,13,12,1,-2.153586113029718,-0.0708055525167026,20,32
2955,relax_and_recompute,0.35,2,3,-1,-7.067084936198143,-0.0593654442548075,69,83
2956,relax_and_recompute,0.35,2,2,0,0.0,0.0,12,15
2957,relax_and_recompute,0.35,0,0,0,0.0,0.0,15,14
2958,relax_and_recompute,0.35,0,0,0,0.0,0.0,23,26
2959,relax_and_recompute,0.35,2,2,0,0.0,0.0,12,20
2960,relax_and_recompute,0.35,201,208,-7,-0.777546499391029,-0.0168449909220319,64,122
2961,relax_and_recompute,0.35,7,3,4,-15.3477275810384,-0.0042339303565398,58,71
2962,relax_and_recompute,0.35,0,0,0,0.0,-0.1147932957929044,20,19
2963,relax_and_recompute,0.35,510,512,-2,-0.0138388627329746,-0.001793654381577,100,191
2964,relax_and_recompute,0.35,34,34,0,0.0,0.0,41,61
2965,relax_and_recompute,0.35,33,34,-1,-0.5384989905164446,0.0398816997391653,13,31
2966,relax_and_recompute,0.35,5,3,2,12.118750923999592,-0.1168739524455244,10,15
2967,relax_and_recompute,0.35,6,5,1,-0.8387168161295051,-0.0584437188666191,37,47
2968,relax_and_recompute,0.35,0,0,0,0.0,-0.0047120123517853,21,21
2969,relax_and_recompute,0.35,0,0,0,0.0,0.0,11,10
2970,relax_and_recompute,0.35,57,57,0,0.0064914760634735,-0.0077421754008314,44,80
2971,relax_and_recompute,0.35,6,6,0,0.0,0.0,12,21
2972,relax_and_recompute,0.35,2,2,0,40.57817790180843,-0.0379305285754828,37,43
2973,relax_and_recompute,0.35,6,6,0,0.0,0.0,41,52
2974,relax_and_recompute,0.35,0,0,0,0.0,0.0,90,89
2975,relax_and_recompute,0.35,0,0,0,0.0,0.0,22,21
2976,relax_and_recompute,0.35,1,6,-5,-12.824308725883805,-0.0280060439235303,37,43
2977,relax_and_recompute,0.35,0,0,0,0.0,0.0,47,47
2978,relax_and_recompute,0.35,4,4,0,0.0,0.0,12,20
2979,relax_and_recompute,0.35,114,114,0,0.0,0.0,84,124
2980,relax_and_recompute,0.35,0,0,0,0.0,0.0,88,92
2981,relax_and_recompute,0.35,380,377,3,-0.3714807714610657,-0.0025427242202904,59,122
2982,relax_and_recompute,0.35,4,4,0,0.0,0.0,26,31
2983,relax_and_recompute,0.35,0,0,0,0.0,0.0,28,27
2984,relax_and_recompute,0.35,6,6,0,0.0,0.0,18,26
2985,relax_and_recompute,0.35,1,1,0,0.0,0.0,23,26
2986,relax_and_recompute,0.35,0,0,0,0.0,0.0,43,43
2987,relax_and_recompute,0.35,2,2,0,0.0,0.0,22,26
2988,relax_and_recompute,0.35,0,0,0,0.0,0.0,15,14
2989,relax_and_recompute,0.35,10,19,-9,5.648675414166,0.1018849030252861,36,48
2990,relax_and_recompute,0.35,6,6,0,2.8016025522275783,-0.3535412006642752,30,37
2991,relax_and_recompute,0.35,1,1,0,0.0,0.0,10,13
2992,relax_and_recompute,0.35,0,0,0,0.0,0.0,12,11
2993,relax_and_recompute,0.35,168,153,15,-1.4597591062543387,0.1638614131178267,55,105
2994,relax_and_recompute,0.35,1,1,0,17.12164821735773,0.0578261695456346,13,17
2995,relax_and_recompute,0.35,0,0,0,0.0,0.0,30,29
2996,relax_and_recompute,0.35,3,4,-1,-9.905682406522075,-0.002170500293968,36,43
2997,relax_and_recompute,0.35,36,36,0,0.0,0.0,40,60
2998,relax_and_recompute,0.35,0,0,0,0.0,0.0,13,17
2999,relax_and_recompute,0.35,6,8,-2,-4.960402959672933,-0.0115319394462201,23,30
3000,relax_and_recompute,0.35,0,0,0,0.0,0.0,12,16
3001,relax_and_recompute,0.35,0,0,0,0.0,0.0,26,26
3002,relax_and_recompute,0.35,0,0,0,0.0,0.0,22,31
3003,relax_and_recompute,0.35,0,0,0,0.0,0.0,68,68
3004,relax_and_recompute,0.35,0,0,0,0.0,0.0,23,22
3005,relax_and_recompute,0.35,0,0,0,0.0,-0.0349525596057489,43,42
3006,relax_and_recompute,0.35,0,0,0,0.0,0.0,18,17
3007,relax_and_recompute,0.35,3,1,2,16.774590073756514,-0.1297888041253873,28,42
3008,relax_and_recompute,0.35,45,50,-5,1.8841541587735409,0.0156030402407787,21,44
3009,relax_and_recompute,0.35,0,0,0,0.0,0.0,36,37
3010,relax_and_recompute,0.35,0,0,0,0.0,0.0,15,14
3011,relax_and_recompute,0.35,1,1,0,0.0,0.0,14,16
3012,relax_and_recompute,0.35,197,211,-14,1.6294158914226389,0.1952030013326532,61,119
3013,relax_and_recompute,0.35,0,0,0,0.0,0.0,19,20
3014,relax_and_recompute,0.35,0,0,0,0.0,0.0,22,22
3015,relax_and_recompute,0.35,0,0,0,0.0,-0.0413225144380497,54,58
3016,relax_and_recompute,0.35,651,651,0,0.0,0.0,65,135
3017,relax_and_recompute,0.35,1,1,0,0.0,0.0,16,18
3018,relax_and_recompute,0.35,7,7,0,1.8691234648716488,0.0445121885028382,17,27
3019,relax_and_recompute,0.35,22,4,18,-18.61747849085588,0.1446288399504806,54,71
3020,relax_and_recompute,0.35,0,2,-2,-69.51467976885004,-0.0285407675374049,23,22
3021,relax_and_recompute,0.35,1,0,1,76.88395716132196,-0.1491322016956315,13,16
3022,relax_and_recompute,0.35,155,149,6,-2.794184228530185,-0.0034415506621975,85,131
3023,relax_and_recompute,0.35,44,58,-14,6.627037203531586,0.0061263330641294,28,55
3024,relax_and_recompute,0.35,4,4,0,0.0,0.0,18,24
3025,relax_and_recompute,0.35,0,0,0,0.0,0.0,19,22
3026,relax_and_recompute,0.35,0,0,0,0.0,0.0,47,46
3027,relax_and_recompute,0.35,21,21,0,-3.6879171991704425,0.0716976646866419,39,64
3028,relax_and_recompute,0.35,0,0,0,0.0,0.0,17,18
3029,relax_and_recompute,0.35,1,1,0,0.0,0.0,23,24
3030,relax_and_recompute,0.35,2,2,0,-2.1513476699157508,-0.0283592430201563,13,16
3031,relax_and_recompute,0.35,22,22,0,0.0,0.0,40,56
3032,relax_and_recompute,0.35,1,1,0,0.0,0.0,10,15
3033,relax_and_recompute,0.35,0,0,0,0.0,0.0,21,20
3034,relax_and_recompute,0.35,4,4,0,0.0,0.0,30,35
3035,relax_and_recompute,0.35,1,1,0,0.0,0.0,71,77
3036,relax_one,0.35,0,0,0,0.0,0.0,17,18
3037,relax_one,0.35,1,1,0,0.0,0.0,43,48
3038,relax_one,0.35,3,3,0,0.0,0.0,38,45
3039,relax_one,0.35,0,0,0,0.0,0.0,12,12
3040,relax_one,0.35,20,18,2,-3.2752299140735204,0.0114158034923678,23,38
3041,relax_one,0.35,0,1,-1,-78.11694026732484,-0.0295512202700576,19,22
3042,relax_one,0.35,976,978,-2,0.1423455471242221,-0.0025418055405018,35,143
3043,relax_one,0.35,0,1,-1,-50.19567681247512,-0.0041327022016595,92,91
3044,relax_one,0.35,2,2,0,0.0,0.0,43,51
3045,relax_one,0.35,1,1,0,0.0,0.0,35,36
3046,relax_one,0.35,1,1,0,0.0,0.0,11,13
3047,relax_one,0.35,22,20,2,-3.01441643358082,0.0082886474985522,10,25
3048,relax_one,0.35,16,16,0,0.0,0.0,86,136
3049,relax_one,0.35,0,0,0,0.0,0.0,10,12
3050,relax_one,0.35,0,0,0,0.0,0.0,32,31
3051,relax_one,0.35,2,2,0,4.970962038347736,-0.0904350603192869,20,26
3052,relax_one,0.35,0,0,0,0.0,0.0,11,11
3053,relax_one,0.35,2,2,0,0.0,0.0,34,42
3054,relax_one,0.35,11,11,0,0.0,0.0,14,25
3055,relax_one,0.35,8,7,1,13.99583228956454,0.1582030612456263,31,46
3056,relax_one,0.35,0,0,0,0.0,0.0,42,45
3057,relax_one,0.35,1265,1240,25,0.1009906236120983,0.0001682713719424,39,173
3058,relax_one,0.35,11,11,0,0.0,0.0,14,24
3059,relax_one,0.35,0,0,0,0.0,0.0,24,25
3060,relax_one,0.35,2,2,0,0.0,0.0,12,19
3061,relax_one,0.35,59,59,0,0.4609819410147793,0.0044552421238692,41,72
3062,relax_one,0.35,182,191,-9,1.446975953367918,0.0358261975695221,59,115
3063,relax_one,0.35,6,6,0,0.0,0.0,32,37
3064,relax_one,0.35,1,1,0,0.0,0.0,20,20
3065,relax_one,0.35,41,32,9,2.305146048931391,0.0775874222420341,12,31
3066,relax_one,0.35,0,0,0,0.0,0.0,10,10
3067,relax_one,0.35,0,0,0,0.0,0.0,20,21
3068,relax_one,0.35,18,18,0,0.0,0.0,39,52
3069,relax_one,0.35,378,395,-17,-0.4859193577000411,-0.0010324457545943,42,109
3070,relax_one,0.35,1,1,0,0.0,0.0,25,28
3071,relax_one,0.35,170,170,0,0.0,0.0,56,106
3072,relax_one,0.35,567,595,-28,0.7834114754025379,-0.002967395777259,87,189
3073,relax_one,0.35,41,41,0,-3.1762323320181167,-0.0099859384844429,56,82
3074,relax_one,0.35,2,2,0,0.0,0.0,13,15
3075,relax_one,0.35,104,88,16,-3.3995451437074067,-0.111275141568526,36,63
3076,relax_one,0.35,0,0,0,0.0,0.0,16,15
3077,relax_one,0.35,0,0,0,0.0,0.0,67,66
3078,relax_one,0.35,13,13,0,0.0,0.0,42,60
3079,relax_one,0.35,0,0,0,0.0,0.0,39,38
3080,relax_one,0.35,8,8,0,0.0,0.0,20,36
3081,relax_one,0.35,0,0,0,0.0,0.0,10,9
3082,relax_one,0.35,1,1,0,0.0,0.0,13,15
3083,relax_one,0.35,6,7,-1,12.522285729298716,0.0299062089849014,34,41
3084,relax_one,0.35,3,3,0,0.0,0.0,37,42
3085,relax_one,0.35,36,36,0,0.0,0.0,18,29
3086,relax_one,0.35,0,0,0,0.0,0.0,23,22
3087,relax_one,0.35,0,0,0,0.0,0.0,13,12
3088,relax_one,0.35,0,0,0,0.0,0.0,15,14
3089,relax_one,0.35,0,0,0,0.0,0.0,69,68
3090,relax_one,0.35,0,0,0,0.0,0.0,40,39
3091,relax_one,0.35,0,0,0,0.0,0.0,89,93
3092,relax_one,0.35,13,13,0,-2.975681235416161,-0.0847204542309565,20,32
3093,relax_one,0.35,2,2,0,0.0,0.0,69,83
3094,relax_one,0.35,2,2,0,0.0,0.0,12,15
3095,relax_one,0.35,0,0,0,0.0,0.0,15,14
3096,relax_one,0.35,0,0,0,0.0,0.0,23,26
3097,relax_one,0.35,2,2,0,0.0,0.0,12,20
3098,relax_one,0.35,201,201,0,0.0,0.0,64,122
3099,relax_one,0.35,7,7,0,0.0,0.0,58,71
3100,relax_one,0.35,0,0,0,0.0,0.0,20,19
3101,relax_one,0.35,510,510,0,0.0060639005596385,-0.0006916839131552,100,191
3102,relax_one,0.35,34,34,0,0.0,0.0,41,61
3103,relax_one,0.35,33,34,-1,-0.6264707699284884,0.0331924782664471,13,31
3104,relax_one,0.35,5,5,0,0.0,0.0,10,15
3105,relax_one,0.35,6,6,0,0.0,0.0,37,47
3106,relax_one,0.35,0,0,0,0.0,0.0,21,21
3107,relax_one,0.35,0,0,0,0.0,0.0,11,10
3108,relax_one,0.35,57,55,2,-1.1796960984034186,9.734149291917849e-05,44,80
3109,relax_one,0.35,6,6,0,0.0,0.0,12,21
3110,relax_one,0.35,2,2,0,42.15913628345388,-0.0181760816329957,37,43
3111,relax_one,0.35,6,6,0,0.0,0.0,41,52
3112,relax_one,0.35,0,0,0,0.0,0.0,90,89
3113,relax_one,0.35,0,0,0,0.0,0.0,22,21
3114,relax_one,0.35,1,1,0,-4.213527745425694,0.0417394626549948,37,43
3115,relax_one,0.35,0,0,0,0.0,0.0,47,47
3116,relax_one,0.35,4,4,0,0.0,0.0,12,20
3117,relax_one,0.35,114,114,0,0.0,0.0,84,124
3118,relax_one,0.35,0,0,0,0.0,0.0,88,92
3119,relax_one,0.35,380,377,3,-0.3714807714610657,-0.0025427242202904,59,122
3120,relax_one,0.35,4,4,0,0.0,0.0,26,31
3121,relax_one,0.35,0,0,0,0.0,0.0,28,27
3122,relax_one,0.35,6,6,0,0.0,0.0,18,26
3123,relax_one,0.35,1,1,0,0.0,0.0,23,26
3124,relax_one,0.35,0,0,0,0.0,0.0,43,43
3125,relax_one,0.35,2,2,0,0.0,0.0,22,26
3126,relax_one,0.35,0,0,0,0.0,0.0,15,14
3127,relax_one,0.35,10,17,-7,3.5874123628873704,0.0856058777554238,36,48
3128,relax_one,0.35,6,6,0,2.8016025522275783,-0.3535412006642752,30,37
3129,relax_one,0.35,1,1,0,0.0,0.0,10,13
3130,relax_one,0.35,0,0,0,0.0,0.0,12,11
3131,relax_one,0.35,168,167,1,-0.7965879277094672,0.0475430066924907,55,105
3132,relax_one,0.35,1,1,0,17.12164821735773,0.0578261695456346,13,17
3133,relax_one,0.35,0,0,0,0.0,0.0,30,29
3134,relax_one,0.35,3,3,0,0.0,0.0,36,43
3135,relax_one,0.35,36,36,0,0.0,0.0,40,60
3136,relax_one,0.35,0,0,0,0.0,0.0,13,17
3137,relax_one,0.35,6,7,-1,-5.27235869178908,0.0082826452568239,23,30
3138,relax_one,0.35,0,0,0,0.0,0.0,12,16
3139,relax_one,0.35,0,0,0,0.0,0.0,26,26
3140,relax_one,0.35,0,0,0,0.0,0.0,22,31
3141,relax_one,0.35,0,0,0,0.0,0.0,68,68
3142,relax_one,0.35,0,0,0,0.0,0.0,23,22
3143,relax_one,0.35,0,0,0,0.0,-0.0348129737608335,43,42
3144,relax_one,0.35,0,0,0,0.0,0.0,18,17
3145,relax_one,0.35,3,3,0,0.0,0.0,28,42
3146,relax_one,0.35,45,45,0,0.1036479088850654,-0.0041754562964496,21,44
3147,relax_one,0.35,0,0,0,0.0,0.0,36,37
3148,relax_one,0.35,0,0,0,0.0,0.0,15,14
3149,relax_one,0.35,1,1,0,0.0,0.0,14,16
3150,relax_one,0.35,197,204,-7,3.484436282689749,0.1757315340586914,61,119
3151,relax_one,0.35,0,0,0,0.0,0.0,19,20
3152,relax_one,0.35,0,0,0,0.0,0.0,22,22
3153,relax_one,0.35,0,0,0,0.0,0.0,54,58
3154,relax_one,0.35,651,651,0,0.0,0.0,65,135
3155,relax_one,0.35,1,1,0,0.0,0.0,16,18
3156,relax_one,0.35,7,7,0,0.0,0.0,17,27
3157,relax_one,0.35,22,4,18,-19.06910671434205,0.1469333863626725,54,71
3158,relax_one,0.35,0,2,-2,-59.99819093035041,-0.0131455917893484,23,22
3159,relax_one,0.35,1,0,1,76.88395716132196,-0.1491322016956315,13,16
3160,relax_one,0.35,155,146,9,-2.3741667241416664,-0.001397205031107,85,131
3161,relax_one,0.35,44,44,0,0.0,0.0,28,55
3162,relax_one,0.35,4,4,0,0.0,0.0,18,24
3163,relax_one,0.35,0,0,0,0.0,0.0,19,22
3164,relax_one,0.35,0,0,0,0.0,0.0,47,46
3165,relax_one,0.35,21,19,2,-6.356920988253222,0.0143956759658575,39,64
3166,relax_one,0.35,0,0,0,0.0,0.0,17,18
3167,relax_one,0.35,1,1,0,0.0,0.0,23,24
3168,relax_one,0.35,2,2,0,0.0,0.0,13,16
3169,relax_one,0.35,22,22,0,0.0,0.0,40,56
3170,relax_one,0.35,1,1,0,0.0,0.0,10,15
3171,relax_one,0.35,0,0,0,0.0,0.0,21,20
3172,relax_one,0.35,4,4,0,0.0,0.0,30,35
3173,relax_one,0.35,1,1,0,0.0,0.0,71,77
3174,just_relax,0.35,0,0,0,0.0,-0.0091692815110081,17,18
3175,just_relax,0.35,1,1,0,0.0009607869158827,0.0014628518031132,43,48
3176,just_relax,0.35,3,3,0,-0.0019521681741139,-7.679999619569777e-05,38,45
3177,just_relax,0.35,0,0,0,0.0,-0.0037600566419999,12,12
3178,just_relax,0.35,20,14,6,1.9891400956483096,0.1544148745043621,23,38
3179,just_relax,0.35,0,1,-1,-78.11694026732484,-0.0295512202700576,19,22
3180,just_relax,0.35,976,1188,-212,1.3106081233515638,0.0257948127350838,35,143
3181,just_relax,0.35,0,4,-4,-39.1818408082167,-0.0156618414823971,92,91
3182,just_relax,0.35,2,2,0,-0.00041775540015,-0.0002552385505018,43,51
3183,just_relax,0.35,1,1,0,-0.0016870080925173,6.40249009676297e-05,35,36
3184,just_relax,0.35,1,1,0,-0.000156439410091,0.0002508982184644,11,13
3185,just_relax,0.35,22,24,-2,-3.49415891827384,0.1000113687896936,10,25
3186,just_relax,0.35,16,13,3,0.2088785180214571,-2.2771107622610032e-05,86,136
3187,just_relax,0.35,0,0,0,0.0,-1.765503840900351e-06,10,12
3188,just_relax,0.35,0,0,0,0.0,-1.014518260578079e-05,32,31
3189,just_relax,0.35,2,2,0,4.970962038347736,-0.0904350603192869,20,26
3190,just_relax,0.35,0,0,0,0.0,0.000269092021105,11,11
3191,just_relax,0.35,2,2,0,0.0009292844165713,-0.0008610890242942,34,42
3192,just_relax,0.35,11,11,0,-0.0003616788843885,0.0005035529702898,14,25
3193,just_relax,0.35,8,7,1,13.99583228956454,0.1582030612456263,31,46
3194,just_relax,0.35,0,0,0,0.0,0.0042083907430441,42,45
3195,just_relax,0.35,1265,1285,-20,2.6849459664833404,-0.1292871249874528,39,173
3196,just_relax,0.35,11,11,0,0.0001627700527109,0.0015600944076981,14,24
3197,just_relax,0.35,0,0,0,0.0,-0.000608053012485,24,25
3198,just_relax,0.35,2,2,0,-2.981324638540173e-05,0.0001440646714581,12,19
3199,just_relax,0.35,59,59,0,0.4609819410147793,0.0044552421238692,41,72
3200,just_relax,0.35,182,178,4,0.0313317398119608,0.0970080713564147,59,115
3201,just_relax,0.35,6,6,0,-0.0020404096920856,0.0011964290694836,32,37
3202,just_relax,0.35,1,0,1,64.5674534074053,-0.0013228453280204,20,20
3203,just_relax,0.35,41,33,8,8.182357833947279,-0.009895766072516,12,31
3204,just_relax,0.35,0,0,0,0.0,-1.5942199658169898e-06,10,10
3205,just_relax,0.35,0,0,0,0.0,0.0018153466622625,20,21
3206,just_relax,0.35,18,18,0,0.0003589278580733,-0.0005865039043362,39,52
3207,just_relax,0.35,378,369,9,2.979528253482861,0.0835817869771829,42,109
3208,just_relax,0.35,1,1,0,-0.0010366044558338,-5.546321229055184e-05,25,28
3209,just_relax,0.35,170,170,0,-0.0002769762706833,-0.0005002245004087,56,106
3210,just_relax,0.35,567,521,46,-0.2657392120378574,0.1239070997048957,87,189
3211,just_relax,0.35,41,43,-2,2.499128887843675,-0.033528056765164,56,82
3212,just_relax,0.35,2,2,0,0.0004861774901456,1.2071037781558047e-06,13,15
3213,just_relax,0.35,104,86,18,5.26724471872344,-0.2840091449765524,36,63
3214,just_relax,0.35,0,0,0,0.0,4.3915154694929015e-06,16,15
3215,just_relax,0.35,0,0,0,0.0,-5.223096419815221e-07,67,66
3216,just_relax,0.35,13,13,0,0.0024384647237383,0.004260897920215,42,60
3217,just_relax,0.35,0,0,0,0.0,0.0005903979895692,39,38
3218,just_relax,0.35,8,8,0,-3.330899971842882e-05,0.0005334774465118,20,36
3219,just_relax,0.35,0,0,0,0.0,-0.0010596071395927,10,9
3220,just_relax,0.35,1,1,0,0.0009644178095271,-1.805181839154013e-05,13,15
3221,just_relax,0.35,6,7,-1,12.522285729298716,0.0299062089849014,34,41
3222,just_relax,0.35,3,3,0,-0.0014185667246167,0.0006213779664755,37,42
3223,just_relax,0.35,36,36,0,7.196136941445275e-06,5.025038399830706e-06,18,29
3224,just_relax,0.35,0,0,0,0.0,-0.0031405837993232,23,22
3225,just_relax,0.35,0,0,0,0.0,1.0504657718901632e-05,13,12
3226,just_relax,0.35,0,0,0,0.0,-0.0007613272869088,15,14
3227,just_relax,0.35,0,0,0,0.0,-0.0017207203528439,69,68
3228,just_relax,0.35,0,0,0,0.0,0.001934163275203,40,39
3229,just_relax,0.35,0,0,0,0.0,0.0016954512903432,89,93
3230,just_relax,0.35,13,13,0,1.511050374969713,-0.0878570612978808,20,32
3231,just_relax,0.35,2,3,-1,-4.120223819609976,0.0096644512108772,69,83
3232,just_relax,0.35,2,2,0,0.0006766545457281,-0.0007958153584334,12,15
3233,just_relax,0.35,0,0,0,0.0,-0.0009758471183408,15,14
3234,just_relax,0.35,0,0,0,0.0,-0.0007570529942456,23,26
3235,just_relax,0.35,2,2,0,-0.0004670837519427,-0.000552899751354,12,20
3236,just_relax,0.35,201,201,0,-5.927609844036397e-05,0.0001073571901385,64,122
3237,just_relax,0.35,7,7,0,-0.0099055150386959,0.0003544031231826,58,71
3238,just_relax,0.35,0,0,0,0.0,-0.0013086772972689,20,19
3239,just_relax,0.35,510,505,5,-0.1096058695008466,0.0001562332230281,100,191
3240,just_relax,0.35,34,34,0,0.0046498502251353,3.462795885833536e-05,41,61
3241,just_relax,0.35,33,21,12,-0.322372772893118,0.0487025778316814,13,31
3242,just_relax,0.35,5,5,0,0.0003476406123752,0.0002826333043987,10,15
3243,just_relax,0.35,6,6,0,-0.0004254358946269,0.0003115870201488,37,47
3244,just_relax,0.35,0,0,0,0.0,0.0007350584472026,21,21
3245,just_relax,0.35,0,0,0,0.0,9.621758975453254e-06,11,10
3246,just_relax,0.35,57,55,2,-1.1796960984034186,9.734149291917849e-05,44,80
3247,just_relax,0.35,6,6,0,0.0001929725905256,-1.6711583069151104e-05,12,21
3248,just_relax,0.35,2,5,-3,10.477360070400792,-0.0167672873232497,37,43
3249,just_relax,0.35,6,6,0,-9.27967616917158e-05,0.0005867078171852,41,52
3250,just_relax,0.35,0,0,0,0.0,0.0258238191424075,90,89
3251,just_relax,0.35,0,0,0,0.0,-0.0001762041220683,22,21
3252,just_relax,0.35,1,5,-4,-25.99394547658536,0.034397478016983,37,43
3253,just_relax,0.35,0,0,0,0.0,0.009279908390236,47,47
3254,just_relax,0.35,4,4,0,-0.0003372893218767,-9.212772776878708e-07,12,20
3255,just_relax,0.35,114,95,19,0.8287298242191525,-0.006531385777559,84,124
3256,just_relax,0.35,0,0,0,0.0,0.0016708237920683,88,92
3257,just_relax,0.35,380,332,48,-1.681066658089314,0.0270328691740772,59,122
3258,just_relax,0.35,4,4,0,2.0677824380754828e-05,-0.000363330475558,26,31
3259,just_relax,0.35,0,0,0,0.0,4.418930553695688e-06,28,27
3260,just_relax,0.35,6,6,0,0.0013890930604816,7.243956427815945e-06,18,26
3261,just_relax,0.35,1,1,0,-0.0014241348598034,0.001861633846505,23,26
3262,just_relax,0.35,0,0,0,0.0,0.0001814651838247,43,43
3263,just_relax,0.35,2,2,0,0.0004949068667485,0.0012137972461528,22,26
3264,just_relax,0.35,0,0,0,0.0,8.316094011640018e-06,15,14
3265,just_relax,0.35,10,17,-7,3.5874123628873704,0.0856058777554238,36,48
3266,just_relax,0.35,6,6,0,2.8016025522275783,-0.3535412006642752,30,37
3267,just_relax,0.35,1,1,0,5.455328151526828e-05,-4.433967369288361e-05,10,13
3268,just_relax,0.35,0,0,0,0.0,-0.0049855760382295,12,11
3269,just_relax,0.35,168,182,-14,1.1771250480206064,-0.0267800915114647,55,105
3270,just_relax,0.35,1,1,0,17.12164821735773,0.0578261695456346,13,17
3271,just_relax,0.35,0,0,0,0.0,0.0003329515887838,30,29
3272,just_relax,0.35,3,3,0,0.000583815366788,0.0008768881680062,36,43
3273,just_relax,0.35,36,36,0,0.0010314806767866,-5.393936385500453e-05,40,60
3274,just_relax,0.35,0,0,0,0.0,0.0017894746066188,13,17
3275,just_relax,0.35,6,7,-1,-5.27235869178908,0.0082826452568239,23,30
3276,just_relax,0.35,0,0,0,0.0,-2.940409977925107e-05,12,16
3277,just_relax,0.35,0,0,0,0.0,3.901708024223183e-06,26,26
3278,just_relax,0.35,0,0,0,0.0,-0.0031688166024113,22,31
3279,just_relax,0.35,0,0,0,0.0,0.0008768193667615,68,68
3280,just_relax,0.35,0,0,0,0.0,-7.938175057398134e-06,23,22
3281,just_relax,0.35,0,0,0,0.0,-0.065399188004364,43,42
3282,just_relax,0.35,0,0,0,0.0,-0.002899723134464,18,17
3283,just_relax,0.35,3,3,0,-0.003194586812441,0.0012605153222713,28,42
3284,just_relax,0.35,45,58,-13,0.9231299892006462,0.088218433779717,21,44
3285,just_relax,0.35,0,0,0,0.0,-0.0112811671875761,36,37
3286,just_relax,0.35,0,0,0,0.0,-3.4878924121017896e-05,15,14
3287,just_relax,0.35,1,1,0,-0.0014549239964907,-0.00058525619921,14,16
3288,just_relax,0.35,197,237,-40,1.3477492998050025,0.0885093784332623,61,119
3289,just_relax,0.35,0,0,0,0.0,-0.0038599581671643,19,20
3290,just_relax,0.35,0,0,0,0.0,-0.0006472841631984,22,22
3291,just_relax,0.35,0,0,0,0.0,-0.0011415137972972,54,58
3292,just_relax,0.35,651,651,0,-0.0003954210755097,0.0002252638081207,65,135
3293,just_relax,0.35,1,1,0,-0.0029471577812358,0.0001749400264638,16,18
3294,just_relax,0.35,7,7,0,0.0002013814076775,0.0006636994664107,17,27
3295,just_relax,0.35,22,7,15,-12.985895473169307,0.1330374466905183,54,71
3296,just_relax,0.35,0,2,-2,-59.99819093035041,-0.0131455917893484,23,22
3297,just_relax,0.35,1,0,1,76.88395716132196,-0.1491322016956315,13,16
3298,just_relax,0.35,155,185,-30,2.3843149677438973,-0.02495720013905,85,131
3299,just_relax,0.35,44,44,0,0.0003032918935019,0.0025857794052007,28,55
3300,just_relax,0.35,4,4,0,-0.0007096785766407,-5.4537984728875166e-05,18,24
3301,just_relax,0.35,0,0,0,0.0,-0.003226028074061,19,22
3302,just_relax,0.35,0,0,0,0.0,0.0048197166778652,47,46
3303,just_relax,0.35,21,27,-6,0.0602947270368474,-0.3310372682946312,39,64
3304,just_relax,0.35,0,0,0,0.0,-0.0037052423868473,17,18
3305,just_relax,0.35,1,1,0,0.0005119856857191,0.0004745196477359,23,24
3306,just_relax,0.35,2,2,0,0.0010275548569325,-0.004970471779609,13,16
3307,just_relax,0.35,22,22,0,0.0038770082111057,0.0004285387996507,40,56
3308,just_relax,0.35,1,1,0,-0.0002865966515059,-0.0003325971221349,10,15
3309,just_relax,0.35,0,0,0,0.0,0.0003384089422906,21,20
3310,just_relax,0.35,4,4,0,-0.0001029723687508,-0.0013906355929786,30,35
3311,just_relax,0.35,1,1,0,0.0051043410712594,-0.0056156512673798,71,77
3312,relax_and_recompute,0.4,0,0,0,0.0,0.0,17,18
3313,relax_and_recompute,0.4,1,1,0,0.0,0.0,43,48
3314,relax_and_recompute,0.4,3,6,-3,14.784127868533233,0.0001325782114905,38,45
3315,relax_and_recompute,0.4,0,0,0,0.0,0.0,12,12
3316,relax_and_recompute,0.4,20,7,13,1.502478168846423,0.2029862696446577,23,38
3317,relax_and_recompute,0.4,0,1,-1,-78.11694026732484,-0.0295512202700576,19,22
3318,relax_and_recompute,0.4,976,1004,-28,-0.0620531910963606,-0.0009330148689207,35,143
3319,relax_and_recompute,0.4,0,0,0,0.0,-0.0046858462976494,92,91
3320,relax_and_recompute,0.4,2,2,0,0.0,0.0,43,51
3321,relax_and_recompute,0.4,1,1,0,0.0,0.0,35,36
3322,relax_and_recompute,0.4,1,1,0,0.0,0.0,11,13
3323,relax_and_recompute,0.4,22,19,3,-4.957652547927751,0.037406937188411,10,25
3324,relax_and_recompute,0.4,16,16,0,-1.2375805476415778,-0.0662978026850604,86,136
3325,relax_and_recompute,0.4,0,0,0,0.0,0.0,10,12
3326,relax_and_recompute,0.4,0,0,0,0.0,0.0,32,31
3327,relax_and_recompute,0.4,2,2,0,0.8097822186271628,0.0720915422264546,20,26
3328,relax_and_recompute,0.4,0,0,0,0.0,0.0,11,11
3329,relax_and_recompute,0.4,2,2,0,0.0,0.0,34,42
3330,relax_and_recompute,0.4,11,11,0,0.0,0.0,14,25
3331,relax_and_recompute,0.4,8,7,1,13.99583228956454,0.1582030612456263,31,46
3332,relax_and_recompute,0.4,0,2,-2,-60.43825847577355,-0.1126466588104083,42,45
3333,relax_and_recompute,0.4,1265,1233,32,-0.0829886923942524,-0.0013136328692162,39,173
3334,relax_and_recompute,0.4,11,11,0,0.0,0.0,14,24
3335,relax_and_recompute,0.4,0,0,0,0.0,0.0,24,25
3336,relax_and_recompute,0.4,2,2,0,0.0,0.0,12,19
3337,relax_and_recompute,0.4,59,59,0,0.0004995248301611,-0.0021609985989152,41,72
3338,relax_and_recompute,0.4,182,192,-10,2.176227062990442,0.127488881317396,59,115
3339,relax_and_recompute,0.4,6,4,2,3.758843121777289,0.465210734665941,32,37
3340,relax_and_recompute,0.4,1,1,0,0.0,0.0,20,20
3341,relax_and_recompute,0.4,41,26,15,-1.6275846340626714,0.0729158968985802,12,31
3342,relax_and_recompute,0.4,0,0,0,0.0,0.0,10,10
3343,relax_and_recompute,0.4,0,0,0,0.0,0.0,20,21
3344,relax_and_recompute,0.4,18,21,-3,0.5719110189928784,0.3696791622426242,39,52
3345,relax_and_recompute,0.4,378,393,-15,0.6108526484877643,4.422482210819645e-05,42,109
3346,relax_and_recompute,0.4,1,1,0,41.29601841034655,-0.0645366457148105,25,28
3347,relax_and_recompute,0.4,170,157,13,-3.523679109137184,0.105536041898159,56,106
3348,relax_and_recompute,0.4,567,575,-8,0.4383057260994292,-0.0017656065849445,87,189
3349,relax_and_recompute,0.4,41,40,1,-2.249384452446378,-0.0072514307594979,56,82
3350,relax_and_recompute,0.4,2,2,0,0.0,0.0,13,15
3351,relax_and_recompute,0.4,104,88,16,-3.3995451437074067,-0.111275141568526,36,63
3352,relax_and_recompute,0.4,0,0,0,0.0,0.0,16,15
3353,relax_and_recompute,0.4,0,0,0,0.0,0.0,67,66
3354,relax_and_recompute,0.4,13,13,0,0.0,0.0,42,60
3355,relax_and_recompute,0.4,0,0,0,0.0,0.0,39,38
3356,relax_and_recompute,0.4,8,8,0,0.0,0.0,20,36
3357,relax_and_recompute,0.4,0,0,0,0.0,0.0,10,9
3358,relax_and_recompute,0.4,1,1,0,0.0,0.0,13,15
3359,relax_and_recompute,0.4,6,14,-8,18.824286639655867,-0.0841754274640885,34,41
3360,relax_and_recompute,0.4,3,3,0,0.0,0.0,37,42
3361,relax_and_recompute,0.4,36,36,0,0.0,0.0,18,29
3362,relax_and_recompute,0.4,0,0,0,0.0,0.0,23,22
3363,relax_and_recompute,0.4,0,0,0,0.0,0.0,13,12
3364,relax_and_recompute,0.4,0,0,0,0.0,0.0,15,14
3365,relax_and_recompute,0.4,0,0,0,0.0,0.0,69,68
3366,relax_and_recompute,0.4,0,0,0,0.0,0.0,40,39
3367,relax_and_recompute,0.4,0,0,0,0.0,0.0,89,93
3368,relax_and_recompute,0.4,13,13,0,-2.975681235416161,-0.0847204542309565,20,32
3369,relax_and_recompute,0.4,2,3,-1,-7.067084936198143,-0.0593654442548075,69,83
3370,relax_and_recompute,0.4,2,2,0,0.0,0.0,12,15
3371,relax_and_recompute,0.4,0,0,0,0.0,0.0,15,14
3372,relax_and_recompute,0.4,0,0,0,0.0,0.0,23,26
3373,relax_and_recompute,0.4,2,2,0,0.0,0.0,12,20
3374,relax_and_recompute,0.4,201,208,-7,-0.777546499391029,-0.0168449909220319,64,122
3375,relax_and_recompute,0.4,7,3,4,-15.3477275810384,-0.0042339303565398,58,71
3376,relax_and_recompute,0.4,0,0,0,0.0,-0.1147932957929044,20,19
3377,relax_and_recompute,0.4,510,512,-2,-0.0138388627329746,-0.001793654381577,100,191
3378,relax_and_recompute,0.4,34,34,0,0.0,0.0,41,61
3379,relax_and_recompute,0.4,33,34,-1,-0.5384989905164446,0.0398816997391653,13,31
3380,relax_and_recompute,0.4,5,5,0,0.0,0.0,10,15
3381,relax_and_recompute,0.4,6,5,1,-0.8387168161295051,-0.0584437188666191,37,47
3382,relax_and_recompute,0.4,0,0,0,0.0,-0.0047120123517853,21,21
3383,relax_and_recompute,0.4,0,0,0,0.0,0.0,11,10
3384,relax_and_recompute,0.4,57,57,0,0.0064914760634735,-0.0077421754008314,44,80
3385,relax_and_recompute,0.4,6,6,0,0.0,0.0,12,21
3386,relax_and_recompute,0.4,2,2,0,40.57817790180843,-0.0379305285754828,37,43
3387,relax_and_recompute,0.4,6,6,0,0.0,0.0,41,52
3388,relax_and_recompute,0.4,0,0,0,0.0,0.0,90,89
3389,relax_and_recompute,0.4,0,0,0,0.0,0.0,22,21
3390,relax_and_recompute,0.4,1,6,-5,-12.824308725883805,-0.0280060439235303,37,43
3391,relax_and_recompute,0.4,0,0,0,0.0,0.0,47,47
3392,relax_and_recompute,0.4,4,4,0,0.0,0.0,12,20
3393,relax_and_recompute,0.4,114,114,0,0.0,0.0,84,124
3394,relax_and_recompute,0.4,0,0,0,0.0,0.0,88,92
3395,relax_and_recompute,0.4,380,377,3,-0.3714807714610657,-0.0025427242202904,59,122
3396,relax_and_recompute,0.4,4,4,0,0.0,0.0,26,31
3397,relax_and_recompute,0.4,0,0,0,0.0,0.0,28,27
3398,relax_and_recompute,0.4,6,6,0,0.0,0.0,18,26
3399,relax_and_recompute,0.4,1,1,0,0.0,0.0,23,26
3400,relax_and_recompute,0.4,0,0,0,0.0,0.0,43,43
3401,relax_and_recompute,0.4,2,2,0,0.0,0.0,22,26
3402,relax_and_recompute,0.4,0,0,0,0.0,0.0,15,14
3403,relax_and_recompute,0.4,10,19,-9,5.648675414166,0.1018849030252861,36,48
3404,relax_and_recompute,0.4,6,6,0,2.8016025522275783,-0.3535412006642752,30,37
3405,relax_and_recompute,0.4,1,1,0,0.0,0.0,10,13
3406,relax_and_recompute,0.4,0,0,0,0.0,0.0,12,11
3407,relax_and_recompute,0.4,168,153,15,-1.4597591062543387,0.1638614131178267,55,105
3408,relax_and_recompute,0.4,1,1,0,17.12164821735773,0.0578261695456346,13,17
3409,relax_and_recompute,0.4,0,0,0,0.0,0.0,30,29
3410,relax_and_recompute,0.4,3,3,0,0.0,0.0,36,43
3411,relax_and_recompute,0.4,36,36,0,0.0,0.0,40,60
3412,relax_and_recompute,0.4,0,0,0,0.0,0.0,13,17
3413,relax_and_recompute,0.4,6,8,-2,-4.960402959672933,-0.0115319394462201,23,30
3414,relax_and_recompute,0.4,0,0,0,0.0,0.0,12,16
3415,relax_and_recompute,0.4,0,0,0,0.0,0.0,26,26
3416,relax_and_recompute,0.4,0,0,0,0.0,0.0,22,31
3417,relax_and_recompute,0.4,0,0,0,0.0,0.0,68,68
3418,relax_and_recompute,0.4,0,0,0,0.0,0.0,23,22
3419,relax_and_recompute,0.4,0,0,0,0.0,-0.0349525596057489,43,42
3420,relax_and_recompute,0.4,0,0,0,0.0,0.0,18,17
3421,relax_and_recompute,0.4,3,1,2,13.207521286203315,-0.0569455074315961,28,42
3422,relax_and_recompute,0.4,45,50,-5,1.8841541587735409,0.0156030402407787,21,44
3423,relax_and_recompute,0.4,0,0,0,0.0,0.0,36,37
3424,relax_and_recompute,0.4,0,0,0,0.0,0.0,15,14
3425,relax_and_recompute,0.4,1,1,0,0.0,0.0,14,16
3426,relax_and_recompute,0.4,197,211,-14,1.6294158914226389,0.1952030013326532,61,119
3427,relax_and_recompute,0.4,0,0,0,0.0,0.0,19,20
3428,relax_and_recompute,0.4,0,0,0,0.0,0.0,22,22
3429,relax_and_recompute,0.4,0,0,0,0.0,0.0,54,58
3430,relax_and_recompute,0.4,651,651,0,0.0,0.0,65,135
3431,relax_and_recompute,0.4,1,1,0,0.0,0.0,16,18
3432,relax_and_recompute,0.4,7,7,0,0.0,0.0,17,27
3433,relax_and_recompute,0.4,22,4,18,-18.61747849085588,0.1446288399504806,54,71
3434,relax_and_recompute,0.4,0,2,-2,-69.51467976885004,-0.0285407675374049,23,22
3435,relax_and_recompute,0.4,1,0,1,76.88395716132196,-0.1491322016956315,13,16
3436,relax_and_recompute,0.4,155,149,6,-2.794184228530185,-0.0034415506621975,85,131
3437,relax_and_recompute,0.4,44,58,-14,6.627037203531586,0.0061263330641294,28,55
3438,relax_and_recompute,0.4,4,4,0,0.0,0.0,18,24
3439,relax_and_recompute,0.4,0,0,0,0.0,0.0,19,22
3440,relax_and_recompute,0.4,0,0,0,0.0,0.0,47,46
3441,relax_and_recompute,0.4,21,21,0,-3.6879171991704425,0.0716976646866419,39,64
3442,relax_and_recompute,0.4,0,0,0,0.0,0.0,17,18
3443,relax_and_recompute,0.4,1,1,0,0.0,0.0,23,24
3444,relax_and_recompute,0.4,2,2,0,0.0,0.0,13,16
3445,relax_and_recompute,0.4,22,22,0,0.0,0.0,40,56
3446,relax_and_recompute,0.4,1,1,0,0.0,0.0,10,15
3447,relax_and_recompute,0.4,0,0,0,0.0,0.0,21,20
3448,relax_and_recompute,0.4,4,4,0,0.0,0.0,30,35
3449,relax_and_recompute,0.4,1,1,0,0.0,0.0,71,77
3450,relax_one,0.4,0,0,0,0.0,0.0,17,18
3451,relax_one,0.4,1,1,0,0.0,0.0,43,48
3452,relax_one,0.4,3,3,0,0.0,0.0,38,45
3453,relax_one,0.4,0,0,0,0.0,0.0,12,12
3454,relax_one,0.4,20,18,2,-3.2752299140735204,0.0114158034923678,23,38
3455,relax_one,0.4,0,1,-1,-78.11694026732484,-0.0295512202700576,19,22
3456,relax_one,0.4,976,978,-2,0.1423455471242221,-0.0025418055405018,35,143
3457,relax_one,0.4,0,1,-1,-50.19567681247512,-0.0041327022016595,92,91
3458,relax_one,0.4,2,2,0,0.0,0.0,43,51
3459,relax_one,0.4,1,1,0,0.0,0.0,35,36
3460,relax_one,0.4,1,1,0,0.0,0.0,11,13
3461,relax_one,0.4,22,20,2,-3.01441643358082,0.0082886474985522,10,25
3462,relax_one,0.4,16,16,0,0.0,0.0,86,136
3463,relax_one,0.4,0,0,0,0.0,0.0,10,12
3464,relax_one,0.4,0,0,0,0.0,0.0,32,31
3465,relax_one,0.4,2,2,0,4.970962038347736,-0.0904350603192869,20,26
3466,relax_one,0.4,0,0,0,0.0,0.0,11,11
3467,relax_one,0.4,2,2,0,0.0,0.0,34,42
3468,relax_one,0.4,11,11,0,0.0,0.0,14,25
3469,relax_one,0.4,8,7,1,13.99583228956454,0.1582030612456263,31,46
3470,relax_one,0.4,0,0,0,0.0,0.0,42,45
3471,relax_one,0.4,1265,1240,25,0.1009906236120983,0.0001682713719424,39,173
3472,relax_one,0.4,11,11,0,0.0,0.0,14,24
3473,relax_one,0.4,0,0,0,0.0,0.0,24,25
3474,relax_one,0.4,2,2,0,0.0,0.0,12,19
3475,relax_one,0.4,59,59,0,0.4609819410147793,0.0044552421238692,41,72
3476,relax_one,0.4,182,191,-9,1.446975953367918,0.0358261975695221,59,115
3477,relax_one,0.4,6,6,0,0.0,0.0,32,37
3478,relax_one,0.4,1,1,0,0.0,0.0,20,20
3479,relax_one,0.4,41,32,9,2.305146048931391,0.0775874222420341,12,31
3480,relax_one,0.4,0,0,0,0.0,0.0,10,10
3481,relax_one,0.4,0,0,0,0.0,0.0,20,21
3482,relax_one,0.4,18,18,0,0.0,0.0,39,52
3483,relax_one,0.4,378,395,-17,-0.4859193577000411,-0.0010324457545943,42,109
3484,relax_one,0.4,1,1,0,0.0,0.0,25,28
3485,relax_one,0.4,170,170,0,0.0,0.0,56,106
3486,relax_one,0.4,567,595,-28,0.7834114754025379,-0.002967395777259,87,189
3487,relax_one,0.4,41,41,0,-3.1762323320181167,-0.0099859384844429,56,82
3488,relax_one,0.4,2,2,0,0.0,0.0,13,15
3489,relax_one,0.4,104,88,16,-3.3995451437074067,-0.111275141568526,36,63
3490,relax_one,0.4,0,0,0,0.0,0.0,16,15
3491,relax_one,0.4,0,0,0,0.0,0.0,67,66
3492,relax_one,0.4,13,13,0,0.0,0.0,42,60
3493,relax_one,0.4,0,0,0,0.0,0.0,39,38
3494,relax_one,0.4,8,8,0,0.0,0.0,20,36
3495,relax_one,0.4,0,0,0,0.0,0.0,10,9
3496,relax_one,0.4,1,1,0,0.0,0.0,13,15
3497,relax_one,0.4,6,7,-1,12.522285729298716,0.0299062089849014,34,41
3498,relax_one,0.4,3,3,0,0.0,0.0,37,42
3499,relax_one,0.4,36,36,0,0.0,0.0,18,29
3500,relax_one,0.4,0,0,0,0.0,0.0,23,22
3501,relax_one,0.4,0,0,0,0.0,0.0,13,12
3502,relax_one,0.4,0,0,0,0.0,0.0,15,14
3503,relax_one,0.4,0,0,0,0.0,0.0,69,68
3504,relax_one,0.4,0,0,0,0.0,0.0,40,39
3505,relax_one,0.4,0,0,0,0.0,0.0,89,93
3506,relax_one,0.4,13,13,0,-2.975681235416161,-0.0847204542309565,20,32
3507,relax_one,0.4,2,2,0,0.0,0.0,69,83
3508,relax_one,0.4,2,2,0,0.0,0.0,12,15
3509,relax_one,0.4,0,0,0,0.0,0.0,15,14
3510,relax_one,0.4,0,0,0,0.0,0.0,23,26
3511,relax_one,0.4,2,2,0,0.0,0.0,12,20
3512,relax_one,0.4,201,201,0,0.0,0.0,64,122
3513,relax_one,0.4,7,7,0,0.0,0.0,58,71
3514,relax_one,0.4,0,0,0,0.0,0.0,20,19
3515,relax_one,0.4,510,510,0,0.0060639005596385,-0.0006916839131552,100,191
3516,relax_one,0.4,34,34,0,0.0,0.0,41,61
3517,relax_one,0.4,33,34,-1,-0.6264707699284884,0.0331924782664471,13,31
3518,relax_one,0.4,5,5,0,0.0,0.0,10,15
3519,relax_one,0.4,6,6,0,0.0,0.0,37,47
3520,relax_one,0.4,0,0,0,0.0,0.0,21,21
3521,relax_one,0.4,0,0,0,0.0,0.0,11,10
3522,relax_one,0.4,57,55,2,-1.1796960984034186,9.734149291917849e-05,44,80
3523,relax_one,0.4,6,6,0,0.0,0.0,12,21
3524,relax_one,0.4,2,2,0,42.15913628345388,-0.0181760816329957,37,43
3525,relax_one,0.4,6,6,0,0.0,0.0,41,52
3526,relax_one,0.4,0,0,0,0.0,0.0,90,89
3527,relax_one,0.4,0,0,0,0.0,0.0,22,21
3528,relax_one,0.4,1,1,0,-4.213527745425694,0.0417394626549948,37,43
3529,relax_one,0.4,0,0,0,0.0,0.0,47,47
3530,relax_one,0.4,4,4,0,0.0,0.0,12,20
3531,relax_one,0.4,114,114,0,0.0,0.0,84,124
3532,relax_one,0.4,0,0,0,0.0,0.0,88,92
3533,relax_one,0.4,380,377,3,-0.3714807714610657,-0.0025427242202904,59,122
3534,relax_one,0.4,4,4,0,0.0,0.0,26,31
3535,relax_one,0.4,0,0,0,0.0,0.0,28,27
3536,relax_one,0.4,6,6,0,0.0,0.0,18,26
3537,relax_one,0.4,1,1,0,0.0,0.0,23,26
3538,relax_one,0.4,0,0,0,0.0,0.0,43,43
3539,relax_one,0.4,2,2,0,0.0,0.0,22,26
3540,relax_one,0.4,0,0,0,0.0,0.0,15,14
3541,relax_one,0.4,10,17,-7,3.5874123628873704,0.0856058777554238,36,48
3542,relax_one,0.4,6,6,0,2.8016025522275783,-0.3535412006642752,30,37
3543,relax_one,0.4,1,1,0,0.0,0.0,10,13
3544,relax_one,0.4,0,0,0,0.0,0.0,12,11
3545,relax_one,0.4,168,167,1,-0.7965879277094672,0.0475430066924907,55,105
3546,relax_one,0.4,1,1,0,17.12164821735773,0.0578261695456346,13,17
3547,relax_one,0.4,0,0,0,0.0,0.0,30,29
3548,relax_one,0.4,3,3,0,0.0,0.0,36,43
3549,relax_one,0.4,36,36,0,0.0,0.0,40,60
3550,relax_one,0.4,0,0,0,0.0,0.0,13,17
3551,relax_one,0.4,6,7,-1,-5.27235869178908,0.0082826452568239,23,30
3552,relax_one,0.4,0,0,0,0.0,0.0,12,16
3553,relax_one,0.4,0,0,0,0.0,0.0,26,26
3554,relax_one,0.4,0,0,0,0.0,0.0,22,31
3555,relax_one,0.4,0,0,0,0.0,0.0,68,68
3556,relax_one,0.4,0,0,0,0.0,0.0,23,22
3557,relax_one,0.4,0,0,0,0.0,-0.0348129737608335,43,42
3558,relax_one,0.4,0,0,0,0.0,0.0,18,17
3559,relax_one,0.4,3,3,0,0.0,0.0,28,42
3560,relax_one,0.4,45,45,0,0.1036479088850654,-0.0041754562964496,21,44
3561,relax_one,0.4,0,0,0,0.0,0.0,36,37
3562,relax_one,0.4,0,0,0,0.0,0.0,15,14
3563,relax_one,0.4,1,1,0,0.0,0.0,14,16
3564,relax_one,0.4,197,204,-7,3.484436282689749,0.1757315340586914,61,119
3565,relax_one,0.4,0,0,0,0.0,0.0,19,20
3566,relax_one,0.4,0,0,0,0.0,0.0,22,22
3567,relax_one,0.4,0,0,0,0.0,0.0,54,58
3568,relax_one,0.4,651,651,0,0.0,0.0,65,135
3569,relax_one,0.4,1,1,0,0.0,0.0,16,18
3570,relax_one,0.4,7,7,0,0.0,0.0,17,27
3571,relax_one,0.4,22,4,18,-19.06910671434205,0.1469333863626725,54,71
3572,relax_one,0.4,0,2,-2,-59.99819093035041,-0.0131455917893484,23,22
3573,relax_one,0.4,1,0,1,76.88395716132196,-0.1491322016956315,13,16
3574,relax_one,0.4,155,146,9,-2.3741667241416664,-0.001397205031107,85,131
3575,relax_one,0.4,44,44,0,0.0,0.0,28,55
3576,relax_one,0.4,4,4,0,0.0,0.0,18,24
3577,relax_one,0.4,0,0,0,0.0,0.0,19,22
3578,relax_one,0.4,0,0,0,0.0,0.0,47,46
3579,relax_one,0.4,21,19,2,-6.356920988253222,0.0143956759658575,39,64
3580,relax_one,0.4,0,0,0,0.0,0.0,17,18
3581,relax_one,0.4,1,1,0,0.0,0.0,23,24
3582,relax_one,0.4,2,2,0,0.0,0.0,13,16
3583,relax_one,0.4,22,22,0,0.0,0.0,40,56
3584,relax_one,0.4,1,1,0,0.0,0.0,10,15
3585,relax_one,0.4,0,0,0,0.0,0.0,21,20
3586,relax_one,0.4,4,4,0,0.0,0.0,30,35
3587,relax_one,0.4,1,1,0,0.0,0.0,71,77
3588,just_relax,0.4,0,0,0,0.0,-0.0091692815110081,17,18
3589,just_relax,0.4,1,1,0,0.0009607869158827,0.0014628518031132,43,48
3590,just_relax,0.4,3,3,0,-0.0019521681741139,-7.679999619569777e-05,38,45
3591,just_relax,0.4,0,0,0,0.0,-0.0037600566419999,12,12
3592,just_relax,0.4,20,14,6,1.9891400956483096,0.1544148745043621,23,38
3593,just_relax,0.4,0,1,-1,-78.11694026732484,-0.0295512202700576,19,22
3594,just_relax,0.4,976,1188,-212,1.3106081233515638,0.0257948127350838,35,143
3595,just_relax,0.4,0,4,-4,-39.1818408082167,-0.0156618414823971,92,91
3596,just_relax,0.4,2,2,0,-0.00041775540015,-0.0002552385505018,43,51
3597,just_relax,0.4,1,1,0,-0.0016870080925173,6.40249009676297e-05,35,36
3598,just_relax,0.4,1,1,0,-0.000156439410091,0.0002508982184644,11,13
3599,just_relax,0.4,22,24,-2,-3.49415891827384,0.1000113687896936,10,25
3600,just_relax,0.4,16,13,3,0.2088785180214571,-2.2771107622610032e-05,86,136
3601,just_relax,0.4,0,0,0,0.0,-1.765503840900351e-06,10,12
3602,just_relax,0.4,0,0,0,0.0,-1.014518260578079e-05,32,31
3603,just_relax,0.4,2,2,0,4.970962038347736,-0.0904350603192869,20,26
3604,just_relax,0.4,0,0,0,0.0,0.000269092021105,11,11
3605,just_relax,0.4,2,2,0,0.0009292844165713,-0.0008610890242942,34,42
3606,just_relax,0.4,11,11,0,-0.0003616788843885,0.0005035529702898,14,25
3607,just_relax,0.4,8,7,1,13.99583228956454,0.1582030612456263,31,46
3608,just_relax,0.4,0,0,0,0.0,0.0042083907430441,42,45
3609,just_relax,0.4,1265,1285,-20,2.6849459664833404,-0.1292871249874528,39,173
3610,just_relax,0.4,11,11,0,0.0001627700527109,0.0015600944076981,14,24
3611,just_relax,0.4,0,0,0,0.0,-0.000608053012485,24,25
3612,just_relax,0.4,2,2,0,-2.981324638540173e-05,0.0001440646714581,12,19
3613,just_relax,0.4,59,59,0,0.4609819410147793,0.0044552421238692,41,72
3614,just_relax,0.4,182,178,4,0.0313317398119608,0.0970080713564147,59,115
3615,just_relax,0.4,6,6,0,-0.0020404096920856,0.0011964290694836,32,37
3616,just_relax,0.4,1,0,1,64.5674534074053,-0.0013228453280204,20,20
3617,just_relax,0.4,41,33,8,8.182357833947279,-0.009895766072516,12,31
3618,just_relax,0.4,0,0,0,0.0,-1.5942199658169898e-06,10,10
3619,just_relax,0.4,0,0,0,0.0,0.0018153466622625,20,21
3620,just_relax,0.4,18,18,0,0.0003589278580733,-0.0005865039043362,39,52
3621,just_relax,0.4,378,369,9,2.979528253482861,0.0835817869771829,42,109
3622,just_relax,0.4,1,1,0,-0.0010366044558338,-5.546321229055184e-05,25,28
3623,just_relax,0.4,170,170,0,-0.0002769762706833,-0.0005002245004087,56,106
3624,just_relax,0.4,567,521,46,-0.2657392120378574,0.1239070997048957,87,189
3625,just_relax,0.4,41,43,-2,2.499128887843675,-0.033528056765164,56,82
3626,just_relax,0.4,2,2,0,0.0004861774901456,1.2071037781558047e-06,13,15
3627,just_relax,0.4,104,86,18,5.26724471872344,-0.2840091449765524,36,63
3628,just_relax,0.4,0,0,0,0.0,4.3915154694929015e-06,16,15
3629,just_relax,0.4,0,0,0,0.0,-5.223096419815221e-07,67,66
3630,just_relax,0.4,13,13,0,0.0024384647237383,0.004260897920215,42,60
3631,just_relax,0.4,0,0,0,0.0,0.0005903979895692,39,38
3632,just_relax,0.4,8,8,0,-3.330899971842882e-05,0.0005334774465118,20,36
3633,just_relax,0.4,0,0,0,0.0,-0.0010596071395927,10,9
3634,just_relax,0.4,1,1,0,0.0009644178095271,-1.805181839154013e-05,13,15
3635,just_relax,0.4,6,7,-1,12.522285729298716,0.0299062089849014,34,41
3636,just_relax,0.4,3,3,0,-0.0014185667246167,0.0006213779664755,37,42
3637,just_relax,0.4,36,36,0,7.196136941445275e-06,5.025038399830706e-06,18,29
3638,just_relax,0.4,0,0,0,0.0,-0.0031405837993232,23,22
3639,just_relax,0.4,0,0,0,0.0,1.0504657718901632e-05,13,12
3640,just_relax,0.4,0,0,0,0.0,-0.0007613272869088,15,14
3641,just_relax,0.4,0,0,0,0.0,-0.0017207203528439,69,68
3642,just_relax,0.4,0,0,0,0.0,0.001934163275203,40,39
3643,just_relax,0.4,0,0,0,0.0,0.0016954512903432,89,93
3644,just_relax,0.4,13,13,0,1.511050374969713,-0.0878570612978808,20,32
3645,just_relax,0.4,2,3,-1,-4.120223819609976,0.0096644512108772,69,83
3646,just_relax,0.4,2,2,0,0.0006766545457281,-0.0007958153584334,12,15
3647,just_relax,0.4,0,0,0,0.0,-0.0009758471183408,15,14
3648,just_relax,0.4,0,0,0,0.0,-0.0007570529942456,23,26
3649,just_relax,0.4,2,2,0,-0.0004670837519427,-0.000552899751354,12,20
3650,just_relax,0.4,201,201,0,-5.927609844036397e-05,0.0001073571901385,64,122
3651,just_relax,0.4,7,7,0,-0.0099055150386959,0.0003544031231826,58,71
3652,just_relax,0.4,0,0,0,0.0,-0.0013086772972689,20,19
3653,just_relax,0.4,510,505,5,-0.1096058695008466,0.0001562332230281,100,191
3654,just_relax,0.4,34,34,0,0.0046498502251353,3.462795885833536e-05,41,61
3655,just_relax,0.4,33,21,12,-0.322372772893118,0.0487025778316814,13,31
3656,just_relax,0.4,5,5,0,0.0003476406123752,0.0002826333043987,10,15
3657,just_relax,0.4,6,6,0,-0.0004254358946269,0.0003115870201488,37,47
3658,just_relax,0.4,0,0,0,0.0,0.0007350584472026,21,21
3659,just_relax,0.4,0,0,0,0.0,9.621758975453254e-06,11,10
3660,just_relax,0.4,57,55,2,-1.1796960984034186,9.734149291917849e-05,44,80
3661,just_relax,0.4,6,6,0,0.0001929725905256,-1.6711583069151104e-05,12,21
3662,just_relax,0.4,2,5,-3,10.477360070400792,-0.0167672873232497,37,43
3663,just_relax,0.4,6,6,0,-9.27967616917158e-05,0.0005867078171852,41,52
3664,just_relax,0.4,0,0,0,0.0,0.0258238191424075,90,89
3665,just_relax,0.4,0,0,0,0.0,-0.0001762041220683,22,21
3666,just_relax,0.4,1,5,-4,-25.99394547658536,0.034397478016983,37,43
3667,just_relax,0.4,0,0,0,0.0,0.009279908390236,47,47
3668,just_relax,0.4,4,4,0,-0.0003372893218767,-9.212772776878708e-07,12,20
3669,just_relax,0.4,114,95,19,0.8287298242191525,-0.006531385777559,84,124
3670,just_relax,0.4,0,0,0,0.0,0.0016708237920683,88,92
3671,just_relax,0.4,380,332,48,-1.681066658089314,0.0270328691740772,59,122
3672,just_relax,0.4,4,4,0,2.0677824380754828e-05,-0.000363330475558,26,31
3673,just_relax,0.4,0,0,0,0.0,4.418930553695688e-06,28,27
3674,just_relax,0.4,6,6,0,0.0013890930604816,7.243956427815945e-06,18,26
3675,just_relax,0.4,1,1,0,-0.0014241348598034,0.001861633846505,23,26
3676,just_relax,0.4,0,0,0,0.0,0.0001814651838247,43,43
3677,just_relax,0.4,2,2,0,0.0004949068667485,0.0012137972461528,22,26
3678,just_relax,0.4,0,0,0,0.0,8.316094011640018e-06,15,14
3679,just_relax,0.4,10,17,-7,3.5874123628873704,0.0856058777554238,36,48
3680,just_relax,0.4,6,6,0,2.8016025522275783,-0.3535412006642752,30,37
3681,just_relax,0.4,1,1,0,5.455328151526828e-05,-4.433967369288361e-05,10,13
3682,just_relax,0.4,0,0,0,0.0,-0.0049855760382295,12,11
3683,just_relax,0.4,168,182,-14,1.1771250480206064,-0.0267800915114647,55,105
3684,just_relax,0.4,1,1,0,17.12164821735773,0.0578261695456346,13,17
3685,just_relax,0.4,0,0,0,0.0,0.0003329515887838,30,29
3686,just_relax,0.4,3,3,0,0.000583815366788,0.0008768881680062,36,43
3687,just_relax,0.4,36,36,0,0.0010314806767866,-5.393936385500453e-05,40,60
3688,just_relax,0.4,0,0,0,0.0,0.0017894746066188,13,17
3689,just_relax,0.4,6,7,-1,-5.27235869178908,0.0082826452568239,23,30
3690,just_relax,0.4,0,0,0,0.0,-2.940409977925107e-05,12,16
3691,just_relax,0.4,0,0,0,0.0,3.901708024223183e-06,26,26
3692,just_relax,0.4,0,0,0,0.0,-0.0031688166024113,22,31
3693,just_relax,0.4,0,0,0,0.0,0.0008768193667615,68,68
3694,just_relax,0.4,0,0,0,0.0,-7.938175057398134e-06,23,22
3695,just_relax,0.4,0,0,0,0.0,-0.065399188004364,43,42
3696,just_relax,0.4,0,0,0,0.0,-0.002899723134464,18,17
3697,just_relax,0.4,3,3,0,-0.003194586812441,0.0012605153222713,28,42
3698,just_relax,0.4,45,58,-13,0.9231299892006462,0.088218433779717,21,44
3699,just_relax,0.4,0,0,0,0.0,-0.0112811671875761,36,37
3700,just_relax,0.4,0,0,0,0.0,-3.4878924121017896e-05,15,14
3701,just_relax,0.4,1,1,0,-0.0014549239964907,-0.00058525619921,14,16
3702,just_relax,0.4,197,237,-40,1.3477492998050025,0.0885093784332623,61,119
3703,just_relax,0.4,0,0,0,0.0,-0.0038599581671643,19,20
3704,just_relax,0.4,0,0,0,0.0,-0.0006472841631984,22,22
3705,just_relax,0.4,0,0,0,0.0,-0.0011415137972972,54,58
3706,just_relax,0.4,651,651,0,-0.0003954210755097,0.0002252638081207,65,135
3707,just_relax,0.4,1,1,0,-0.0029471577812358,0.0001749400264638,16,18
3708,just_relax,0.4,7,7,0,0.0002013814076775,0.0006636994664107,17,27
3709,just_relax,0.4,22,7,15,-12.985895473169307,0.1330374466905183,54,71
3710,just_relax,0.4,0,2,-2,-59.99819093035041,-0.0131455917893484,23,22
3711,just_relax,0.4,1,0,1,76.88395716132196,-0.1491322016956315,13,16
3712,just_relax,0.4,155,185,-30,2.3843149677438973,-0.02495720013905,85,131
3713,just_relax,0.4,44,44,0,0.0003032918935019,0.0025857794052007,28,55
3714,just_relax,0.4,4,4,0,-0.0007096785766407,-5.4537984728875166e-05,18,24
3715,just_relax,0.4,0,0,0,0.0,-0.003226028074061,19,22
3716,just_relax,0.4,0,0,0,0.0,0.0048197166778652,47,46
3717,just_relax,0.4,21,27,-6,0.0602947270368474,-0.3310372682946312,39,64
3718,just_relax,0.4,0,0,0,0.0,-0.0037052423868473,17,18
3719,just_relax,0.4,1,1,0,0.0005119856857191,0.0004745196477359,23,24
3720,just_relax,0.4,2,2,0,0.0010275548569325,-0.004970471779609,13,16
3721,just_relax,0.4,22,22,0,0.0038770082111057,0.0004285387996507,40,56
3722,just_relax,0.4,1,1,0,-0.0002865966515059,-0.0003325971221349,10,15
3723,just_relax,0.4,0,0,0,0.0,0.0003384089422906,21,20
3724,just_relax,0.4,4,4,0,-0.0001029723687508,-0.0013906355929786,30,35
3725,just_relax,0.4,1,1,0,0.0051043410712594,-0.0056156512673798,71,77
3726,relax_and_recompute,0.45,0,0,0,0.0,0.0,17,18
3727,relax_and_recompute,0.45,1,1,0,0.0,0.0,43,48
3728,relax_and_recompute,0.45,3,3,0,0.0,0.0,38,45
3729,relax_and_recompute,0.45,0,0,0,0.0,0.0,12,12
3730,relax_and_recompute,0.45,20,7,13,1.502478168846423,0.2029862696446577,23,38
3731,relax_and_recompute,0.45,0,1,-1,-78.11694026732484,-0.0295512202700576,19,22
3732,relax_and_recompute,0.45,976,1004,-28,-0.0620531910963606,-0.0009330148689207,35,143
3733,relax_and_recompute,0.45,0,0,0,0.0,-0.0046858462976494,92,91
3734,relax_and_recompute,0.45,2,2,0,0.0,0.0,43,51
3735,relax_and_recompute,0.45,1,1,0,0.0,0.0,35,36
3736,relax_and_recompute,0.45,1,1,0,0.0,0.0,11,13
3737,relax_and_recompute,0.45,22,19,3,-4.957652547927751,0.037406937188411,10,25
3738,relax_and_recompute,0.45,16,16,0,-1.2375805476415778,-0.0662978026850604,86,136
3739,relax_and_recompute,0.45,0,0,0,0.0,0.0,10,12
3740,relax_and_recompute,0.45,0,0,0,0.0,0.0,32,31
3741,relax_and_recompute,0.45,2,2,0,4.970962038347736,-0.0904350603192869,20,26
3742,relax_and_recompute,0.45,0,0,0,0.0,0.0,11,11
3743,relax_and_recompute,0.45,2,2,0,0.0,0.0,34,42
3744,relax_and_recompute,0.45,11,11,0,0.0,0.0,14,25
3745,relax_and_recompute,0.45,8,7,1,13.99583228956454,0.1582030612456263,31,46
3746,relax_and_recompute,0.45,0,0,0,0.0,0.0,42,45
3747,relax_and_recompute,0.45,1265,1233,32,-0.0829886923942524,-0.0013136328692162,39,173
3748,relax_and_recompute,0.45,11,11,0,0.0,0.0,14,24
3749,relax_and_recompute,0.45,0,0,0,0.0,0.0,24,25
3750,relax_and_recompute,0.45,2,2,0,0.0,0.0,12,19
3751,relax_and_recompute,0.45,59,59,0,0.4609819410147793,0.0044552421238692,41,72
3752,relax_and_recompute,0.45,182,192,-10,2.176227062990442,0.127488881317396,59,115
3753,relax_and_recompute,0.45,6,4,2,3.758843121777289,0.465210734665941,32,37
3754,relax_and_recompute,0.45,1,1,0,0.0,0.0,20,20
3755,relax_and_recompute,0.45,41,26,15,-1.6275846340626714,0.0729158968985802,12,31
3756,relax_and_recompute,0.45,0,0,0,0.0,0.0,10,10
3757,relax_and_recompute,0.45,0,0,0,0.0,0.0,20,21
3758,relax_and_recompute,0.45,18,17,1,-2.730022024646217,0.3488913167094044,39,52
3759,relax_and_recompute,0.45,378,393,-15,0.6108526484877643,4.422482210819645e-05,42,109
3760,relax_and_recompute,0.45,1,1,0,0.0,0.0,25,28
3761,relax_and_recompute,0.45,170,157,13,-3.523679109137184,0.105536041898159,56,106
3762,relax_and_recompute,0.45,567,575,-8,0.4383057260994292,-0.0017656065849445,87,189
3763,relax_and_recompute,0.45,41,40,1,-2.249384452446378,-0.0072514307594979,56,82
3764,relax_and_recompute,0.45,2,2,0,0.0,0.0,13,15
3765,relax_and_recompute,0.45,104,88,16,-3.3995451437074067,-0.111275141568526,36,63
3766,relax_and_recompute,0.45,0,0,0,0.0,0.0,16,15
3767,relax_and_recompute,0.45,0,0,0,0.0,0.0,67,66
3768,relax_and_recompute,0.45,13,13,0,0.0,0.0,42,60
3769,relax_and_recompute,0.45,0,0,0,0.0,0.0,39,38
3770,relax_and_recompute,0.45,8,8,0,0.0,0.0,20,36
3771,relax_and_recompute,0.45,0,0,0,0.0,0.0,10,9
3772,relax_and_recompute,0.45,1,1,0,0.0,0.0,13,15
3773,relax_and_recompute,0.45,6,14,-8,18.824286639655867,-0.0841754274640885,34,41
3774,relax_and_recompute,0.45,3,3,0,0.0,0.0,37,42
3775,relax_and_recompute,0.45,36,36,0,0.0,0.0,18,29
3776,relax_and_recompute,0.45,0,0,0,0.0,0.0,23,22
3777,relax_and_recompute,0.45,0,0,0,0.0,0.0,13,12
3778,relax_and_recompute,0.45,0,0,0,0.0,0.0,15,14
3779,relax_and_recompute,0.45,0,0,0,0.0,0.0,69,68
3780,relax_and_recompute,0.45,0,0,0,0.0,0.0,40,39
3781,relax_and_recompute,0.45,0,0,0,0.0,0.0,89,93
3782,relax_and_recompute,0.45,13,13,0,-2.975681235416161,-0.0847204542309565,20,32
3783,relax_and_recompute,0.45,2,2,0,0.0,0.0,69,83
3784,relax_and_recompute,0.45,2,2,0,0.0,0.0,12,15
3785,relax_and_recompute,0.45,0,0,0,0.0,0.0,15,14
3786,relax_and_recompute,0.45,0,0,0,0.0,0.0,23,26
3787,relax_and_recompute,0.45,2,2,0,0.0,0.0,12,20
3788,relax_and_recompute,0.45,201,208,-7,-0.777546499391029,-0.0168449909220319,64,122
3789,relax_and_recompute,0.45,7,3,4,-15.3477275810384,-0.0042339303565398,58,71
3790,relax_and_recompute,0.45,0,0,0,0.0,-0.1147932957929044,20,19
3791,relax_and_recompute,0.45,510,512,-2,-0.0138388627329746,-0.001793654381577,100,191
3792,relax_and_recompute,0.45,34,34,0,0.0,0.0,41,61
3793,relax_and_recompute,0.45,33,34,-1,-0.5384989905164446,0.0398816997391653,13,31
3794,relax_and_recompute,0.45,5,5,0,0.0,0.0,10,15
3795,relax_and_recompute,0.45,6,6,0,0.0,0.0,37,47
3796,relax_and_recompute,0.45,0,0,0,0.0,-0.0047120123517853,21,21
3797,relax_and_recompute,0.45,0,0,0,0.0,0.0,11,10
3798,relax_and_recompute,0.45,57,57,0,0.0064914760634735,-0.0077421754008314,44,80
3799,relax_and_recompute,0.45,6,6,0,0.0,0.0,12,21
3800,relax_and_recompute,0.45,2,2,0,40.57817790180843,-0.0379305285754828,37,43
3801,relax_and_recompute,0.45,6,6,0,0.0,0.0,41,52
3802,relax_and_recompute,0.45,0,0,0,0.0,0.0,90,89
3803,relax_and_recompute,0.45,0,0,0,0.0,0.0,22,21
3804,relax_and_recompute,0.45,1,6,-5,-12.824308725883805,-0.0280060439235303,37,43
3805,relax_and_recompute,0.45,0,0,0,0.0,0.0,47,47
3806,relax_and_recompute,0.45,4,4,0,0.0,0.0,12,20
3807,relax_and_recompute,0.45,114,114,0,0.0,0.0,84,124
3808,relax_and_recompute,0.45,0,0,0,0.0,0.0,88,92
3809,relax_and_recompute,0.45,380,377,3,-0.3714807714610657,-0.0025427242202904,59,122
3810,relax_and_recompute,0.45,4,4,0,0.0,0.0,26,31
3811,relax_and_recompute,0.45,0,0,0,0.0,0.0,28,27
3812,relax_and_recompute,0.45,6,6,0,0.0,0.0,18,26
3813,relax_and_recompute,0.45,1,1,0,0.0,0.0,23,26
3814,relax_and_recompute,0.45,0,0,0,0.0,0.0,43,43
3815,relax_and_recompute,0.45,2,2,0,0.0,0.0,22,26
3816,relax_and_recompute,0.45,0,0,0,0.0,0.0,15,14
3817,relax_and_recompute,0.45,10,17,-7,3.5874123628873704,0.0856058777554238,36,48
3818,relax_and_recompute,0.45,6,6,0,2.8016025522275783,-0.3535412006642752,30,37
3819,relax_and_recompute,0.45,1,1,0,0.0,0.0,10,13
3820,relax_and_recompute,0.45,0,0,0,0.0,0.0,12,11
3821,relax_and_recompute,0.45,168,153,15,-1.4597591062543387,0.1638614131178267,55,105
3822,relax_and_recompute,0.45,1,1,0,17.12164821735773,0.0578261695456346,13,17
3823,relax_and_recompute,0.45,0,0,0,0.0,0.0,30,29
3824,relax_and_recompute,0.45,3,3,0,0.0,0.0,36,43
3825,relax_and_recompute,0.45,36,36,0,0.0,0.0,40,60
3826,relax_and_recompute,0.45,0,0,0,0.0,0.0,13,17
3827,relax_and_recompute,0.45,6,8,-2,-4.960402959672933,-0.0115319394462201,23,30
3828,relax_and_recompute,0.45,0,0,0,0.0,0.0,12,16
3829,relax_and_recompute,0.45,0,0,0,0.0,0.0,26,26
3830,relax_and_recompute,0.45,0,0,0,0.0,0.0,22,31
3831,relax_and_recompute,0.45,0,0,0,0.0,0.0,68,68
3832,relax_and_recompute,0.45,0,0,0,0.0,0.0,23,22
3833,relax_and_recompute,0.45,0,0,0,0.0,-0.0349525596057489,43,42
3834,relax_and_recompute,0.45,0,0,0,0.0,0.0,18,17
3835,relax_and_recompute,0.45,3,1,2,13.207521286203315,-0.0569455074315961,28,42
3836,relax_and_recompute,0.45,45,50,-5,1.8841541587735409,0.0156030402407787,21,44
3837,relax_and_recompute,0.45,0,0,0,0.0,0.0,36,37
3838,relax_and_recompute,0.45,0,0,0,0.0,0.0,15,14
3839,relax_and_recompute,0.45,1,1,0,0.0,0.0,14,16
3840,relax_and_recompute,0.45,197,211,-14,1.6294158914226389,0.1952030013326532,61,119
3841,relax_and_recompute,0.45,0,0,0,0.0,0.0,19,20
3842,relax_and_recompute,0.45,0,0,0,0.0,0.0,22,22
3843,relax_and_recompute,0.45,0,0,0,0.0,0.0,54,58
3844,relax_and_recompute,0.45,651,651,0,0.0,0.0,65,135
3845,relax_and_recompute,0.45,1,1,0,0.0,0.0,16,18
3846,relax_and_recompute,0.45,7,7,0,0.0,0.0,17,27
3847,relax_and_recompute,0.45,22,4,18,-18.61747849085588,0.1446288399504806,54,71
3848,relax_and_recompute,0.45,0,2,-2,-59.99819093035041,-0.0131455917893484,23,22
3849,relax_and_recompute,0.45,1,0,1,76.88395716132196,-0.1491322016956315,13,16
3850,relax_and_recompute,0.45,155,149,6,-2.794184228530185,-0.0034415506621975,85,131
3851,relax_and_recompute,0.45,44,44,0,0.0,0.0,28,55
3852,relax_and_recompute,0.45,4,4,0,0.0,0.0,18,24
3853,relax_and_recompute,0.45,0,0,0,0.0,0.0,19,22
3854,relax_and_recompute,0.45,0,0,0,0.0,0.0,47,46
3855,relax_and_recompute,0.45,21,19,2,-6.356920988253222,0.0143956759658575,39,64
3856,relax_and_recompute,0.45,0,0,0,0.0,0.0,17,18
3857,relax_and_recompute,0.45,1,1,0,0.0,0.0,23,24
3858,relax_and_recompute,0.45,2,2,0,0.0,0.0,13,16
3859,relax_and_recompute,0.45,22,22,0,0.0,0.0,40,56
3860,relax_and_recompute,0.45,1,1,0,0.0,0.0,10,15
3861,relax_and_recompute,0.45,0,0,0,0.0,0.0,21,20
3862,relax_and_recompute,0.45,4,4,0,0.0,0.0,30,35
3863,relax_and_recompute,0.45,1,1,0,0.0,0.0,71,77
3864,relax_one,0.45,0,0,0,0.0,0.0,17,18
3865,relax_one,0.45,1,1,0,0.0,0.0,43,48
3866,relax_one,0.45,3,3,0,0.0,0.0,38,45
3867,relax_one,0.45,0,0,0,0.0,0.0,12,12
3868,relax_one,0.45,20,18,2,-3.2752299140735204,0.0114158034923678,23,38
3869,relax_one,0.45,0,1,-1,-78.11694026732484,-0.0295512202700576,19,22
3870,relax_one,0.45,976,978,-2,0.1423455471242221,-0.0025418055405018,35,143
3871,relax_one,0.45,0,1,-1,-50.19567681247512,-0.0041327022016595,92,91
3872,relax_one,0.45,2,2,0,0.0,0.0,43,51
3873,relax_one,0.45,1,1,0,0.0,0.0,35,36
3874,relax_one,0.45,1,1,0,0.0,0.0,11,13
3875,relax_one,0.45,22,20,2,-3.01441643358082,0.0082886474985522,10,25
3876,relax_one,0.45,16,16,0,0.0,0.0,86,136
3877,relax_one,0.45,0,0,0,0.0,0.0,10,12
3878,relax_one,0.45,0,0,0,0.0,0.0,32,31
3879,relax_one,0.45,2,2,0,4.970962038347736,-0.0904350603192869,20,26
3880,relax_one,0.45,0,0,0,0.0,0.0,11,11
3881,relax_one,0.45,2,2,0,0.0,0.0,34,42
3882,relax_one,0.45,11,11,0,0.0,0.0,14,25
3883,relax_one,0.45,8,7,1,13.99583228956454,0.1582030612456263,31,46
3884,relax_one,0.45,0,0,0,0.0,0.0,42,45
3885,relax_one,0.45,1265,1240,25,0.1009906236120983,0.0001682713719424,39,173
3886,relax_one,0.45,11,11,0,0.0,0.0,14,24
3887,relax_one,0.45,0,0,0,0.0,0.0,24,25
3888,relax_one,0.45,2,2,0,0.0,0.0,12,19
3889,relax_one,0.45,59,59,0,0.4609819410147793,0.0044552421238692,41,72
3890,relax_one,0.45,182,191,-9,1.446975953367918,0.0358261975695221,59,115
3891,relax_one,0.45,6,6,0,0.0,0.0,32,37
3892,relax_one,0.45,1,1,0,0.0,0.0,20,20
3893,relax_one,0.45,41,32,9,2.305146048931391,0.0775874222420341,12,31
3894,relax_one,0.45,0,0,0,0.0,0.0,10,10
3895,relax_one,0.45,0,0,0,0.0,0.0,20,21
3896,relax_one,0.45,18,18,0,0.0,0.0,39,52
3897,relax_one,0.45,378,395,-17,-0.4859193577000411,-0.0010324457545943,42,109
3898,relax_one,0.45,1,1,0,0.0,0.0,25,28
3899,relax_one,0.45,170,170,0,0.0,0.0,56,106
3900,relax_one,0.45,567,595,-28,0.7834114754025379,-0.002967395777259,87,189
3901,relax_one,0.45,41,41,0,-3.1762323320181167,-0.0099859384844429,56,82
3902,relax_one,0.45,2,2,0,0.0,0.0,13,15
3903,relax_one,0.45,104,88,16,-3.3995451437074067,-0.111275141568526,36,63
3904,relax_one,0.45,0,0,0,0.0,0.0,16,15
3905,relax_one,0.45,0,0,0,0.0,0.0,67,66
3906,relax_one,0.45,13,13,0,0.0,0.0,42,60
3907,relax_one,0.45,0,0,0,0.0,0.0,39,38
3908,relax_one,0.45,8,8,0,0.0,0.0,20,36
3909,relax_one,0.45,0,0,0,0.0,0.0,10,9
3910,relax_one,0.45,1,1,0,0.0,0.0,13,15
3911,relax_one,0.45,6,7,-1,12.522285729298716,0.0299062089849014,34,41
3912,relax_one,0.45,3,3,0,0.0,0.0,37,42
3913,relax_one,0.45,36,36,0,0.0,0.0,18,29
3914,relax_one,0.45,0,0,0,0.0,0.0,23,22
3915,relax_one,0.45,0,0,0,0.0,0.0,13,12
3916,relax_one,0.45,0,0,0,0.0,0.0,15,14
3917,relax_one,0.45,0,0,0,0.0,0.0,69,68
3918,relax_one,0.45,0,0,0,0.0,0.0,40,39
3919,relax_one,0.45,0,0,0,0.0,0.0,89,93
3920,relax_one,0.45,13,13,0,-2.975681235416161,-0.0847204542309565,20,32
3921,relax_one,0.45,2,2,0,0.0,0.0,69,83
3922,relax_one,0.45,2,2,0,0.0,0.0,12,15
3923,relax_one,0.45,0,0,0,0.0,0.0,15,14
3924,relax_one,0.45,0,0,0,0.0,0.0,23,26
3925,relax_one,0.45,2,2,0,0.0,0.0,12,20
3926,relax_one,0.45,201,201,0,0.0,0.0,64,122
3927,relax_one,0.45,7,7,0,0.0,0.0,58,71
3928,relax_one,0.45,0,0,0,0.0,0.0,20,19
3929,relax_one,0.45,510,510,0,0.0060639005596385,-0.0006916839131552,100,191
3930,relax_one,0.45,34,34,0,0.0,0.0,41,61
3931,relax_one,0.45,33,34,-1,-0.6264707699284884,0.0331924782664471,13,31
3932,relax_one,0.45,5,5,0,0.0,0.0,10,15
3933,relax_one,0.45,6,6,0,0.0,0.0,37,47
3934,relax_one,0.45,0,0,0,0.0,0.0,21,21
3935,relax_one,0.45,0,0,0,0.0,0.0,11,10
3936,relax_one,0.45,57,55,2,-1.1796960984034186,9.734149291917849e-05,44,80
3937,relax_one,0.45,6,6,0,0.0,0.0,12,21
3938,relax_one,0.45,2,2,0,42.15913628345388,-0.0181760816329957,37,43
3939,relax_one,0.45,6,6,0,0.0,0.0,41,52
3940,relax_one,0.45,0,0,0,0.0,0.0,90,89
3941,relax_one,0.45,0,0,0,0.0,0.0,22,21
3942,relax_one,0.45,1,1,0,-4.213527745425694,0.0417394626549948,37,43
3943,relax_one,0.45,0,0,0,0.0,0.0,47,47
3944,relax_one,0.45,4,4,0,0.0,0.0,12,20
3945,relax_one,0.45,114,114,0,0.0,0.0,84,124
3946,relax_one,0.45,0,0,0,0.0,0.0,88,92
3947,relax_one,0.45,380,377,3,-0.3714807714610657,-0.0025427242202904,59,122
3948,relax_one,0.45,4,4,0,0.0,0.0,26,31
3949,relax_one,0.45,0,0,0,0.0,0.0,28,27
3950,relax_one,0.45,6,6,0,0.0,0.0,18,26
3951,relax_one,0.45,1,1,0,0.0,0.0,23,26
3952,relax_one,0.45,0,0,0,0.0,0.0,43,43
3953,relax_one,0.45,2,2,0,0.0,0.0,22,26
3954,relax_one,0.45,0,0,0,0.0,0.0,15,14
3955,relax_one,0.45,10,17,-7,3.5874123628873704,0.0856058777554238,36,48
3956,relax_one,0.45,6,6,0,2.8016025522275783,-0.3535412006642752,30,37
3957,relax_one,0.45,1,1,0,0.0,0.0,10,13
3958,relax_one,0.45,0,0,0,0.0,0.0,12,11
3959,relax_one,0.45,168,167,1,-0.7965879277094672,0.0475430066924907,55,105
3960,relax_one,0.45,1,1,0,17.12164821735773,0.0578261695456346,13,17
3961,relax_one,0.45,0,0,0,0.0,0.0,30,29
3962,relax_one,0.45,3,3,0,0.0,0.0,36,43
3963,relax_one,0.45,36,36,0,0.0,0.0,40,60
3964,relax_one,0.45,0,0,0,0.0,0.0,13,17
3965,relax_one,0.45,6,7,-1,-5.27235869178908,0.0082826452568239,23,30
3966,relax_one,0.45,0,0,0,0.0,0.0,12,16
3967,relax_one,0.45,0,0,0,0.0,0.0,26,26
3968,relax_one,0.45,0,0,0,0.0,0.0,22,31
3969,relax_one,0.45,0,0,0,0.0,0.0,68,68
3970,relax_one,0.45,0,0,0,0.0,0.0,23,22
3971,relax_one,0.45,0,0,0,0.0,-0.0348129737608335,43,42
3972,relax_one,0.45,0,0,0,0.0,0.0,18,17
3973,relax_one,0.45,3,3,0,0.0,0.0,28,42
3974,relax_one,0.45,45,45,0,0.1036479088850654,-0.0041754562964496,21,44
3975,relax_one,0.45,0,0,0,0.0,0.0,36,37
3976,relax_one,0.45,0,0,0,0.0,0.0,15,14
3977,relax_one,0.45,1,1,0,0.0,0.0,14,16
3978,relax_one,0.45,197,204,-7,3.484436282689749,0.1757315340586914,61,119
3979,relax_one,0.45,0,0,0,0.0,0.0,19,20
3980,relax_one,0.45,0,0,0,0.0,0.0,22,22
3981,relax_one,0.45,0,0,0,0.0,0.0,54,58
3982,relax_one,0.45,651,651,0,0.0,0.0,65,135
3983,relax_one,0.45,1,1,0,0.0,0.0,16,18
3984,relax_one,0.45,7,7,0,0.0,0.0,17,27
3985,relax_one,0.45,22,4,18,-19.06910671434205,0.1469333863626725,54,71
3986,relax_one,0.45,0,2,-2,-59.99819093035041,-0.0131455917893484,23,22
3987,relax_one,0.45,1,0,1,76.88395716132196,-0.1491322016956315,13,16
3988,relax_one,0.45,155,146,9,-2.3741667241416664,-0.001397205031107,85,131
3989,relax_one,0.45,44,44,0,0.0,0.0,28,55
3990,relax_one,0.45,4,4,0,0.0,0.0,18,24
3991,relax_one,0.45,0,0,0,0.0,0.0,19,22
3992,relax_one,0.45,0,0,0,0.0,0.0,47,46
3993,relax_one,0.45,21,19,2,-6.356920988253222,0.0143956759658575,39,64
3994,relax_one,0.45,0,0,0,0.0,0.0,17,18
3995,relax_one,0.45,1,1,0,0.0,0.0,23,24
3996,relax_one,0.45,2,2,0,0.0,0.0,13,16
3997,relax_one,0.45,22,22,0,0.0,0.0,40,56
3998,relax_one,0.45,1,1,0,0.0,0.0,10,15
3999,relax_one,0.45,0,0,0,0.0,0.0,21,20
4000,relax_one,0.45,4,4,0,0.0,0.0,30,35
4001,relax_one,0.45,1,1,0,0.0,0.0,71,77
4002,just_relax,0.45,0,0,0,0.0,-0.0091692815110081,17,18
4003,just_relax,0.45,1,1,0,0.0009607869158827,0.0014628518031132,43,48
4004,just_relax,0.45,3,3,0,-0.0019521681741139,-7.679999619569777e-05,38,45
4005,just_relax,0.45,0,0,0,0.0,-0.0037600566419999,12,12
4006,just_relax,0.45,20,14,6,1.9891400956483096,0.1544148745043621,23,38
4007,just_relax,0.45,0,1,-1,-78.11694026732484,-0.0295512202700576,19,22
4008,just_relax,0.45,976,1188,-212,1.3106081233515638,0.0257948127350838,35,143
4009,just_relax,0.45,0,4,-4,-39.1818408082167,-0.0156618414823971,92,91
4010,just_relax,0.45,2,2,0,-0.00041775540015,-0.0002552385505018,43,51
4011,just_relax,0.45,1,1,0,-0.0016870080925173,6.40249009676297e-05,35,36
4012,just_relax,0.45,1,1,0,-0.000156439410091,0.0002508982184644,11,13
4013,just_relax,0.45,22,24,-2,-3.49415891827384,0.1000113687896936,10,25
4014,just_relax,0.45,16,13,3,0.2088785180214571,-2.2771107622610032e-05,86,136
4015,just_relax,0.45,0,0,0,0.0,-1.765503840900351e-06,10,12
4016,just_relax,0.45,0,0,0,0.0,-1.014518260578079e-05,32,31
4017,just_relax,0.45,2,2,0,4.970962038347736,-0.0904350603192869,20,26
4018,just_relax,0.45,0,0,0,0.0,0.000269092021105,11,11
4019,just_relax,0.45,2,2,0,0.0009292844165713,-0.0008610890242942,34,42
4020,just_relax,0.45,11,11,0,-0.0003616788843885,0.0005035529702898,14,25
4021,just_relax,0.45,8,7,1,13.99583228956454,0.1582030612456263,31,46
4022,just_relax,0.45,0,0,0,0.0,0.0042083907430441,42,45
4023,just_relax,0.45,1265,1285,-20,2.6849459664833404,-0.1292871249874528,39,173
4024,just_relax,0.45,11,11,0,0.0001627700527109,0.0015600944076981,14,24
4025,just_relax,0.45,0,0,0,0.0,-0.000608053012485,24,25
4026,just_relax,0.45,2,2,0,-2.981324638540173e-05,0.0001440646714581,12,19
4027,just_relax,0.45,59,59,0,0.4609819410147793,0.0044552421238692,41,72
4028,just_relax,0.45,182,178,4,0.0313317398119608,0.0970080713564147,59,115
4029,just_relax,0.45,6,6,0,-0.0020404096920856,0.0011964290694836,32,37
4030,just_relax,0.45,1,0,1,64.5674534074053,-0.0013228453280204,20,20
4031,just_relax,0.45,41,33,8,8.182357833947279,-0.009895766072516,12,31
4032,just_relax,0.45,0,0,0,0.0,-1.5942199658169898e-06,10,10
4033,just_relax,0.45,0,0,0,0.0,0.0018153466622625,20,21
4034,just_relax,0.45,18,18,0,0.0003589278580733,-0.0005865039043362,39,52
4035,just_relax,0.45,378,369,9,2.979528253482861,0.0835817869771829,42,109
4036,just_relax,0.45,1,1,0,-0.0010366044558338,-5.546321229055184e-05,25,28
4037,just_relax,0.45,170,170,0,-0.0002769762706833,-0.0005002245004087,56,106
4038,just_relax,0.45,567,521,46,-0.2657392120378574,0.1239070997048957,87,189
4039,just_relax,0.45,41,43,-2,2.499128887843675,-0.033528056765164,56,82
4040,just_relax,0.45,2,2,0,0.0004861774901456,1.2071037781558047e-06,13,15
4041,just_relax,0.45,104,86,18,5.26724471872344,-0.2840091449765524,36,63
4042,just_relax,0.45,0,0,0,0.0,4.3915154694929015e-06,16,15
4043,just_relax,0.45,0,0,0,0.0,-5.223096419815221e-07,67,66
4044,just_relax,0.45,13,13,0,0.0024384647237383,0.004260897920215,42,60
4045,just_relax,0.45,0,0,0,0.0,0.0005903979895692,39,38
4046,just_relax,0.45,8,8,0,-3.330899971842882e-05,0.0005334774465118,20,36
4047,just_relax,0.45,0,0,0,0.0,-0.0010596071395927,10,9
4048,just_relax,0.45,1,1,0,0.0009644178095271,-1.805181839154013e-05,13,15
4049,just_relax,0.45,6,7,-1,12.522285729298716,0.0299062089849014,34,41
4050,just_relax,0.45,3,3,0,-0.0014185667246167,0.0006213779664755,37,42
4051,just_relax,0.45,36,36,0,7.196136941445275e-06,5.025038399830706e-06,18,29
4052,just_relax,0.45,0,0,0,0.0,-0.0031405837993232,23,22
4053,just_relax,0.45,0,0,0,0.0,1.0504657718901632e-05,13,12
4054,just_relax,0.45,0,0,0,0.0,-0.0007613272869088,15,14
4055,just_relax,0.45,0,0,0,0.0,-0.0017207203528439,69,68
4056,just_relax,0.45,0,0,0,0.0,0.001934163275203,40,39
4057,just_relax,0.45,0,0,0,0.0,0.0016954512903432,89,93
4058,just_relax,0.45,13,13,0,1.511050374969713,-0.0878570612978808,20,32
4059,just_relax,0.45,2,3,-1,-4.120223819609976,0.0096644512108772,69,83
4060,just_relax,0.45,2,2,0,0.0006766545457281,-0.0007958153584334,12,15
4061,just_relax,0.45,0,0,0,0.0,-0.0009758471183408,15,14
4062,just_relax,0.45,0,0,0,0.0,-0.0007570529942456,23,26
4063,just_relax,0.45,2,2,0,-0.0004670837519427,-0.000552899751354,12,20
4064,just_relax,0.45,201,201,0,-5.927609844036397e-05,0.0001073571901385,64,122
4065,just_relax,0.45,7,7,0,-0.0099055150386959,0.0003544031231826,58,71
4066,just_relax,0.45,0,0,0,0.0,-0.0013086772972689,20,19
4067,just_relax,0.45,510,505,5,-0.1096058695008466,0.0001562332230281,100,191
4068,just_relax,0.45,34,34,0,0.0046498502251353,3.462795885833536e-05,41,61
4069,just_relax,0.45,33,21,12,-0.322372772893118,0.0487025778316814,13,31
4070,just_relax,0.45,5,5,0,0.0003476406123752,0.0002826333043987,10,15
4071,just_relax,0.45,6,6,0,-0.0004254358946269,0.0003115870201488,37,47
4072,just_relax,0.45,0,0,0,0.0,0.0007350584472026,21,21
4073,just_relax,0.45,0,0,0,0.0,9.621758975453254e-06,11,10
4074,just_relax,0.45,57,55,2,-1.1796960984034186,9.734149291917849e-05,44,80
4075,just_relax,0.45,6,6,0,0.0001929725905256,-1.6711583069151104e-05,12,21
4076,just_relax,0.45,2,5,-3,10.477360070400792,-0.0167672873232497,37,43
4077,just_relax,0.45,6,6,0,-9.27967616917158e-05,0.0005867078171852,41,52
4078,just_relax,0.45,0,0,0,0.0,0.0258238191424075,90,89
4079,just_relax,0.45,0,0,0,0.0,-0.0001762041220683,22,21
4080,just_relax,0.45,1,5,-4,-25.99394547658536,0.034397478016983,37,43
4081,just_relax,0.45,0,0,0,0.0,0.009279908390236,47,47
4082,just_relax,0.45,4,4,0,-0.0003372893218767,-9.212772776878708e-07,12,20
4083,just_relax,0.45,114,95,19,0.8287298242191525,-0.006531385777559,84,124
4084,just_relax,0.45,0,0,0,0.0,0.0016708237920683,88,92
4085,just_relax,0.45,380,332,48,-1.681066658089314,0.0270328691740772,59,122
4086,just_relax,0.45,4,4,0,2.0677824380754828e-05,-0.000363330475558,26,31
4087,just_relax,0.45,0,0,0,0.0,4.418930553695688e-06,28,27
4088,just_relax,0.45,6,6,0,0.0013890930604816,7.243956427815945e-06,18,26
4089,just_relax,0.45,1,1,0,-0.0014241348598034,0.001861633846505,23,26
4090,just_relax,0.45,0,0,0,0.0,0.0001814651838247,43,43
4091,just_relax,0.45,2,2,0,0.0004949068667485,0.0012137972461528,22,26
4092,just_relax,0.45,0,0,0,0.0,8.316094011640018e-06,15,14
4093,just_relax,0.45,10,17,-7,3.5874123628873704,0.0856058777554238,36,48
4094,just_relax,0.45,6,6,0,2.8016025522275783,-0.3535412006642752,30,37
4095,just_relax,0.45,1,1,0,5.455328151526828e-05,-4.433967369288361e-05,10,13
4096,just_relax,0.45,0,0,0,0.0,-0.0049855760382295,12,11
4097,just_relax,0.45,168,182,-14,1.1771250480206064,-0.0267800915114647,55,105
4098,just_relax,0.45,1,1,0,17.12164821735773,0.0578261695456346,13,17
4099,just_relax,0.45,0,0,0,0.0,0.0003329515887838,30,29
4100,just_relax,0.45,3,3,0,0.000583815366788,0.0008768881680062,36,43
4101,just_relax,0.45,36,36,0,0.0010314806767866,-5.393936385500453e-05,40,60
4102,just_relax,0.45,0,0,0,0.0,0.0017894746066188,13,17
4103,just_relax,0.45,6,7,-1,-5.27235869178908,0.0082826452568239,23,30
4104,just_relax,0.45,0,0,0,0.0,-2.940409977925107e-05,12,16
4105,just_relax,0.45,0,0,0,0.0,3.901708024223183e-06,26,26
4106,just_relax,0.45,0,0,0,0.0,-0.0031688166024113,22,31
4107,just_relax,0.45,0,0,0,0.0,0.0008768193667615,68,68
4108,just_relax,0.45,0,0,0,0.0,-7.938175057398134e-06,23,22
4109,just_relax,0.45,0,0,0,0.0,-0.065399188004364,43,42
4110,just_relax,0.45,0,0,0,0.0,-0.002899723134464,18,17
4111,just_relax,0.45,3,3,0,-0.003194586812441,0.0012605153222713,28,42
4112,just_relax,0.45,45,58,-13,0.9231299892006462,0.088218433779717,21,44
4113,just_relax,0.45,0,0,0,0.0,-0.0112811671875761,36,37
4114,just_relax,0.45,0,0,0,0.0,-3.4878924121017896e-05,15,14
4115,just_relax,0.45,1,1,0,-0.0014549239964907,-0.00058525619921,14,16
4116,just_relax,0.45,197,237,-40,1.3477492998050025,0.0885093784332623,61,119
4117,just_relax,0.45,0,0,0,0.0,-0.0038599581671643,19,20
4118,just_relax,0.45,0,0,0,0.0,-0.0006472841631984,22,22
4119,just_relax,0.45,0,0,0,0.0,-0.0011415137972972,54,58
4120,just_relax,0.45,651,651,0,-0.0003954210755097,0.0002252638081207,65,135
4121,just_relax,0.45,1,1,0,-0.0029471577812358,0.0001749400264638,16,18
4122,just_relax,0.45,7,7,0,0.0002013814076775,0.0006636994664107,17,27
4123,just_relax,0.45,22,7,15,-12.985895473169307,0.1330374466905183,54,71
4124,just_relax,0.45,0,2,-2,-59.99819093035041,-0.0131455917893484,23,22
4125,just_relax,0.45,1,0,1,76.88395716132196,-0.1491322016956315,13,16
4126,just_relax,0.45,155,185,-30,2.3843149677438973,-0.02495720013905,85,131
4127,just_relax,0.45,44,44,0,0.0003032918935019,0.0025857794052007,28,55
4128,just_relax,0.45,4,4,0,-0.0007096785766407,-5.4537984728875166e-05,18,24
4129,just_relax,0.45,0,0,0,0.0,-0.003226028074061,19,22
4130,just_relax,0.45,0,0,0,0.0,0.0048197166778652,47,46
4131,just_relax,0.45,21,27,-6,0.0602947270368474,-0.3310372682946312,39,64
4132,just_relax,0.45,0,0,0,0.0,-0.0037052423868473,17,18
4133,just_relax,0.45,1,1,0,0.0005119856857191,0.0004745196477359,23,24
4134,just_relax,0.45,2,2,0,0.0010275548569325,-0.004970471779609,13,16
4135,just_relax,0.45,22,22,0,0.0038770082111057,0.0004285387996507,40,56
4136,just_relax,0.45,1,1,0,-0.0002865966515059,-0.0003325971221349,10,15
4137,just_relax,0.45,0,0,0,0.0,0.0003384089422906,21,20
4138,just_relax,0.45,4,4,0,-0.0001029723687508,-0.0013906355929786,30,35
4139,just_relax,0.45,1,1,0,0.0051043410712594,-0.0056156512673798,71,77
4140,relax_and_recompute,0.5,0,0,0,0.0,0.0,17,18
4141,relax_and_recompute,0.5,1,1,0,0.0,0.0,43,48
4142,relax_and_recompute,0.5,3,3,0,0.0,0.0,38,45
4143,relax_and_recompute,0.5,0,0,0,0.0,0.0,12,12
4144,relax_and_recompute,0.5,20,18,2,-3.2752299140735204,0.0114158034923678,23,38
4145,relax_and_recompute,0.5,0,1,-1,-78.11694026732484,-0.0295512202700576,19,22
4146,relax_and_recompute,0.5,976,1004,-28,-0.0620531910963606,-0.0009330148689207,35,143
4147,relax_and_recompute,0.5,0,0,0,0.0,-0.0046858462976494,92,91
4148,relax_and_recompute,0.5,2,2,0,0.0,0.0,43,51
4149,relax_and_recompute,0.5,1,1,0,0.0,0.0,35,36
4150,relax_and_recompute,0.5,1,1,0,0.0,0.0,11,13
4151,relax_and_recompute,0.5,22,19,3,-4.957652547927751,0.037406937188411,10,25
4152,relax_and_recompute,0.5,16,16,0,0.0,0.0,86,136
4153,relax_and_recompute,0.5,0,0,0,0.0,0.0,10,12
4154,relax_and_recompute,0.5,0,0,0,0.0,0.0,32,31
4155,relax_and_recompute,0.5,2,2,0,4.970962038347736,-0.0904350603192869,20,26
4156,relax_and_recompute,0.5,0,0,0,0.0,0.0,11,11
4157,relax_and_recompute,0.5,2,2,0,0.0,0.0,34,42
4158,relax_and_recompute,0.5,11,11,0,0.0,0.0,14,25
4159,relax_and_recompute,0.5,8,7,1,13.99583228956454,0.1582030612456263,31,46
4160,relax_and_recompute,0.5,0,0,0,0.0,0.0,42,45
4161,relax_and_recompute,0.5,1265,1233,32,-0.0829886923942524,-0.0013136328692162,39,173
4162,relax_and_recompute,0.5,11,11,0,0.0,0.0,14,24
4163,relax_and_recompute,0.5,0,0,0,0.0,0.0,24,25
4164,relax_and_recompute,0.5,2,2,0,0.0,0.0,12,19
4165,relax_and_recompute,0.5,59,59,0,0.4609819410147793,0.0044552421238692,41,72
4166,relax_and_recompute,0.5,182,192,-10,2.176227062990442,0.127488881317396,59,115
4167,relax_and_recompute,0.5,6,6,0,0.0,0.0,32,37
4168,relax_and_recompute,0.5,1,1,0,0.0,0.0,20,20
4169,relax_and_recompute,0.5,41,26,15,-1.6275846340626714,0.0729158968985802,12,31
4170,relax_and_recompute,0.5,0,0,0,0.0,0.0,10,10
4171,relax_and_recompute,0.5,0,0,0,0.0,0.0,20,21
4172,relax_and_recompute,0.5,18,18,0,0.0,0.0,39,52
4173,relax_and_recompute,0.5,378,393,-15,0.6108526484877643,4.422482210819645e-05,42,109
4174,relax_and_recompute,0.5,1,1,0,0.0,0.0,25,28
4175,relax_and_recompute,0.5,170,170,0,0.0,0.0,56,106
4176,relax_and_recompute,0.5,567,575,-8,0.4383057260994292,-0.0017656065849445,87,189
4177,relax_and_recompute,0.5,41,40,1,-2.249384452446378,-0.0072514307594979,56,82
4178,relax_and_recompute,0.5,2,2,0,0.0,0.0,13,15
4179,relax_and_recompute,0.5,104,88,16,-3.3995451437074067,-0.111275141568526,36,63
4180,relax_and_recompute,0.5,0,0,0,0.0,0.0,16,15
4181,relax_and_recompute,0.5,0,0,0,0.0,0.0,67,66
4182,relax_and_recompute,0.5,13,13,0,0.0,0.0,42,60
4183,relax_and_recompute,0.5,0,0,0,0.0,0.0,39,38
4184,relax_and_recompute,0.5,8,8,0,0.0,0.0,20,36
4185,relax_and_recompute,0.5,0,0,0,0.0,0.0,10,9
4186,relax_and_recompute,0.5,1,1,0,0.0,0.0,13,15
4187,relax_and_recompute,0.5,6,7,-1,12.522285729298716,0.0299062089849014,34,41
4188,relax_and_recompute,0.5,3,3,0,0.0,0.0,37,42
4189,relax_and_recompute,0.5,36,36,0,0.0,0.0,18,29
4190,relax_and_recompute,0.5,0,0,0,0.0,0.0,23,22
4191,relax_and_recompute,0.5,0,0,0,0.0,0.0,13,12
4192,relax_and_recompute,0.5,0,0,0,0.0,0.0,15,14
4193,relax_and_recompute,0.5,0,0,0,0.0,0.0,69,68
4194,relax_and_recompute,0.5,0,0,0,0.0,0.0,40,39
4195,relax_and_recompute,0.5,0,0,0,0.0,0.0,89,93
4196,relax_and_recompute,0.5,13,13,0,-2.975681235416161,-0.0847204542309565,20,32
4197,relax_and_recompute,0.5,2,2,0,0.0,0.0,69,83
4198,relax_and_recompute,0.5,2,2,0,0.0,0.0,12,15
4199,relax_and_recompute,0.5,0,0,0,0.0,0.0,15,14
4200,relax_and_recompute,0.5,0,0,0,0.0,0.0,23,26
4201,relax_and_recompute,0.5,2,2,0,0.0,0.0,12,20
4202,relax_and_recompute,0.5,201,201,0,0.0,0.0,64,122
4203,relax_and_recompute,0.5,7,7,0,0.0,0.0,58,71
4204,relax_and_recompute,0.5,0,0,0,0.0,0.0,20,19
4205,relax_and_recompute,0.5,510,512,-2,-0.0138388627329746,-0.001793654381577,100,191
4206,relax_and_recompute,0.5,34,34,0,0.0,0.0,41,61
4207,relax_and_recompute,0.5,33,34,-1,-0.5384989905164446,0.0398816997391653,13,31
4208,relax_and_recompute,0.5,5,5,0,0.0,0.0,10,15
4209,relax_and_recompute,0.5,6,6,0,0.0,0.0,37,47
4210,relax_and_recompute,0.5,0,0,0,0.0,0.0,21,21
4211,relax_and_recompute,0.5,0,0,0,0.0,0.0,11,10
4212,relax_and_recompute,0.5,57,57,0,0.0064914760634735,-0.0077421754008314,44,80
4213,relax_and_recompute,0.5,6,6,0,0.0,0.0,12,21
4214,relax_and_recompute,0.5,2,2,0,40.57817790180843,-0.0379305285754828,37,43
4215,relax_and_recompute,0.5,6,6,0,0.0,0.0,41,52
4216,relax_and_recompute,0.5,0,0,0,0.0,0.0,90,89
4217,relax_and_recompute,0.5,0,0,0,0.0,0.0,22,21
4218,relax_and_recompute,0.5,1,6,-5,-12.824308725883805,-0.0280060439235303,37,43
4219,relax_and_recompute,0.5,0,0,0,0.0,0.0,47,47
4220,relax_and_recompute,0.5,4,4,0,0.0,0.0,12,20
4221,relax_and_recompute,0.5,114,114,0,0.0,0.0,84,124
4222,relax_and_recompute,0.5,0,0,0,0.0,0.0,88,92
4223,relax_and_recompute,0.5,380,377,3,-0.3714807714610657,-0.0025427242202904,59,122
4224,relax_and_recompute,0.5,4,4,0,0.0,0.0,26,31
4225,relax_and_recompute,0.5,0,0,0,0.0,0.0,28,27
4226,relax_and_recompute,0.5,6,6,0,0.0,0.0,18,26
4227,relax_and_recompute,0.5,1,1,0,0.0,0.0,23,26
4228,relax_and_recompute,0.5,0,0,0,0.0,0.0,43,43
4229,relax_and_recompute,0.5,2,2,0,0.0,0.0,22,26
4230,relax_and_recompute,0.5,0,0,0,0.0,0.0,15,14
4231,relax_and_recompute,0.5,10,17,-7,3.5874123628873704,0.0856058777554238,36,48
4232,relax_and_recompute,0.5,6,6,0,2.8016025522275783,-0.3535412006642752,30,37
4233,relax_and_recompute,0.5,1,1,0,0.0,0.0,10,13
4234,relax_and_recompute,0.5,0,0,0,0.0,0.0,12,11
4235,relax_and_recompute,0.5,168,153,15,-1.4597591062543387,0.1638614131178267,55,105
4236,relax_and_recompute,0.5,1,1,0,17.12164821735773,0.0578261695456346,13,17
4237,relax_and_recompute,0.5,0,0,0,0.0,0.0,30,29
4238,relax_and_recompute,0.5,3,3,0,0.0,0.0,36,43
4239,relax_and_recompute,0.5,36,36,0,0.0,0.0,40,60
4240,relax_and_recompute,0.5,0,0,0,0.0,0.0,13,17
4241,relax_and_recompute,0.5,6,8,-2,-4.960402959672933,-0.0115319394462201,23,30
4242,relax_and_recompute,0.5,0,0,0,0.0,0.0,12,16
4243,relax_and_recompute,0.5,0,0,0,0.0,0.0,26,26
4244,relax_and_recompute,0.5,0,0,0,0.0,0.0,22,31
4245,relax_and_recompute,0.5,0,0,0,0.0,0.0,68,68
4246,relax_and_recompute,0.5,0,0,0,0.0,0.0,23,22
4247,relax_and_recompute,0.5,0,0,0,0.0,-0.0349525596057489,43,42
4248,relax_and_recompute,0.5,0,0,0,0.0,0.0,18,17
4249,relax_and_recompute,0.5,3,3,0,0.0,0.0,28,42
4250,relax_and_recompute,0.5,45,50,-5,1.8841541587735409,0.0156030402407787,21,44
4251,relax_and_recompute,0.5,0,0,0,0.0,0.0,36,37
4252,relax_and_recompute,0.5,0,0,0,0.0,0.0,15,14
4253,relax_and_recompute,0.5,1,1,0,0.0,0.0,14,16
4254,relax_and_recompute,0.5,197,211,-14,1.6294158914226389,0.1952030013326532,61,119
4255,relax_and_recompute,0.5,0,0,0,0.0,0.0,19,20
4256,relax_and_recompute,0.5,0,0,0,0.0,0.0,22,22
4257,relax_and_recompute,0.5,0,0,0,0.0,0.0,54,58
4258,relax_and_recompute,0.5,651,651,0,0.0,0.0,65,135
4259,relax_and_recompute,0.5,1,1,0,0.0,0.0,16,18
4260,relax_and_recompute,0.5,7,7,0,0.0,0.0,17,27
4261,relax_and_recompute,0.5,22,4,18,-18.61747849085588,0.1446288399504806,54,71
4262,relax_and_recompute,0.5,0,2,-2,-59.99819093035041,-0.0131455917893484,23,22
4263,relax_and_recompute,0.5,1,0,1,76.88395716132196,-0.1491322016956315,13,16
4264,relax_and_recompute,0.5,155,146,9,-2.3741667241416664,-0.001397205031107,85,131
4265,relax_and_recompute,0.5,44,44,0,0.0,0.0,28,55
4266,relax_and_recompute,0.5,4,4,0,0.0,0.0,18,24
4267,relax_and_recompute,0.5,0,0,0,0.0,0.0,19,22
4268,relax_and_recompute,0.5,0,0,0,0.0,0.0,47,46
4269,relax_and_recompute,0.5,21,19,2,-6.356920988253222,0.0143956759658575,39,64
4270,relax_and_recompute,0.5,0,0,0,0.0,0.0,17,18
4271,relax_and_recompute,0.5,1,1,0,0.0,0.0,23,24
4272,relax_and_recompute,0.5,2,2,0,0.0,0.0,13,16
4273,relax_and_recompute,0.5,22,22,0,0.0,0.0,40,56
4274,relax_and_recompute,0.5,1,1,0,0.0,0.0,10,15
4275,relax_and_recompute,0.5,0,0,0,0.0,0.0,21,20
4276,relax_and_recompute,0.5,4,4,0,0.0,0.0,30,35
4277,relax_and_recompute,0.5,1,1,0,0.0,0.0,71,77
4278,relax_one,0.5,0,0,0,0.0,0.0,17,18
4279,relax_one,0.5,1,1,0,0.0,0.0,43,48
4280,relax_one,0.5,3,3,0,0.0,0.0,38,45
4281,relax_one,0.5,0,0,0,0.0,0.0,12,12
4282,relax_one,0.5,20,18,2,-3.2752299140735204,0.0114158034923678,23,38
4283,relax_one,0.5,0,1,-1,-78.11694026732484,-0.0295512202700576,19,22
4284,relax_one,0.5,976,978,-2,0.1423455471242221,-0.0025418055405018,35,143
4285,relax_one,0.5,0,1,-1,-50.19567681247512,-0.0041327022016595,92,91
4286,relax_one,0.5,2,2,0,0.0,0.0,43,51
4287,relax_one,0.5,1,1,0,0.0,0.0,35,36
4288,relax_one,0.5,1,1,0,0.0,0.0,11,13
4289,relax_one,0.5,22,20,2,-3.01441643358082,0.0082886474985522,10,25
4290,relax_one,0.5,16,16,0,0.0,0.0,86,136
4291,relax_one,0.5,0,0,0,0.0,0.0,10,12
4292,relax_one,0.5,0,0,0,0.0,0.0,32,31
4293,relax_one,0.5,2,2,0,4.970962038347736,-0.0904350603192869,20,26
4294,relax_one,0.5,0,0,0,0.0,0.0,11,11
4295,relax_one,0.5,2,2,0,0.0,0.0,34,42
4296,relax_one,0.5,11,11,0,0.0,0.0,14,25
4297,relax_one,0.5,8,7,1,13.99583228956454,0.1582030612456263,31,46
4298,relax_one,0.5,0,0,0,0.0,0.0,42,45
4299,relax_one,0.5,1265,1240,25,0.1009906236120983,0.0001682713719424,39,173
4300,relax_one,0.5,11,11,0,0.0,0.0,14,24
4301,relax_one,0.5,0,0,0,0.0,0.0,24,25
4302,relax_one,0.5,2,2,0,0.0,0.0,12,19
4303,relax_one,0.5,59,59,0,0.4609819410147793,0.0044552421238692,41,72
4304,relax_one,0.5,182,191,-9,1.446975953367918,0.0358261975695221,59,115
4305,relax_one,0.5,6,6,0,0.0,0.0,32,37
4306,relax_one,0.5,1,1,0,0.0,0.0,20,20
4307,relax_one,0.5,41,32,9,2.305146048931391,0.0775874222420341,12,31
4308,relax_one,0.5,0,0,0,0.0,0.0,10,10
4309,relax_one,0.5,0,0,0,0.0,0.0,20,21
4310,relax_one,0.5,18,18,0,0.0,0.0,39,52
4311,relax_one,0.5,378,395,-17,-0.4859193577000411,-0.0010324457545943,42,109
4312,relax_one,0.5,1,1,0,0.0,0.0,25,28
4313,relax_one,0.5,170,170,0,0.0,0.0,56,106
4314,relax_one,0.5,567,595,-28,0.7834114754025379,-0.002967395777259,87,189
4315,relax_one,0.5,41,41,0,-3.1762323320181167,-0.0099859384844429,56,82
4316,relax_one,0.5,2,2,0,0.0,0.0,13,15
4317,relax_one,0.5,104,88,16,-3.3995451437074067,-0.111275141568526,36,63
4318,relax_one,0.5,0,0,0,0.0,0.0,16,15
4319,relax_one,0.5,0,0,0,0.0,0.0,67,66
4320,relax_one,0.5,13,13,0,0.0,0.0,42,60
4321,relax_one,0.5,0,0,0,0.0,0.0,39,38
4322,relax_one,0.5,8,8,0,0.0,0.0,20,36
4323,relax_one,0.5,0,0,0,0.0,0.0,10,9
4324,relax_one,0.5,1,1,0,0.0,0.0,13,15
4325,relax_one,0.5,6,7,-1,12.522285729298716,0.0299062089849014,34,41
4326,relax_one,0.5,3,3,0,0.0,0.0,37,42
4327,relax_one,0.5,36,36,0,0.0,0.0,18,29
4328,relax_one,0.5,0,0,0,0.0,0.0,23,22
4329,relax_one,0.5,0,0,0,0.0,0.0,13,12
4330,relax_one,0.5,0,0,0,0.0,0.0,15,14
4331,relax_one,0.5,0,0,0,0.0,0.0,69,68
4332,relax_one,0.5,0,0,0,0.0,0.0,40,39
4333,relax_one,0.5,0,0,0,0.0,0.0,89,93
4334,relax_one,0.5,13,13,0,-2.975681235416161,-0.0847204542309565,20,32
4335,relax_one,0.5,2,2,0,0.0,0.0,69,83
4336,relax_one,0.5,2,2,0,0.0,0.0,12,15
4337,relax_one,0.5,0,0,0,0.0,0.0,15,14
4338,relax_one,0.5,0,0,0,0.0,0.0,23,26
4339,relax_one,0.5,2,2,0,0.0,0.0,12,20
4340,relax_one,0.5,201,201,0,0.0,0.0,64,122
4341,relax_one,0.5,7,7,0,0.0,0.0,58,71
4342,relax_one,0.5,0,0,0,0.0,0.0,20,19
4343,relax_one,0.5,510,510,0,0.0060639005596385,-0.0006916839131552,100,191
4344,relax_one,0.5,34,34,0,0.0,0.0,41,61
4345,relax_one,0.5,33,34,-1,-0.6264707699284884,0.0331924782664471,13,31
4346,relax_one,0.5,5,5,0,0.0,0.0,10,15
4347,relax_one,0.5,6,6,0,0.0,0.0,37,47
4348,relax_one,0.5,0,0,0,0.0,0.0,21,21
4349,relax_one,0.5,0,0,0,0.0,0.0,11,10
4350,relax_one,0.5,57,55,2,-1.1796960984034186,9.734149291917849e-05,44,80
4351,relax_one,0.5,6,6,0,0.0,0.0,12,21
4352,relax_one,0.5,2,2,0,42.15913628345388,-0.0181760816329957,37,43
4353,relax_one,0.5,6,6,0,0.0,0.0,41,52
4354,relax_one,0.5,0,0,0,0.0,0.0,90,89
4355,relax_one,0.5,0,0,0,0.0,0.0,22,21
4356,relax_one,0.5,1,1,0,-4.213527745425694,0.0417394626549948,37,43
4357,relax_one,0.5,0,0,0,0.0,0.0,47,47
4358,relax_one,0.5,4,4,0,0.0,0.0,12,20
4359,relax_one,0.5,114,114,0,0.0,0.0,84,124
4360,relax_one,0.5,0,0,0,0.0,0.0,88,92
4361,relax_one,0.5,380,377,3,-0.3714807714610657,-0.0025427242202904,59,122
4362,relax_one,0.5,4,4,0,0.0,0.0,26,31
4363,relax_one,0.5,0,0,0,0.0,0.0,28,27
4364,relax_one,0.5,6,6,0,0.0,0.0,18,26
4365,relax_one,0.5,1,1,0,0.0,0.0,23,26
4366,relax_one,0.5,0,0,0,0.0,0.0,43,43
4367,relax_one,0.5,2,2,0,0.0,0.0,22,26
4368,relax_one,0.5,0,0,0,0.0,0.0,15,14
4369,relax_one,0.5,10,17,-7,3.5874123628873704,0.0856058777554238,36,48
4370,relax_one,0.5,6,6,0,2.8016025522275783,-0.3535412006642752,30,37
4371,relax_one,0.5,1,1,0,0.0,0.0,10,13
4372,relax_one,0.5,0,0,0,0.0,0.0,12,11
4373,relax_one,0.5,168,167,1,-0.7965879277094672,0.0475430066924907,55,105
4374,relax_one,0.5,1,1,0,17.12164821735773,0.0578261695456346,13,17
4375,relax_one,0.5,0,0,0,0.0,0.0,30,29
4376,relax_one,0.5,3,3,0,0.0,0.0,36,43
4377,relax_one,0.5,36,36,0,0.0,0.0,40,60
4378,relax_one,0.5,0,0,0,0.0,0.0,13,17
4379,relax_one,0.5,6,7,-1,-5.27235869178908,0.0082826452568239,23,30
4380,relax_one,0.5,0,0,0,0.0,0.0,12,16
4381,relax_one,0.5,0,0,0,0.0,0.0,26,26
4382,relax_one,0.5,0,0,0,0.0,0.0,22,31
4383,relax_one,0.5,0,0,0,0.0,0.0,68,68
4384,relax_one,0.5,0,0,0,0.0,0.0,23,22
4385,relax_one,0.5,0,0,0,0.0,-0.0348129737608335,43,42
4386,relax_one,0.5,0,0,0,0.0,0.0,18,17
4387,relax_one,0.5,3,3,0,0.0,0.0,28,42
4388,relax_one,0.5,45,45,0,0.1036479088850654,-0.0041754562964496,21,44
4389,relax_one,0.5,0,0,0,0.0,0.0,36,37
4390,relax_one,0.5,0,0,0,0.0,0.0,15,14
4391,relax_one,0.5,1,1,0,0.0,0.0,14,16
4392,relax_one,0.5,197,204,-7,3.484436282689749,0.1757315340586914,61,119
4393,relax_one,0.5,0,0,0,0.0,0.0,19,20
4394,relax_one,0.5,0,0,0,0.0,0.0,22,22
4395,relax_one,0.5,0,0,0,0.0,0.0,54,58
4396,relax_one,0.5,651,651,0,0.0,0.0,65,135
4397,relax_one,0.5,1,1,0,0.0,0.0,16,18
4398,relax_one,0.5,7,7,0,0.0,0.0,17,27
4399,relax_one,0.5,22,4,18,-19.06910671434205,0.1469333863626725,54,71
4400,relax_one,0.5,0,2,-2,-59.99819093035041,-0.0131455917893484,23,22
4401,relax_one,0.5,1,0,1,76.88395716132196,-0.1491322016956315,13,16
4402,relax_one,0.5,155,146,9,-2.3741667241416664,-0.001397205031107,85,131
4403,relax_one,0.5,44,44,0,0.0,0.0,28,55
4404,relax_one,0.5,4,4,0,0.0,0.0,18,24
4405,relax_one,0.5,0,0,0,0.0,0.0,19,22
4406,relax_one,0.5,0,0,0,0.0,0.0,47,46
4407,relax_one,0.5,21,19,2,-6.356920988253222,0.0143956759658575,39,64
4408,relax_one,0.5,0,0,0,0.0,0.0,17,18
4409,relax_one,0.5,1,1,0,0.0,0.0,23,24
4410,relax_one,0.5,2,2,0,0.0,0.0,13,16
4411,relax_one,0.5,22,22,0,0.0,0.0,40,56
4412,relax_one,0.5,1,1,0,0.0,0.0,10,15
4413,relax_one,0.5,0,0,0,0.0,0.0,21,20
4414,relax_one,0.5,4,4,0,0.0,0.0,30,35
4415,relax_one,0.5,1,1,0,0.0,0.0,71,77
4416,just_relax,0.5,0,0,0,0.0,-0.0091692815110081,17,18
4417,just_relax,0.5,1,1,0,0.0009607869158827,0.0014628518031132,43,48
4418,just_relax,0.5,3,3,0,-0.0019521681741139,-7.679999619569777e-05,38,45
4419,just_relax,0.5,0,0,0,0.0,-0.0037600566419999,12,12
4420,just_relax,0.5,20,14,6,1.9891400956483096,0.1544148745043621,23,38
4421,just_relax,0.5,0,1,-1,-78.11694026732484,-0.0295512202700576,19,22
4422,just_relax,0.5,976,1188,-212,1.3106081233515638,0.0257948127350838,35,143
4423,just_relax,0.5,0,4,-4,-39.1818408082167,-0.0156618414823971,92,91
4424,just_relax,0.5,2,2,0,-0.00041775540015,-0.0002552385505018,43,51
4425,just_relax,0.5,1,1,0,-0.0016870080925173,6.40249009676297e-05,35,36
4426,just_relax,0.5,1,1,0,-0.000156439410091,0.0002508982184644,11,13
4427,just_relax,0.5,22,24,-2,-3.49415891827384,0.1000113687896936,10,25
4428,just_relax,0.5,16,13,3,0.2088785180214571,-2.2771107622610032e-05,86,136
4429,just_relax,0.5,0,0,0,0.0,-1.765503840900351e-06,10,12
4430,just_relax,0.5,0,0,0,0.0,-1.014518260578079e-05,32,31
4431,just_relax,0.5,2,2,0,4.970962038347736,-0.0904350603192869,20,26
4432,just_relax,0.5,0,0,0,0.0,0.000269092021105,11,11
4433,just_relax,0.5,2,2,0,0.0009292844165713,-0.0008610890242942,34,42
4434,just_relax,0.5,11,11,0,-0.0003616788843885,0.0005035529702898,14,25
4435,just_relax,0.5,8,7,1,13.99583228956454,0.1582030612456263,31,46
4436,just_relax,0.5,0,0,0,0.0,0.0042083907430441,42,45
4437,just_relax,0.5,1265,1285,-20,2.6849459664833404,-0.1292871249874528,39,173
4438,just_relax,0.5,11,11,0,0.0001627700527109,0.0015600944076981,14,24
4439,just_relax,0.5,0,0,0,0.0,-0.000608053012485,24,25
4440,just_relax,0.5,2,2,0,-2.981324638540173e-05,0.0001440646714581,12,19
4441,just_relax,0.5,59,59,0,0.4609819410147793,0.0044552421238692,41,72
4442,just_relax,0.5,182,178,4,0.0313317398119608,0.0970080713564147,59,115
4443,just_relax,0.5,6,6,0,-0.0020404096920856,0.0011964290694836,32,37
4444,just_relax,0.5,1,0,1,64.5674534074053,-0.0013228453280204,20,20
4445,just_relax,0.5,41,33,8,8.182357833947279,-0.009895766072516,12,31
4446,just_relax,0.5,0,0,0,0.0,-1.5942199658169898e-06,10,10
4447,just_relax,0.5,0,0,0,0.0,0.0018153466622625,20,21
4448,just_relax,0.5,18,18,0,0.0003589278580733,-0.0005865039043362,39,52
4449,just_relax,0.5,378,369,9,2.979528253482861,0.0835817869771829,42,109
4450,just_relax,0.5,1,1,0,-0.0010366044558338,-5.546321229055184e-05,25,28
4451,just_relax,0.5,170,170,0,-0.0002769762706833,-0.0005002245004087,56,106
4452,just_relax,0.5,567,521,46,-0.2657392120378574,0.1239070997048957,87,189
4453,just_relax,0.5,41,43,-2,2.499128887843675,-0.033528056765164,56,82
4454,just_relax,0.5,2,2,0,0.0004861774901456,1.2071037781558047e-06,13,15
4455,just_relax,0.5,104,86,18,5.26724471872344,-0.2840091449765524,36,63
4456,just_relax,0.5,0,0,0,0.0,4.3915154694929015e-06,16,15
4457,just_relax,0.5,0,0,0,0.0,-5.223096419815221e-07,67,66
4458,just_relax,0.5,13,13,0,0.0024384647237383,0.004260897920215,42,60
4459,just_relax,0.5,0,0,0,0.0,0.0005903979895692,39,38
4460,just_relax,0.5,8,8,0,-3.330899971842882e-05,0.0005334774465118,20,36
4461,just_relax,0.5,0,0,0,0.0,-0.0010596071395927,10,9
4462,just_relax,0.5,1,1,0,0.0009644178095271,-1.805181839154013e-05,13,15
4463,just_relax,0.5,6,7,-1,12.522285729298716,0.0299062089849014,34,41
4464,just_relax,0.5,3,3,0,-0.0014185667246167,0.0006213779664755,37,42
4465,just_relax,0.5,36,36,0,7.196136941445275e-06,5.025038399830706e-06,18,29
4466,just_relax,0.5,0,0,0,0.0,-0.0031405837993232,23,22
4467,just_relax,0.5,0,0,0,0.0,1.0504657718901632e-05,13,12
4468,just_relax,0.5,0,0,0,0.0,-0.0007613272869088,15,14
4469,just_relax,0.5,0,0,0,0.0,-0.0017207203528439,69,68
4470,just_relax,0.5,0,0,0,0.0,0.001934163275203,40,39
4471,just_relax,0.5,0,0,0,0.0,0.0016954512903432,89,93
4472,just_relax,0.5,13,13,0,1.511050374969713,-0.0878570612978808,20,32
4473,just_relax,0.5,2,3,-1,-4.120223819609976,0.0096644512108772,69,83
4474,just_relax,0.5,2,2,0,0.0006766545457281,-0.0007958153584334,12,15
4475,just_relax,0.5,0,0,0,0.0,-0.0009758471183408,15,14
4476,just_relax,0.5,0,0,0,0.0,-0.0007570529942456,23,26
4477,just_relax,0.5,2,2,0,-0.0004670837519427,-0.000552899751354,12,20
4478,just_relax,0.5,201,201,0,-5.927609844036397e-05,0.0001073571901385,64,122
4479,just_relax,0.5,7,7,0,-0.0099055150386959,0.0003544031231826,58,71
4480,just_relax,0.5,0,0,0,0.0,-0.0013086772972689,20,19
4481,just_relax,0.5,510,505,5,-0.1096058695008466,0.0001562332230281,100,191
4482,just_relax,0.5,34,34,0,0.0046498502251353,3.462795885833536e-05,41,61
4483,just_relax,0.5,33,21,12,-0.322372772893118,0.0487025778316814,13,31
4484,just_relax,0.5,5,5,0,0.0003476406123752,0.0002826333043987,10,15
4485,just_relax,0.5,6,6,0,-0.0004254358946269,0.0003115870201488,37,47
4486,just_relax,0.5,0,0,0,0.0,0.0007350584472026,21,21
4487,just_relax,0.5,0,0,0,0.0,9.621758975453254e-06,11,10
4488,just_relax,0.5,57,55,2,-1.1796960984034186,9.734149291917849e-05,44,80
4489,just_relax,0.5,6,6,0,0.0001929725905256,-1.6711583069151104e-05,12,21
4490,just_relax,0.5,2,5,-3,10.477360070400792,-0.0167672873232497,37,43
4491,just_relax,0.5,6,6,0,-9.27967616917158e-05,0.0005867078171852,41,52
4492,just_relax,0.5,0,0,0,0.0,0.0258238191424075,90,89
4493,just_relax,0.5,0,0,0,0.0,-0.0001762041220683,22,21
4494,just_relax,0.5,1,5,-4,-25.99394547658536,0.034397478016983,37,43
4495,just_relax,0.5,0,0,0,0.0,0.009279908390236,47,47
4496,just_relax,0.5,4,4,0,-0.0003372893218767,-9.212772776878708e-07,12,20
4497,just_relax,0.5,114,95,19,0.8287298242191525,-0.006531385777559,84,124
4498,just_relax,0.5,0,0,0,0.0,0.0016708237920683,88,92
4499,just_relax,0.5,380,332,48,-1.681066658089314,0.0270328691740772,59,122
4500,just_relax,0.5,4,4,0,2.0677824380754828e-05,-0.000363330475558,26,31
4501,just_relax,0.5,0,0,0,0.0,4.418930553695688e-06,28,27
4502,just_relax,0.5,6,6,0,0.0013890930604816,7.243956427815945e-06,18,26
4503,just_relax,0.5,1,1,0,-0.0014241348598034,0.001861633846505,23,26
4504,just_relax,0.5,0,0,0,0.0,0.0001814651838247,43,43
4505,just_relax,0.5,2,2,0,0.0004949068667485,0.0012137972461528,22,26
4506,just_relax,0.5,0,0,0,0.0,8.316094011640018e-06,15,14
4507,just_relax,0.5,10,17,-7,3.5874123628873704,0.0856058777554238,36,48
4508,just_relax,0.5,6,6,0,2.8016025522275783,-0.3535412006642752,30,37
4509,just_relax,0.5,1,1,0,5.455328151526828e-05,-4.433967369288361e-05,10,13
4510,just_relax,0.5,0,0,0,0.0,-0.0049855760382295,12,11
4511,just_relax,0.5,168,182,-14,1.1771250480206064,-0.0267800915114647,55,105
4512,just_relax,0.5,1,1,0,17.12164821735773,0.0578261695456346,13,17
4513,just_relax,0.5,0,0,0,0.0,0.0003329515887838,30,29
4514,just_relax,0.5,3,3,0,0.000583815366788,0.0008768881680062,36,43
4515,just_relax,0.5,36,36,0,0.0010314806767866,-5.393936385500453e-05,40,60
4516,just_relax,0.5,0,0,0,0.0,0.0017894746066188,13,17
4517,just_relax,0.5,6,7,-1,-5.27235869178908,0.0082826452568239,23,30
4518,just_relax,0.5,0,0,0,0.0,-2.940409977925107e-05,12,16
4519,just_relax,0.5,0,0,0,0.0,3.901708024223183e-06,26,26
4520,just_relax,0.5,0,0,0,0.0,-0.0031688166024113,22,31
4521,just_relax,0.5,0,0,0,0.0,0.0008768193667615,68,68
4522,just_relax,0.5,0,0,0,0.0,-7.938175057398134e-06,23,22
4523,just_relax,0.5,0,0,0,0.0,-0.065399188004364,43,42
4524,just_relax,0.5,0,0,0,0.0,-0.002899723134464,18,17
4525,just_relax,0.5,3,3,0,-0.003194586812441,0.0012605153222713,28,42
4526,just_relax,0.5,45,58,-13,0.9231299892006462,0.088218433779717,21,44
4527,just_relax,0.5,0,0,0,0.0,-0.0112811671875761,36,37
4528,just_relax,0.5,0,0,0,0.0,-3.4878924121017896e-05,15,14
4529,just_relax,0.5,1,1,0,-0.0014549239964907,-0.00058525619921,14,16
4530,just_relax,0.5,197,237,-40,1.3477492998050025,0.0885093784332623,61,119
4531,just_relax,0.5,0,0,0,0.0,-0.0038599581671643,19,20
4532,just_relax,0.5,0,0,0,0.0,-0.0006472841631984,22,22
4533,just_relax,0.5,0,0,0,0.0,-0.0011415137972972,54,58
4534,just_relax,0.5,651,651,0,-0.0003954210755097,0.0002252638081207,65,135
4535,just_relax,0.5,1,1,0,-0.0029471577812358,0.0001749400264638,16,18
4536,just_relax,0.5,7,7,0,0.0002013814076775,0.0006636994664107,17,27
4537,just_relax,0.5,22,7,15,-12.985895473169307,0.1330374466905183,54,71
4538,just_relax,0.5,0,2,-2,-59.99819093035041,-0.0131455917893484,23,22
4539,just_relax,0.5,1,0,1,76.88395716132196,-0.1491322016956315,13,16
4540,just_relax,0.5,155,185,-30,2.3843149677438973,-0.02495720013905,85,131
4541,just_relax,0.5,44,44,0,0.0003032918935019,0.0025857794052007,28,55
4542,just_relax,0.5,4,4,0,-0.0007096785766407,-5.4537984728875166e-05,18,24
4543,just_relax,0.5,0,0,0,0.0,-0.003226028074061,19,22
4544,just_relax,0.5,0,0,0,0.0,0.0048197166778652,47,46
4545,just_relax,0.5,21,27,-6,0.0602947270368474,-0.3310372682946312,39,64
4546,just_relax,0.5,0,0,0,0.0,-0.0037052423868473,17,18
4547,just_relax,0.5,1,1,0,0.0005119856857191,0.0004745196477359,23,24
4548,just_relax,0.5,2,2,0,0.0010275548569325,-0.004970471779609,13,16
4549,just_relax,0.5,22,22,0,0.0038770082111057,0.0004285387996507,40,56
4550,just_relax,0.5,1,1,0,-0.0002865966515059,-0.0003325971221349,10,15
4551,just_relax,0.5,0,0,0,0.0,0.0003384089422906,21,20
4552,just_relax,0.5,4,4,0,-0.0001029723687508,-0.0013906355929786,30,35
4553,just_relax,0.5,1,1,0,0.0051043410712594,-0.0056156512673798,71,77
4554,relax_and_recompute,0.55,0,0,0,0.0,0.0,17,18
4555,relax_and_recompute,0.55,1,1,0,0.0,0.0,43,48
4556,relax_and_recompute,0.55,3,3,0,0.0,0.0,38,45
4557,relax_and_recompute,0.55,0,0,0,0.0,0.0,12,12
4558,relax_and_recompute,0.55,20,18,2,-3.2752299140735204,0.0114158034923678,23,38
4559,relax_and_recompute,0.55,0,1,-1,-78.11694026732484,-0.0295512202700576,19,22
4560,relax_and_recompute,0.55,976,1004,-28,-0.0620531910963606,-0.0009330148689207,35,143
4561,relax_and_recompute,0.55,0,0,0,0.0,-0.0046858462976494,92,91
4562,relax_and_recompute,0.55,2,2,0,0.0,0.0,43,51
4563,relax_and_recompute,0.55,1,1,0,0.0,0.0,35,36
4564,relax_and_recompute,0.55,1,1,0,0.0,0.0,11,13
4565,relax_and_recompute,0.55,22,19,3,-4.957652547927751,0.037406937188411,10,25
4566,relax_and_recompute,0.55,16,16,0,0.0,0.0,86,136
4567,relax_and_recompute,0.55,0,0,0,0.0,0.0,10,12
4568,relax_and_recompute,0.55,0,0,0,0.0,0.0,32,31
4569,relax_and_recompute,0.55,2,2,0,4.970962038347736,-0.0904350603192869,20,26
4570,relax_and_recompute,0.55,0,0,0,0.0,0.0,11,11
4571,relax_and_recompute,0.55,2,2,0,0.0,0.0,34,42
4572,relax_and_recompute,0.55,11,11,0,0.0,0.0,14,25
4573,relax_and_recompute,0.55,8,7,1,13.99583228956454,0.1582030612456263,31,46
4574,relax_and_recompute,0.55,0,0,0,0.0,0.0,42,45
4575,relax_and_recompute,0.55,1265,1233,32,-0.0829886923942524,-0.0013136328692162,39,173
4576,relax_and_recompute,0.55,11,11,0,0.0,0.0,14,24
4577,relax_and_recompute,0.55,0,0,0,0.0,0.0,24,25
4578,relax_and_recompute,0.55,2,2,0,0.0,0.0,12,19
4579,relax_and_recompute,0.55,59,59,0,0.0,0.0,41,72
4580,relax_and_recompute,0.55,182,192,-10,2.176227062990442,0.127488881317396,59,115
4581,relax_and_recompute,0.55,6,6,0,0.0,0.0,32,37
4582,relax_and_recompute,0.55,1,1,0,0.0,0.0,20,20
4583,relax_and_recompute,0.55,41,26,15,-1.6275846340626714,0.0729158968985802,12,31
4584,relax_and_recompute,0.55,0,0,0,0.0,0.0,10,10
4585,relax_and_recompute,0.55,0,0,0,0.0,0.0,20,21
4586,relax_and_recompute,0.55,18,18,0,0.0,0.0,39,52
4587,relax_and_recompute,0.55,378,393,-15,0.6108526484877643,4.422482210819645e-05,42,109
4588,relax_and_recompute,0.55,1,1,0,0.0,0.0,25,28
4589,relax_and_recompute,0.55,170,170,0,0.0,0.0,56,106
4590,relax_and_recompute,0.55,567,575,-8,0.4383057260994292,-0.0017656065849445,87,189
4591,relax_and_recompute,0.55,41,41,0,0.0,0.0,56,82
4592,relax_and_recompute,0.55,2,2,0,0.0,0.0,13,15
4593,relax_and_recompute,0.55,104,88,16,-3.3995451437074067,-0.111275141568526,36,63
4594,relax_and_recompute,0.55,0,0,0,0.0,0.0,16,15
4595,relax_and_recompute,0.55,0,0,0,0.0,0.0,67,66
4596,relax_and_recompute,0.55,13,13,0,0.0,0.0,42,60
4597,relax_and_recompute,0.55,0,0,0,0.0,0.0,39,38
4598,relax_and_recompute,0.55,8,8,0,0.0,0.0,20,36
4599,relax_and_recompute,0.55,0,0,0,0.0,0.0,10,9
4600,relax_and_recompute,0.55,1,1,0,0.0,0.0,13,15
4601,relax_and_recompute,0.55,6,7,-1,12.522285729298716,0.0299062089849014,34,41
4602,relax_and_recompute,0.55,3,3,0,0.0,0.0,37,42
4603,relax_and_recompute,0.55,36,36,0,0.0,0.0,18,29
4604,relax_and_recompute,0.55,0,0,0,0.0,0.0,23,22
4605,relax_and_recompute,0.55,0,0,0,0.0,0.0,13,12
4606,relax_and_recompute,0.55,0,0,0,0.0,0.0,15,14
4607,relax_and_recompute,0.55,0,0,0,0.0,0.0,69,68
4608,relax_and_recompute,0.55,0,0,0,0.0,0.0,40,39
4609,relax_and_recompute,0.55,0,0,0,0.0,0.0,89,93
4610,relax_and_recompute,0.55,13,13,0,-2.975681235416161,-0.0847204542309565,20,32
4611,relax_and_recompute,0.55,2,2,0,0.0,0.0,69,83
4612,relax_and_recompute,0.55,2,2,0,0.0,0.0,12,15
4613,relax_and_recompute,0.55,0,0,0,0.0,0.0,15,14
4614,relax_and_recompute,0.55,0,0,0,0.0,0.0,23,26
4615,relax_and_recompute,0.55,2,2,0,0.0,0.0,12,20
4616,relax_and_recompute,0.55,201,201,0,0.0,0.0,64,122
4617,relax_and_recompute,0.55,7,7,0,0.0,0.0,58,71
4618,relax_and_recompute,0.55,0,0,0,0.0,0.0,20,19
4619,relax_and_recompute,0.55,510,510,0,0.0060639005596385,-0.0006916839131552,100,191
4620,relax_and_recompute,0.55,34,34,0,0.0,0.0,41,61
4621,relax_and_recompute,0.55,33,34,-1,-0.5384989905164446,0.0398816997391653,13,31
4622,relax_and_recompute,0.55,5,5,0,0.0,0.0,10,15
4623,relax_and_recompute,0.55,6,6,0,0.0,0.0,37,47
4624,relax_and_recompute,0.55,0,0,0,0.0,0.0,21,21
4625,relax_and_recompute,0.55,0,0,0,0.0,0.0,11,10
4626,relax_and_recompute,0.55,57,57,0,0.0,0.0,44,80
4627,relax_and_recompute,0.55,6,6,0,0.0,0.0,12,21
4628,relax_and_recompute,0.55,2,2,0,40.57817790180843,-0.0379305285754828,37,43
4629,relax_and_recompute,0.55,6,6,0,0.0,0.0,41,52
4630,relax_and_recompute,0.55,0,0,0,0.0,0.0,90,89
4631,relax_and_recompute,0.55,0,0,0,0.0,0.0,22,21
4632,relax_and_recompute,0.55,1,1,0,-4.213527745425694,0.0417394626549948,37,43
4633,relax_and_recompute,0.55,0,0,0,0.0,0.0,47,47
4634,relax_and_recompute,0.55,4,4,0,0.0,0.0,12,20
4635,relax_and_recompute,0.55,114,114,0,0.0,0.0,84,124
4636,relax_and_recompute,0.55,0,0,0,0.0,0.0,88,92
4637,relax_and_recompute,0.55,380,377,3,-0.3714807714610657,-0.0025427242202904,59,122
4638,relax_and_recompute,0.55,4,4,0,0.0,0.0,26,31
4639,relax_and_recompute,0.55,0,0,0,0.0,0.0,28,27
4640,relax_and_recompute,0.55,6,6,0,0.0,0.0,18,26
4641,relax_and_recompute,0.55,1,1,0,0.0,0.0,23,26
4642,relax_and_recompute,0.55,0,0,0,0.0,0.0,43,43
4643,relax_and_recompute,0.55,2,2,0,0.0,0.0,22,26
4644,relax_and_recompute,0.55,0,0,0,0.0,0.0,15,14
4645,relax_and_recompute,0.55,10,10,0,0.0,0.0,36,48
4646,relax_and_recompute,0.55,6,6,0,2.8016025522275783,-0.3535412006642752,30,37
4647,relax_and_recompute,0.55,1,1,0,0.0,0.0,10,13
4648,relax_and_recompute,0.55,0,0,0,0.0,0.0,12,11
4649,relax_and_recompute,0.55,168,153,15,-1.4597591062543387,0.1638614131178267,55,105
4650,relax_and_recompute,0.55,1,1,0,17.12164821735773,0.0578261695456346,13,17
4651,relax_and_recompute,0.55,0,0,0,0.0,0.0,30,29
4652,relax_and_recompute,0.55,3,3,0,0.0,0.0,36,43
4653,relax_and_recompute,0.55,36,36,0,0.0,0.0,40,60
4654,relax_and_recompute,0.55,0,0,0,0.0,0.0,13,17
4655,relax_and_recompute,0.55,6,8,-2,-4.960402959672933,-0.0115319394462201,23,30
4656,relax_and_recompute,0.55,0,0,0,0.0,0.0,12,16
4657,relax_and_recompute,0.55,0,0,0,0.0,0.0,26,26
4658,relax_and_recompute,0.55,0,0,0,0.0,0.0,22,31
4659,relax_and_recompute,0.55,0,0,0,0.0,0.0,68,68
4660,relax_and_recompute,0.55,0,0,0,0.0,0.0,23,22
4661,relax_and_recompute,0.55,0,0,0,0.0,-0.0349525596057489,43,42
4662,relax_and_recompute,0.55,0,0,0,0.0,0.0,18,17
4663,relax_and_recompute,0.55,3,3,0,0.0,0.0,28,42
4664,relax_and_recompute,0.55,45,50,-5,1.8841541587735409,0.0156030402407787,21,44
4665,relax_and_recompute,0.55,0,0,0,0.0,0.0,36,37
4666,relax_and_recompute,0.55,0,0,0,0.0,0.0,15,14
4667,relax_and_recompute,0.55,1,1,0,0.0,0.0,14,16
4668,relax_and_recompute,0.55,197,211,-14,1.6294158914226389,0.1952030013326532,61,119
4669,relax_and_recompute,0.55,0,0,0,0.0,0.0,19,20
4670,relax_and_recompute,0.55,0,0,0,0.0,0.0,22,22
4671,relax_and_recompute,0.55,0,0,0,0.0,0.0,54,58
4672,relax_and_recompute,0.55,651,651,0,0.0,0.0,65,135
4673,relax_and_recompute,0.55,1,1,0,0.0,0.0,16,18
4674,relax_and_recompute,0.55,7,7,0,0.0,0.0,17,27
4675,relax_and_recompute,0.55,22,4,18,-18.61747849085588,0.1446288399504806,54,71
4676,relax_and_recompute,0.55,0,0,0,0.0,0.0,23,22
4677,relax_and_recompute,0.55,1,0,1,76.88395716132196,-0.1491322016956315,13,16
4678,relax_and_recompute,0.55,155,146,9,-2.3741667241416664,-0.001397205031107,85,131
4679,relax_and_recompute,0.55,44,44,0,0.0,0.0,28,55
4680,relax_and_recompute,0.55,4,4,0,0.0,0.0,18,24
4681,relax_and_recompute,0.55,0,0,0,0.0,0.0,19,22
4682,relax_and_recompute,0.55,0,0,0,0.0,0.0,47,46
4683,relax_and_recompute,0.55,21,19,2,-6.356920988253222,0.0143956759658575,39,64
4684,relax_and_recompute,0.55,0,0,0,0.0,0.0,17,18
4685,relax_and_recompute,0.55,1,1,0,0.0,0.0,23,24
4686,relax_and_recompute,0.55,2,2,0,0.0,0.0,13,16
4687,relax_and_recompute,0.55,22,22,0,0.0,0.0,40,56
4688,relax_and_recompute,0.55,1,1,0,0.0,0.0,10,15
4689,relax_and_recompute,0.55,0,0,0,0.0,0.0,21,20
4690,relax_and_recompute,0.55,4,4,0,0.0,0.0,30,35
4691,relax_and_recompute,0.55,1,1,0,0.0,0.0,71,77
4692,relax_one,0.55,0,0,0,0.0,0.0,17,18
4693,relax_one,0.55,1,1,0,0.0,0.0,43,48
4694,relax_one,0.55,3,3,0,0.0,0.0,38,45
4695,relax_one,0.55,0,0,0,0.0,0.0,12,12
4696,relax_one,0.55,20,18,2,-3.2752299140735204,0.0114158034923678,23,38
4697,relax_one,0.55,0,1,-1,-78.11694026732484,-0.0295512202700576,19,22
4698,relax_one,0.55,976,978,-2,0.1423455471242221,-0.0025418055405018,35,143
4699,relax_one,0.55,0,1,-1,-50.19567681247512,-0.0041327022016595,92,91
4700,relax_one,0.55,2,2,0,0.0,0.0,43,51
4701,relax_one,0.55,1,1,0,0.0,0.0,35,36
4702,relax_one,0.55,1,1,0,0.0,0.0,11,13
4703,relax_one,0.55,22,20,2,-3.01441643358082,0.0082886474985522,10,25
4704,relax_one,0.55,16,16,0,0.0,0.0,86,136
4705,relax_one,0.55,0,0,0,0.0,0.0,10,12
4706,relax_one,0.55,0,0,0,0.0,0.0,32,31
4707,relax_one,0.55,2,2,0,4.970962038347736,-0.0904350603192869,20,26
4708,relax_one,0.55,0,0,0,0.0,0.0,11,11
4709,relax_one,0.55,2,2,0,0.0,0.0,34,42
4710,relax_one,0.55,11,11,0,0.0,0.0,14,25
4711,relax_one,0.55,8,7,1,13.99583228956454,0.1582030612456263,31,46
4712,relax_one,0.55,0,0,0,0.0,0.0,42,45
4713,relax_one,0.55,1265,1240,25,0.1009906236120983,0.0001682713719424,39,173
4714,relax_one,0.55,11,11,0,0.0,0.0,14,24
4715,relax_one,0.55,0,0,0,0.0,0.0,24,25
4716,relax_one,0.55,2,2,0,0.0,0.0,12,19
4717,relax_one,0.55,59,59,0,0.4609819410147793,0.0044552421238692,41,72
4718,relax_one,0.55,182,191,-9,1.446975953367918,0.0358261975695221,59,115
4719,relax_one,0.55,6,6,0,0.0,0.0,32,37
4720,relax_one,0.55,1,1,0,0.0,0.0,20,20
4721,relax_one,0.55,41,32,9,2.305146048931391,0.0775874222420341,12,31
4722,relax_one,0.55,0,0,0,0.0,0.0,10,10
4723,relax_one,0.55,0,0,0,0.0,0.0,20,21
4724,relax_one,0.55,18,18,0,0.0,0.0,39,52
4725,relax_one,0.55,378,395,-17,-0.4859193577000411,-0.0010324457545943,42,109
4726,relax_one,0.55,1,1,0,0.0,0.0,25,28
4727,relax_one,0.55,170,170,0,0.0,0.0,56,106
4728,relax_one,0.55,567,595,-28,0.7834114754025379,-0.002967395777259,87,189
4729,relax_one,0.55,41,41,0,-3.1762323320181167,-0.0099859384844429,56,82
4730,relax_one,0.55,2,2,0,0.0,0.0,13,15
4731,relax_one,0.55,104,88,16,-3.3995451437074067,-0.111275141568526,36,63
4732,relax_one,0.55,0,0,0,0.0,0.0,16,15
4733,relax_one,0.55,0,0,0,0.0,0.0,67,66
4734,relax_one,0.55,13,13,0,0.0,0.0,42,60
4735,relax_one,0.55,0,0,0,0.0,0.0,39,38
4736,relax_one,0.55,8,8,0,0.0,0.0,20,36
4737,relax_one,0.55,0,0,0,0.0,0.0,10,9
4738,relax_one,0.55,1,1,0,0.0,0.0,13,15
4739,relax_one,0.55,6,7,-1,12.522285729298716,0.0299062089849014,34,41
4740,relax_one,0.55,3,3,0,0.0,0.0,37,42
4741,relax_one,0.55,36,36,0,0.0,0.0,18,29
4742,relax_one,0.55,0,0,0,0.0,0.0,23,22
4743,relax_one,0.55,0,0,0,0.0,0.0,13,12
4744,relax_one,0.55,0,0,0,0.0,0.0,15,14
4745,relax_one,0.55,0,0,0,0.0,0.0,69,68
4746,relax_one,0.55,0,0,0,0.0,0.0,40,39
4747,relax_one,0.55,0,0,0,0.0,0.0,89,93
4748,relax_one,0.55,13,13,0,-2.975681235416161,-0.0847204542309565,20,32
4749,relax_one,0.55,2,2,0,0.0,0.0,69,83
4750,relax_one,0.55,2,2,0,0.0,0.0,12,15
4751,relax_one,0.55,0,0,0,0.0,0.0,15,14
4752,relax_one,0.55,0,0,0,0.0,0.0,23,26
4753,relax_one,0.55,2,2,0,0.0,0.0,12,20
4754,relax_one,0.55,201,201,0,0.0,0.0,64,122
4755,relax_one,0.55,7,7,0,0.0,0.0,58,71
4756,relax_one,0.55,0,0,0,0.0,0.0,20,19
4757,relax_one,0.55,510,510,0,0.0060639005596385,-0.0006916839131552,100,191
4758,relax_one,0.55,34,34,0,0.0,0.0,41,61
4759,relax_one,0.55,33,34,-1,-0.6264707699284884,0.0331924782664471,13,31
4760,relax_one,0.55,5,5,0,0.0,0.0,10,15
4761,relax_one,0.55,6,6,0,0.0,0.0,37,47
4762,relax_one,0.55,0,0,0,0.0,0.0,21,21
4763,relax_one,0.55,0,0,0,0.0,0.0,11,10
4764,relax_one,0.55,57,55,2,-1.1796960984034186,9.734149291917849e-05,44,80
4765,relax_one,0.55,6,6,0,0.0,0.0,12,21
4766,relax_one,0.55,2,2,0,42.15913628345388,-0.0181760816329957,37,43
4767,relax_one,0.55,6,6,0,0.0,0.0,41,52
4768,relax_one,0.55,0,0,0,0.0,0.0,90,89
4769,relax_one,0.55,0,0,0,0.0,0.0,22,21
4770,relax_one,0.55,1,1,0,-4.213527745425694,0.0417394626549948,37,43
4771,relax_one,0.55,0,0,0,0.0,0.0,47,47
4772,relax_one,0.55,4,4,0,0.0,0.0,12,20
4773,relax_one,0.55,114,114,0,0.0,0.0,84,124
4774,relax_one,0.55,0,0,0,0.0,0.0,88,92
4775,relax_one,0.55,380,377,3,-0.3714807714610657,-0.0025427242202904,59,122
4776,relax_one,0.55,4,4,0,0.0,0.0,26,31
4777,relax_one,0.55,0,0,0,0.0,0.0,28,27
4778,relax_one,0.55,6,6,0,0.0,0.0,18,26
4779,relax_one,0.55,1,1,0,0.0,0.0,23,26
4780,relax_one,0.55,0,0,0,0.0,0.0,43,43
4781,relax_one,0.55,2,2,0,0.0,0.0,22,26
4782,relax_one,0.55,0,0,0,0.0,0.0,15,14
4783,relax_one,0.55,10,17,-7,3.5874123628873704,0.0856058777554238,36,48
4784,relax_one,0.55,6,6,0,2.8016025522275783,-0.3535412006642752,30,37
4785,relax_one,0.55,1,1,0,0.0,0.0,10,13
4786,relax_one,0.55,0,0,0,0.0,0.0,12,11
4787,relax_one,0.55,168,167,1,-0.7965879277094672,0.0475430066924907,55,105
4788,relax_one,0.55,1,1,0,17.12164821735773,0.0578261695456346,13,17
4789,relax_one,0.55,0,0,0,0.0,0.0,30,29
4790,relax_one,0.55,3,3,0,0.0,0.0,36,43
4791,relax_one,0.55,36,36,0,0.0,0.0,40,60
4792,relax_one,0.55,0,0,0,0.0,0.0,13,17
4793,relax_one,0.55,6,7,-1,-5.27235869178908,0.0082826452568239,23,30
4794,relax_one,0.55,0,0,0,0.0,0.0,12,16
4795,relax_one,0.55,0,0,0,0.0,0.0,26,26
4796,relax_one,0.55,0,0,0,0.0,0.0,22,31
4797,relax_one,0.55,0,0,0,0.0,0.0,68,68
4798,relax_one,0.55,0,0,0,0.0,0.0,23,22
4799,relax_one,0.55,0,0,0,0.0,-0.0348129737608335,43,42
4800,relax_one,0.55,0,0,0,0.0,0.0,18,17
4801,relax_one,0.55,3,3,0,0.0,0.0,28,42
4802,relax_one,0.55,45,45,0,0.1036479088850654,-0.0041754562964496,21,44
4803,relax_one,0.55,0,0,0,0.0,0.0,36,37
4804,relax_one,0.55,0,0,0,0.0,0.0,15,14
4805,relax_one,0.55,1,1,0,0.0,0.0,14,16
4806,relax_one,0.55,197,204,-7,3.484436282689749,0.1757315340586914,61,119
4807,relax_one,0.55,0,0,0,0.0,0.0,19,20
4808,relax_one,0.55,0,0,0,0.0,0.0,22,22
4809,relax_one,0.55,0,0,0,0.0,0.0,54,58
4810,relax_one,0.55,651,651,0,0.0,0.0,65,135
4811,relax_one,0.55,1,1,0,0.0,0.0,16,18
4812,relax_one,0.55,7,7,0,0.0,0.0,17,27
4813,relax_one,0.55,22,4,18,-19.06910671434205,0.1469333863626725,54,71
4814,relax_one,0.55,0,2,-2,-59.99819093035041,-0.0131455917893484,23,22
4815,relax_one,0.55,1,0,1,76.88395716132196,-0.1491322016956315,13,16
4816,relax_one,0.55,155,146,9,-2.3741667241416664,-0.001397205031107,85,131
4817,relax_one,0.55,44,44,0,0.0,0.0,28,55
4818,relax_one,0.55,4,4,0,0.0,0.0,18,24
4819,relax_one,0.55,0,0,0,0.0,0.0,19,22
4820,relax_one,0.55,0,0,0,0.0,0.0,47,46
4821,relax_one,0.55,21,19,2,-6.356920988253222,0.0143956759658575,39,64
4822,relax_one,0.55,0,0,0,0.0,0.0,17,18
4823,relax_one,0.55,1,1,0,0.0,0.0,23,24
4824,relax_one,0.55,2,2,0,0.0,0.0,13,16
4825,relax_one,0.55,22,22,0,0.0,0.0,40,56
4826,relax_one,0.55,1,1,0,0.0,0.0,10,15
4827,relax_one,0.55,0,0,0,0.0,0.0,21,20
4828,relax_one,0.55,4,4,0,0.0,0.0,30,35
4829,relax_one,0.55,1,1,0,0.0,0.0,71,77
4830,just_relax,0.55,0,0,0,0.0,-0.0091692815110081,17,18
4831,just_relax,0.55,1,1,0,0.0009607869158827,0.0014628518031132,43,48
4832,just_relax,0.55,3,3,0,-0.0019521681741139,-7.679999619569777e-05,38,45
4833,just_relax,0.55,0,0,0,0.0,-0.0037600566419999,12,12
4834,just_relax,0.55,20,14,6,1.9891400956483096,0.1544148745043621,23,38
4835,just_relax,0.55,0,1,-1,-78.11694026732484,-0.0295512202700576,19,22
4836,just_relax,0.55,976,1188,-212,1.3106081233515638,0.0257948127350838,35,143
4837,just_relax,0.55,0,4,-4,-39.1818408082167,-0.0156618414823971,92,91
4838,just_relax,0.55,2,2,0,-0.00041775540015,-0.0002552385505018,43,51
4839,just_relax,0.55,1,1,0,-0.0016870080925173,6.40249009676297e-05,35,36
4840,just_relax,0.55,1,1,0,-0.000156439410091,0.0002508982184644,11,13
4841,just_relax,0.55,22,24,-2,-3.49415891827384,0.1000113687896936,10,25
4842,just_relax,0.55,16,13,3,0.2088785180214571,-2.2771107622610032e-05,86,136
4843,just_relax,0.55,0,0,0,0.0,-1.765503840900351e-06,10,12
4844,just_relax,0.55,0,0,0,0.0,-1.014518260578079e-05,32,31
4845,just_relax,0.55,2,2,0,4.970962038347736,-0.0904350603192869,20,26
4846,just_relax,0.55,0,0,0,0.0,0.000269092021105,11,11
4847,just_relax,0.55,2,2,0,0.0009292844165713,-0.0008610890242942,34,42
4848,just_relax,0.55,11,11,0,-0.0003616788843885,0.0005035529702898,14,25
4849,just_relax,0.55,8,7,1,13.99583228956454,0.1582030612456263,31,46
4850,just_relax,0.55,0,0,0,0.0,0.0042083907430441,42,45
4851,just_relax,0.55,1265,1285,-20,2.6849459664833404,-0.1292871249874528,39,173
4852,just_relax,0.55,11,11,0,0.0001627700527109,0.0015600944076981,14,24
4853,just_relax,0.55,0,0,0,0.0,-0.000608053012485,24,25
4854,just_relax,0.55,2,2,0,-2.981324638540173e-05,0.0001440646714581,12,19
4855,just_relax,0.55,59,59,0,0.4609819410147793,0.0044552421238692,41,72
4856,just_relax,0.55,182,178,4,0.0313317398119608,0.0970080713564147,59,115
4857,just_relax,0.55,6,6,0,-0.0020404096920856,0.0011964290694836,32,37
4858,just_relax,0.55,1,0,1,64.5674534074053,-0.0013228453280204,20,20
4859,just_relax,0.55,41,33,8,8.182357833947279,-0.009895766072516,12,31
4860,just_relax,0.55,0,0,0,0.0,-1.5942199658169898e-06,10,10
4861,just_relax,0.55,0,0,0,0.0,0.0018153466622625,20,21
4862,just_relax,0.55,18,18,0,0.0003589278580733,-0.0005865039043362,39,52
4863,just_relax,0.55,378,369,9,2.979528253482861,0.0835817869771829,42,109
4864,just_relax,0.55,1,1,0,-0.0010366044558338,-5.546321229055184e-05,25,28
4865,just_relax,0.55,170,170,0,-0.0002769762706833,-0.0005002245004087,56,106
4866,just_relax,0.55,567,521,46,-0.2657392120378574,0.1239070997048957,87,189
4867,just_relax,0.55,41,43,-2,2.499128887843675,-0.033528056765164,56,82
4868,just_relax,0.55,2,2,0,0.0004861774901456,1.2071037781558047e-06,13,15
4869,just_relax,0.55,104,86,18,5.26724471872344,-0.2840091449765524,36,63
4870,just_relax,0.55,0,0,0,0.0,4.3915154694929015e-06,16,15
4871,just_relax,0.55,0,0,0,0.0,-5.223096419815221e-07,67,66
4872,just_relax,0.55,13,13,0,0.0024384647237383,0.004260897920215,42,60
4873,just_relax,0.55,0,0,0,0.0,0.0005903979895692,39,38
4874,just_relax,0.55,8,8,0,-3.330899971842882e-05,0.0005334774465118,20,36
4875,just_relax,0.55,0,0,0,0.0,-0.0010596071395927,10,9
4876,just_relax,0.55,1,1,0,0.0009644178095271,-1.805181839154013e-05,13,15
4877,just_relax,0.55,6,7,-1,12.522285729298716,0.0299062089849014,34,41
4878,just_relax,0.55,3,3,0,-0.0014185667246167,0.0006213779664755,37,42
4879,just_relax,0.55,36,36,0,7.196136941445275e-06,5.025038399830706e-06,18,29
4880,just_relax,0.55,0,0,0,0.0,-0.0031405837993232,23,22
4881,just_relax,0.55,0,0,0,0.0,1.0504657718901632e-05,13,12
4882,just_relax,0.55,0,0,0,0.0,-0.0007613272869088,15,14
4883,just_relax,0.55,0,0,0,0.0,-0.0017207203528439,69,68
4884,just_relax,0.55,0,0,0,0.0,0.001934163275203,40,39
4885,just_relax,0.55,0,0,0,0.0,0.0016954512903432,89,93
4886,just_relax,0.55,13,13,0,1.511050374969713,-0.0878570612978808,20,32
4887,just_relax,0.55,2,3,-1,-4.120223819609976,0.0096644512108772,69,83
4888,just_relax,0.55,2,2,0,0.0006766545457281,-0.0007958153584334,12,15
4889,just_relax,0.55,0,0,0,0.0,-0.0009758471183408,15,14
4890,just_relax,0.55,0,0,0,0.0,-0.0007570529942456,23,26
4891,just_relax,0.55,2,2,0,-0.0004670837519427,-0.000552899751354,12,20
4892,just_relax,0.55,201,201,0,-5.927609844036397e-05,0.0001073571901385,64,122
4893,just_relax,0.55,7,7,0,-0.0099055150386959,0.0003544031231826,58,71
4894,just_relax,0.55,0,0,0,0.0,-0.0013086772972689,20,19
4895,just_relax,0.55,510,505,5,-0.1096058695008466,0.0001562332230281,100,191
4896,just_relax,0.55,34,34,0,0.0046498502251353,3.462795885833536e-05,41,61
4897,just_relax,0.55,33,21,12,-0.322372772893118,0.0487025778316814,13,31
4898,just_relax,0.55,5,5,0,0.0003476406123752,0.0002826333043987,10,15
4899,just_relax,0.55,6,6,0,-0.0004254358946269,0.0003115870201488,37,47
4900,just_relax,0.55,0,0,0,0.0,0.0007350584472026,21,21
4901,just_relax,0.55,0,0,0,0.0,9.621758975453254e-06,11,10
4902,just_relax,0.55,57,55,2,-1.1796960984034186,9.734149291917849e-05,44,80
4903,just_relax,0.55,6,6,0,0.0001929725905256,-1.6711583069151104e-05,12,21
4904,just_relax,0.55,2,5,-3,10.477360070400792,-0.0167672873232497,37,43
4905,just_relax,0.55,6,6,0,-9.27967616917158e-05,0.0005867078171852,41,52
4906,just_relax,0.55,0,0,0,0.0,0.0258238191424075,90,89
4907,just_relax,0.55,0,0,0,0.0,-0.0001762041220683,22,21
4908,just_relax,0.55,1,5,-4,-25.99394547658536,0.034397478016983,37,43
4909,just_relax,0.55,0,0,0,0.0,0.009279908390236,47,47
4910,just_relax,0.55,4,4,0,-0.0003372893218767,-9.212772776878708e-07,12,20
4911,just_relax,0.55,114,95,19,0.8287298242191525,-0.006531385777559,84,124
4912,just_relax,0.55,0,0,0,0.0,0.0016708237920683,88,92
4913,just_relax,0.55,380,332,48,-1.681066658089314,0.0270328691740772,59,122
4914,just_relax,0.55,4,4,0,2.0677824380754828e-05,-0.000363330475558,26,31
4915,just_relax,0.55,0,0,0,0.0,4.418930553695688e-06,28,27
4916,just_relax,0.55,6,6,0,0.0013890930604816,7.243956427815945e-06,18,26
4917,just_relax,0.55,1,1,0,-0.0014241348598034,0.001861633846505,23,26
4918,just_relax,0.55,0,0,0,0.0,0.0001814651838247,43,43
4919,just_relax,0.55,2,2,0,0.0004949068667485,0.0012137972461528,22,26
4920,just_relax,0.55,0,0,0,0.0,8.316094011640018e-06,15,14
4921,just_relax,0.55,10,17,-7,3.5874123628873704,0.0856058777554238,36,48
4922,just_relax,0.55,6,6,0,2.8016025522275783,-0.3535412006642752,30,37
4923,just_relax,0.55,1,1,0,5.455328151526828e-05,-4.433967369288361e-05,10,13
4924,just_relax,0.55,0,0,0,0.0,-0.0049855760382295,12,11
4925,just_relax,0.55,168,182,-14,1.1771250480206064,-0.0267800915114647,55,105
4926,just_relax,0.55,1,1,0,17.12164821735773,0.0578261695456346,13,17
4927,just_relax,0.55,0,0,0,0.0,0.0003329515887838,30,29
4928,just_relax,0.55,3,3,0,0.000583815366788,0.0008768881680062,36,43
4929,just_relax,0.55,36,36,0,0.0010314806767866,-5.393936385500453e-05,40,60
4930,just_relax,0.55,0,0,0,0.0,0.0017894746066188,13,17
4931,just_relax,0.55,6,7,-1,-5.27235869178908,0.0082826452568239,23,30
4932,just_relax,0.55,0,0,0,0.0,-2.940409977925107e-05,12,16
4933,just_relax,0.55,0,0,0,0.0,3.901708024223183e-06,26,26
4934,just_relax,0.55,0,0,0,0.0,-0.0031688166024113,22,31
4935,just_relax,0.55,0,0,0,0.0,0.0008768193667615,68,68
4936,just_relax,0.55,0,0,0,0.0,-7.938175057398134e-06,23,22
4937,just_relax,0.55,0,0,0,0.0,-0.065399188004364,43,42
4938,just_relax,0.55,0,0,0,0.0,-0.002899723134464,18,17
4939,just_relax,0.55,3,3,0,-0.003194586812441,0.0012605153222713,28,42
4940,just_relax,0.55,45,58,-13,0.9231299892006462,0.088218433779717,21,44
4941,just_relax,0.55,0,0,0,0.0,-0.0112811671875761,36,37
4942,just_relax,0.55,0,0,0,0.0,-3.4878924121017896e-05,15,14
4943,just_relax,0.55,1,1,0,-0.0014549239964907,-0.00058525619921,14,16
4944,just_relax,0.55,197,237,-40,1.3477492998050025,0.0885093784332623,61,119
4945,just_relax,0.55,0,0,0,0.0,-0.0038599581671643,19,20
4946,just_relax,0.55,0,0,0,0.0,-0.0006472841631984,22,22
4947,just_relax,0.55,0,0,0,0.0,-0.0011415137972972,54,58
4948,just_relax,0.55,651,651,0,-0.0003954210755097,0.0002252638081207,65,135
4949,just_relax,0.55,1,1,0,-0.0029471577812358,0.0001749400264638,16,18
4950,just_relax,0.55,7,7,0,0.0002013814076775,0.0006636994664107,17,27
4951,just_relax,0.55,22,7,15,-12.985895473169307,0.1330374466905183,54,71
4952,just_relax,0.55,0,2,-2,-59.99819093035041,-0.0131455917893484,23,22
4953,just_relax,0.55,1,0,1,76.88395716132196,-0.1491322016956315,13,16
4954,just_relax,0.55,155,185,-30,2.3843149677438973,-0.02495720013905,85,131
4955,just_relax,0.55,44,44,0,0.0003032918935019,0.0025857794052007,28,55
4956,just_relax,0.55,4,4,0,-0.0007096785766407,-5.4537984728875166e-05,18,24
4957,just_relax,0.55,0,0,0,0.0,-0.003226028074061,19,22
4958,just_relax,0.55,0,0,0,0.0,0.0048197166778652,47,46
4959,just_relax,0.55,21,27,-6,0.0602947270368474,-0.3310372682946312,39,64
4960,just_relax,0.55,0,0,0,0.0,-0.0037052423868473,17,18
4961,just_relax,0.55,1,1,0,0.0005119856857191,0.0004745196477359,23,24
4962,just_relax,0.55,2,2,0,0.0010275548569325,-0.004970471779609,13,16
4963,just_relax,0.55,22,22,0,0.0038770082111057,0.0004285387996507,40,56
4964,just_relax,0.55,1,1,0,-0.0002865966515059,-0.0003325971221349,10,15
4965,just_relax,0.55,0,0,0,0.0,0.0003384089422906,21,20
4966,just_relax,0.55,4,4,0,-0.0001029723687508,-0.0013906355929786,30,35
4967,just_relax,0.55,1,1,0,0.0051043410712594,-0.0056156512673798,71,77
4968,relax_and_recompute,0.6000000000000001,0,0,0,0.0,0.0,17,18
4969,relax_and_recompute,0.6000000000000001,1,1,0,0.0,0.0,43,48
4970,relax_and_recompute,0.6000000000000001,3,3,0,0.0,0.0,38,45
4971,relax_and_recompute,0.6000000000000001,0,0,0,0.0,0.0,12,12
4972,relax_and_recompute,0.6000000000000001,20,18,2,-3.2752299140735204,0.0114158034923678,23,38
4973,relax_and_recompute,0.6000000000000001,0,0,0,0.0,0.0,19,22
4974,relax_and_recompute,0.6000000000000001,976,1004,-28,-0.0620531910963606,-0.0009330148689207,35,143
4975,relax_and_recompute,0.6000000000000001,0,1,-1,-50.19567681247512,-0.0041327022016595,92,91
4976,relax_and_recompute,0.6000000000000001,2,2,0,0.0,0.0,43,51
4977,relax_and_recompute,0.6000000000000001,1,1,0,0.0,0.0,35,36
4978,relax_and_recompute,0.6000000000000001,1,1,0,0.0,0.0,11,13
4979,relax_and_recompute,0.6000000000000001,22,19,3,-4.957652547927751,0.037406937188411,10,25
4980,relax_and_recompute,0.6000000000000001,16,16,0,0.0,0.0,86,136
4981,relax_and_recompute,0.6000000000000001,0,0,0,0.0,0.0,10,12
4982,relax_and_recompute,0.6000000000000001,0,0,0,0.0,0.0,32,31
4983,relax_and_recompute,0.6000000000000001,2,2,0,4.970962038347736,-0.0904350603192869,20,26
4984,relax_and_recompute,0.6000000000000001,0,0,0,0.0,0.0,11,11
4985,relax_and_recompute,0.6000000000000001,2,2,0,0.0,0.0,34,42
4986,relax_and_recompute,0.6000000000000001,11,11,0,0.0,0.0,14,25
4987,relax_and_recompute,0.6000000000000001,8,8,0,0.0,0.0,31,46
4988,relax_and_recompute,0.6000000000000001,0,0,0,0.0,0.0,42,45
4989,relax_and_recompute,0.6000000000000001,1265,1233,32,-0.0829886923942524,-0.0013136328692162,39,173
4990,relax_and_recompute,0.6000000000000001,11,11,0,0.0,0.0,14,24
4991,relax_and_recompute,0.6000000000000001,0,0,0,0.0,0.0,24,25
4992,relax_and_recompute,0.6000000000000001,2,2,0,0.0,0.0,12,19
4993,relax_and_recompute,0.6000000000000001,59,59,0,0.0,0.0,41,72
4994,relax_and_recompute,0.6000000000000001,182,182,0,0.0,0.0,59,115
4995,relax_and_recompute,0.6000000000000001,6,6,0,0.0,0.0,32,37
4996,relax_and_recompute,0.6000000000000001,1,1,0,0.0,0.0,20,20
4997,relax_and_recompute,0.6000000000000001,41,26,15,-1.6275846340626714,0.0729158968985802,12,31
4998,relax_and_recompute,0.6000000000000001,0,0,0,0.0,0.0,10,10
4999,relax_and_recompute,0.6000000000000001,0,0,0,0.0,0.0,20,21
5000,relax_and_recompute,0.6000000000000001,18,18,0,0.0,0.0,39,52
5001,relax_and_recompute,0.6000000000000001,378,393,-15,0.6108526484877643,4.422482210819645e-05,42,109
5002,relax_and_recompute,0.6000000000000001,1,1,0,0.0,0.0,25,28
5003,relax_and_recompute,0.6000000000000001,170,170,0,0.0,0.0,56,106
5004,relax_and_recompute,0.6000000000000001,567,575,-8,0.4383057260994292,-0.0017656065849445,87,189
5005,relax_and_recompute,0.6000000000000001,41,41,0,0.0,0.0,56,82
5006,relax_and_recompute,0.6000000000000001,2,2,0,0.0,0.0,13,15
5007,relax_and_recompute,0.6000000000000001,104,88,16,-3.3995451437074067,-0.111275141568526,36,63
5008,relax_and_recompute,0.6000000000000001,0,0,0,0.0,0.0,16,15
5009,relax_and_recompute,0.6000000000000001,0,0,0,0.0,0.0,67,66
5010,relax_and_recompute,0.6000000000000001,13,13,0,0.0,0.0,42,60
5011,relax_and_recompute,0.6000000000000001,0,0,0,0.0,0.0,39,38
5012,relax_and_recompute,0.6000000000000001,8,8,0,0.0,0.0,20,36
5013,relax_and_recompute,0.6000000000000001,0,0,0,0.0,0.0,10,9
5014,relax_and_recompute,0.6000000000000001,1,1,0,0.0,0.0,13,15
5015,relax_and_recompute,0.6000000000000001,6,6,0,0.0,0.0,34,41
5016,relax_and_recompute,0.6000000000000001,3,3,0,0.0,0.0,37,42
5017,relax_and_recompute,0.6000000000000001,36,36,0,0.0,0.0,18,29
5018,relax_and_recompute,0.6000000000000001,0,0,0,0.0,0.0,23,22
5019,relax_and_recompute,0.6000000000000001,0,0,0,0.0,0.0,13,12
5020,relax_and_recompute,0.6000000000000001,0,0,0,0.0,0.0,15,14
5021,relax_and_recompute,0.6000000000000001,0,0,0,0.0,0.0,69,68
5022,relax_and_recompute,0.6000000000000001,0,0,0,0.0,0.0,40,39
5023,relax_and_recompute,0.6000000000000001,0,0,0,0.0,0.0,89,93
5024,relax_and_recompute,0.6000000000000001,13,13,0,0.0,0.0,20,32
5025,relax_and_recompute,0.6000000000000001,2,2,0,0.0,0.0,69,83
5026,relax_and_recompute,0.6000000000000001,2,2,0,0.0,0.0,12,15
5027,relax_and_recompute,0.6000000000000001,0,0,0,0.0,0.0,15,14
5028,relax_and_recompute,0.6000000000000001,0,0,0,0.0,0.0,23,26
5029,relax_and_recompute,0.6000000000000001,2,2,0,0.0,0.0,12,20
5030,relax_and_recompute,0.6000000000000001,201,201,0,0.0,0.0,64,122
5031,relax_and_recompute,0.6000000000000001,7,7,0,0.0,0.0,58,71
5032,relax_and_recompute,0.6000000000000001,0,0,0,0.0,0.0,20,19
5033,relax_and_recompute,0.6000000000000001,510,510,0,0.0,0.0,100,191
5034,relax_and_recompute,0.6000000000000001,34,34,0,0.0,0.0,41,61
5035,relax_and_recompute,0.6000000000000001,33,34,-1,-0.5384989905164446,0.0398816997391653,13,31
5036,relax_and_recompute,0.6000000000000001,5,5,0,0.0,0.0,10,15
5037,relax_and_recompute,0.6000000000000001,6,6,0,0.0,0.0,37,47
5038,relax_and_recompute,0.6000000000000001,0,0,0,0.0,0.0,21,21
5039,relax_and_recompute,0.6000000000000001,0,0,0,0.0,0.0,11,10
5040,relax_and_recompute,0.6000000000000001,57,57,0,0.0,0.0,44,80
5041,relax_and_recompute,0.6000000000000001,6,6,0,0.0,0.0,12,21
5042,relax_and_recompute,0.6000000000000001,2,2,0,40.57817790180843,-0.0379305285754828,37,43
5043,relax_and_recompute,0.6000000000000001,6,6,0,0.0,0.0,41,52
5044,relax_and_recompute,0.6000000000000001,0,0,0,0.0,0.0,90,89
5045,relax_and_recompute,0.6000000000000001,0,0,0,0.0,0.0,22,21
5046,relax_and_recompute,0.6000000000000001,1,1,0,0.0,0.0,37,43
5047,relax_and_recompute,0.6000000000000001,0,0,0,0.0,0.0,47,47
5048,relax_and_recompute,0.6000000000000001,4,4,0,0.0,0.0,12,20
5049,relax_and_recompute,0.6000000000000001,114,114,0,0.0,0.0,84,124
5050,relax_and_recompute,0.6000000000000001,0,0,0,0.0,0.0,88,92
5051,relax_and_recompute,0.6000000000000001,380,377,3,-0.3714807714610657,-0.0025427242202904,59,122
5052,relax_and_recompute,0.6000000000000001,4,4,0,0.0,0.0,26,31
5053,relax_and_recompute,0.6000000000000001,0,0,0,0.0,0.0,28,27
5054,relax_and_recompute,0.6000000000000001,6,6,0,0.0,0.0,18,26
5055,relax_and_recompute,0.6000000000000001,1,1,0,0.0,0.0,23,26
5056,relax_and_recompute,0.6000000000000001,0,0,0,0.0,0.0,43,43
5057,relax_and_recompute,0.6000000000000001,2,2,0,0.0,0.0,22,26
5058,relax_and_recompute,0.6000000000000001,0,0,0,0.0,0.0,15,14
5059,relax_and_recompute,0.6000000000000001,10,10,0,0.0,0.0,36,48
5060,relax_and_recompute,0.6000000000000001,6,6,0,2.8016025522275783,-0.3535412006642752,30,37
5061,relax_and_recompute,0.6000000000000001,1,1,0,0.0,0.0,10,13
5062,relax_and_recompute,0.6000000000000001,0,0,0,0.0,0.0,12,11
5063,relax_and_recompute,0.6000000000000001,168,153,15,-1.4597591062543387,0.1638614131178267,55,105
5064,relax_and_recompute,0.6000000000000001,1,1,0,17.12164821735773,0.0578261695456346,13,17
5065,relax_and_recompute,0.6000000000000001,0,0,0,0.0,0.0,30,29
5066,relax_and_recompute,0.6000000000000001,3,3,0,0.0,0.0,36,43
5067,relax_and_recompute,0.6000000000000001,36,36,0,0.0,0.0,40,60
5068,relax_and_recompute,0.6000000000000001,0,0,0,0.0,0.0,13,17
5069,relax_and_recompute,0.6000000000000001,6,8,-2,-4.960402959672933,-0.0115319394462201,23,30
5070,relax_and_recompute,0.6000000000000001,0,0,0,0.0,0.0,12,16
5071,relax_and_recompute,0.6000000000000001,0,0,0,0.0,0.0,26,26
5072,relax_and_recompute,0.6000000000000001,0,0,0,0.0,0.0,22,31
5073,relax_and_recompute,0.6000000000000001,0,0,0,0.0,0.0,68,68
5074,relax_and_recompute,0.6000000000000001,0,0,0,0.0,0.0,23,22
5075,relax_and_recompute,0.6000000000000001,0,0,0,0.0,-0.0349525596057489,43,42
5076,relax_and_recompute,0.6000000000000001,0,0,0,0.0,0.0,18,17
5077,relax_and_recompute,0.6000000000000001,3,3,0,0.0,0.0,28,42
5078,relax_and_recompute,0.6000000000000001,45,45,0,0.1036479088850654,-0.0041754562964496,21,44
5079,relax_and_recompute,0.6000000000000001,0,0,0,0.0,0.0,36,37
5080,relax_and_recompute,0.6000000000000001,0,0,0,0.0,0.0,15,14
5081,relax_and_recompute,0.6000000000000001,1,1,0,0.0,0.0,14,16
5082,relax_and_recompute,0.6000000000000001,197,211,-14,1.6294158914226389,0.1952030013326532,61,119
5083,relax_and_recompute,0.6000000000000001,0,0,0,0.0,0.0,19,20
5084,relax_and_recompute,0.6000000000000001,0,0,0,0.0,0.0,22,22
5085,relax_and_recompute,0.6000000000000001,0,0,0,0.0,0.0,54,58
5086,relax_and_recompute,0.6000000000000001,651,651,0,0.0,0.0,65,135
5087,relax_and_recompute,0.6000000000000001,1,1,0,0.0,0.0,16,18
5088,relax_and_recompute,0.6000000000000001,7,7,0,0.0,0.0,17,27
5089,relax_and_recompute,0.6000000000000001,22,22,0,0.0,0.0,54,71
5090,relax_and_recompute,0.6000000000000001,0,0,0,0.0,0.0,23,22
5091,relax_and_recompute,0.6000000000000001,1,0,1,76.88395716132196,-0.1491322016956315,13,16
5092,relax_and_recompute,0.6000000000000001,155,146,9,-2.3741667241416664,-0.001397205031107,85,131
5093,relax_and_recompute,0.6000000000000001,44,44,0,0.0,0.0,28,55
5094,relax_and_recompute,0.6000000000000001,4,4,0,0.0,0.0,18,24
5095,relax_and_recompute,0.6000000000000001,0,0,0,0.0,0.0,19,22
5096,relax_and_recompute,0.6000000000000001,0,0,0,0.0,0.0,47,46
5097,relax_and_recompute,0.6000000000000001,21,19,2,-6.356920988253222,0.0143956759658575,39,64
5098,relax_and_recompute,0.6000000000000001,0,0,0,0.0,0.0,17,18
5099,relax_and_recompute,0.6000000000000001,1,1,0,0.0,0.0,23,24
5100,relax_and_recompute,0.6000000000000001,2,2,0,0.0,0.0,13,16
5101,relax_and_recompute,0.6000000000000001,22,22,0,0.0,0.0,40,56
5102,relax_and_recompute,0.6000000000000001,1,1,0,0.0,0.0,10,15
5103,relax_and_recompute,0.6000000000000001,0,0,0,0.0,0.0,21,20
5104,relax_and_recompute,0.6000000000000001,4,4,0,0.0,0.0,30,35
5105,relax_and_recompute,0.6000000000000001,1,1,0,0.0,0.0,71,77
5106,relax_one,0.6000000000000001,0,0,0,0.0,0.0,17,18
5107,relax_one,0.6000000000000001,1,1,0,0.0,0.0,43,48
5108,relax_one,0.6000000000000001,3,3,0,0.0,0.0,38,45
5109,relax_one,0.6000000000000001,0,0,0,0.0,0.0,12,12
5110,relax_one,0.6000000000000001,20,18,2,-3.2752299140735204,0.0114158034923678,23,38
5111,relax_one,0.6000000000000001,0,1,-1,-78.11694026732484,-0.0295512202700576,19,22
5112,relax_one,0.6000000000000001,976,978,-2,0.1423455471242221,-0.0025418055405018,35,143
5113,relax_one,0.6000000000000001,0,1,-1,-50.19567681247512,-0.0041327022016595,92,91
5114,relax_one,0.6000000000000001,2,2,0,0.0,0.0,43,51
5115,relax_one,0.6000000000000001,1,1,0,0.0,0.0,35,36
5116,relax_one,0.6000000000000001,1,1,0,0.0,0.0,11,13
5117,relax_one,0.6000000000000001,22,20,2,-3.01441643358082,0.0082886474985522,10,25
5118,relax_one,0.6000000000000001,16,16,0,0.0,0.0,86,136
5119,relax_one,0.6000000000000001,0,0,0,0.0,0.0,10,12
5120,relax_one,0.6000000000000001,0,0,0,0.0,0.0,32,31
5121,relax_one,0.6000000000000001,2,2,0,4.970962038347736,-0.0904350603192869,20,26
5122,relax_one,0.6000000000000001,0,0,0,0.0,0.0,11,11
5123,relax_one,0.6000000000000001,2,2,0,0.0,0.0,34,42
5124,relax_one,0.6000000000000001,11,11,0,0.0,0.0,14,25
5125,relax_one,0.6000000000000001,8,7,1,13.99583228956454,0.1582030612456263,31,46
5126,relax_one,0.6000000000000001,0,0,0,0.0,0.0,42,45
5127,relax_one,0.6000000000000001,1265,1240,25,0.1009906236120983,0.0001682713719424,39,173
5128,relax_one,0.6000000000000001,11,11,0,0.0,0.0,14,24
5129,relax_one,0.6000000000000001,0,0,0,0.0,0.0,24,25
5130,relax_one,0.6000000000000001,2,2,0,0.0,0.0,12,19
5131,relax_one,0.6000000000000001,59,59,0,0.4609819410147793,0.0044552421238692,41,72
5132,relax_one,0.6000000000000001,182,191,-9,1.446975953367918,0.0358261975695221,59,115
5133,relax_one,0.6000000000000001,6,6,0,0.0,0.0,32,37
5134,relax_one,0.6000000000000001,1,1,0,0.0,0.0,20,20
5135,relax_one,0.6000000000000001,41,32,9,2.305146048931391,0.0775874222420341,12,31
5136,relax_one,0.6000000000000001,0,0,0,0.0,0.0,10,10
5137,relax_one,0.6000000000000001,0,0,0,0.0,0.0,20,21
5138,relax_one,0.6000000000000001,18,18,0,0.0,0.0,39,52
5139,relax_one,0.6000000000000001,378,395,-17,-0.4859193577000411,-0.0010324457545943,42,109
5140,relax_one,0.6000000000000001,1,1,0,0.0,0.0,25,28
5141,relax_one,0.6000000000000001,170,170,0,0.0,0.0,56,106
5142,relax_one,0.6000000000000001,567,595,-28,0.7834114754025379,-0.002967395777259,87,189
5143,relax_one,0.6000000000000001,41,41,0,-3.1762323320181167,-0.0099859384844429,56,82
5144,relax_one,0.6000000000000001,2,2,0,0.0,0.0,13,15
5145,relax_one,0.6000000000000001,104,88,16,-3.3995451437074067,-0.111275141568526,36,63
5146,relax_one,0.6000000000000001,0,0,0,0.0,0.0,16,15
5147,relax_one,0.6000000000000001,0,0,0,0.0,0.0,67,66
5148,relax_one,0.6000000000000001,13,13,0,0.0,0.0,42,60
5149,relax_one,0.6000000000000001,0,0,0,0.0,0.0,39,38
5150,relax_one,0.6000000000000001,8,8,0,0.0,0.0,20,36
5151,relax_one,0.6000000000000001,0,0,0,0.0,0.0,10,9
5152,relax_one,0.6000000000000001,1,1,0,0.0,0.0,13,15
5153,relax_one,0.6000000000000001,6,7,-1,12.522285729298716,0.0299062089849014,34,41
5154,relax_one,0.6000000000000001,3,3,0,0.0,0.0,37,42
5155,relax_one,0.6000000000000001,36,36,0,0.0,0.0,18,29
5156,relax_one,0.6000000000000001,0,0,0,0.0,0.0,23,22
5157,relax_one,0.6000000000000001,0,0,0,0.0,0.0,13,12
5158,relax_one,0.6000000000000001,0,0,0,0.0,0.0,15,14
5159,relax_one,0.6000000000000001,0,0,0,0.0,0.0,69,68
5160,relax_one,0.6000000000000001,0,0,0,0.0,0.0,40,39
5161,relax_one,0.6000000000000001,0,0,0,0.0,0.0,89,93
5162,relax_one,0.6000000000000001,13,13,0,-2.975681235416161,-0.0847204542309565,20,32
5163,relax_one,0.6000000000000001,2,2,0,0.0,0.0,69,83
5164,relax_one,0.6000000000000001,2,2,0,0.0,0.0,12,15
5165,relax_one,0.6000000000000001,0,0,0,0.0,0.0,15,14
5166,relax_one,0.6000000000000001,0,0,0,0.0,0.0,23,26
5167,relax_one,0.6000000000000001,2,2,0,0.0,0.0,12,20
5168,relax_one,0.6000000000000001,201,201,0,0.0,0.0,64,122
5169,relax_one,0.6000000000000001,7,7,0,0.0,0.0,58,71
5170,relax_one,0.6000000000000001,0,0,0,0.0,0.0,20,19
5171,relax_one,0.6000000000000001,510,510,0,0.0060639005596385,-0.0006916839131552,100,191
5172,relax_one,0.6000000000000001,34,34,0,0.0,0.0,41,61
5173,relax_one,0.6000000000000001,33,34,-1,-0.6264707699284884,0.0331924782664471,13,31
5174,relax_one,0.6000000000000001,5,5,0,0.0,0.0,10,15
5175,relax_one,0.6000000000000001,6,6,0,0.0,0.0,37,47
5176,relax_one,0.6000000000000001,0,0,0,0.0,0.0,21,21
5177,relax_one,0.6000000000000001,0,0,0,0.0,0.0,11,10
5178,relax_one,0.6000000000000001,57,55,2,-1.1796960984034186,9.734149291917849e-05,44,80
5179,relax_one,0.6000000000000001,6,6,0,0.0,0.0,12,21
5180,relax_one,0.6000000000000001,2,2,0,42.15913628345388,-0.0181760816329957,37,43
5181,relax_one,0.6000000000000001,6,6,0,0.0,0.0,41,52
5182,relax_one,0.6000000000000001,0,0,0,0.0,0.0,90,89
5183,relax_one,0.6000000000000001,0,0,0,0.0,0.0,22,21
5184,relax_one,0.6000000000000001,1,1,0,-4.213527745425694,0.0417394626549948,37,43
5185,relax_one,0.6000000000000001,0,0,0,0.0,0.0,47,47
5186,relax_one,0.6000000000000001,4,4,0,0.0,0.0,12,20
5187,relax_one,0.6000000000000001,114,114,0,0.0,0.0,84,124
5188,relax_one,0.6000000000000001,0,0,0,0.0,0.0,88,92
5189,relax_one,0.6000000000000001,380,377,3,-0.3714807714610657,-0.0025427242202904,59,122
5190,relax_one,0.6000000000000001,4,4,0,0.0,0.0,26,31
5191,relax_one,0.6000000000000001,0,0,0,0.0,0.0,28,27
5192,relax_one,0.6000000000000001,6,6,0,0.0,0.0,18,26
5193,relax_one,0.6000000000000001,1,1,0,0.0,0.0,23,26
5194,relax_one,0.6000000000000001,0,0,0,0.0,0.0,43,43
5195,relax_one,0.6000000000000001,2,2,0,0.0,0.0,22,26
5196,relax_one,0.6000000000000001,0,0,0,0.0,0.0,15,14
5197,relax_one,0.6000000000000001,10,17,-7,3.5874123628873704,0.0856058777554238,36,48
5198,relax_one,0.6000000000000001,6,6,0,2.8016025522275783,-0.3535412006642752,30,37
5199,relax_one,0.6000000000000001,1,1,0,0.0,0.0,10,13
5200,relax_one,0.6000000000000001,0,0,0,0.0,0.0,12,11
5201,relax_one,0.6000000000000001,168,167,1,-0.7965879277094672,0.0475430066924907,55,105
5202,relax_one,0.6000000000000001,1,1,0,17.12164821735773,0.0578261695456346,13,17
5203,relax_one,0.6000000000000001,0,0,0,0.0,0.0,30,29
5204,relax_one,0.6000000000000001,3,3,0,0.0,0.0,36,43
5205,relax_one,0.6000000000000001,36,36,0,0.0,0.0,40,60
5206,relax_one,0.6000000000000001,0,0,0,0.0,0.0,13,17
5207,relax_one,0.6000000000000001,6,7,-1,-5.27235869178908,0.0082826452568239,23,30
5208,relax_one,0.6000000000000001,0,0,0,0.0,0.0,12,16
5209,relax_one,0.6000000000000001,0,0,0,0.0,0.0,26,26
5210,relax_one,0.6000000000000001,0,0,0,0.0,0.0,22,31
5211,relax_one,0.6000000000000001,0,0,0,0.0,0.0,68,68
5212,relax_one,0.6000000000000001,0,0,0,0.0,0.0,23,22
5213,relax_one,0.6000000000000001,0,0,0,0.0,-0.0348129737608335,43,42
5214,relax_one,0.6000000000000001,0,0,0,0.0,0.0,18,17
5215,relax_one,0.6000000000000001,3,3,0,0.0,0.0,28,42
5216,relax_one,0.6000000000000001,45,45,0,0.1036479088850654,-0.0041754562964496,21,44
5217,relax_one,0.6000000000000001,0,0,0,0.0,0.0,36,37
5218,relax_one,0.6000000000000001,0,0,0,0.0,0.0,15,14
5219,relax_one,0.6000000000000001,1,1,0,0.0,0.0,14,16
5220,relax_one,0.6000000000000001,197,204,-7,3.484436282689749,0.1757315340586914,61,119
5221,relax_one,0.6000000000000001,0,0,0,0.0,0.0,19,20
5222,relax_one,0.6000000000000001,0,0,0,0.0,0.0,22,22
5223,relax_one,0.6000000000000001,0,0,0,0.0,0.0,54,58
5224,relax_one,0.6000000000000001,651,651,0,0.0,0.0,65,135
5225,relax_one,0.6000000000000001,1,1,0,0.0,0.0,16,18
5226,relax_one,0.6000000000000001,7,7,0,0.0,0.0,17,27
5227,relax_one,0.6000000000000001,22,4,18,-19.06910671434205,0.1469333863626725,54,71
5228,relax_one,0.6000000000000001,0,2,-2,-59.99819093035041,-0.0131455917893484,23,22
5229,relax_one,0.6000000000000001,1,0,1,76.88395716132196,-0.1491322016956315,13,16
5230,relax_one,0.6000000000000001,155,146,9,-2.3741667241416664,-0.001397205031107,85,131
5231,relax_one,0.6000000000000001,44,44,0,0.0,0.0,28,55
5232,relax_one,0.6000000000000001,4,4,0,0.0,0.0,18,24
5233,relax_one,0.6000000000000001,0,0,0,0.0,0.0,19,22
5234,relax_one,0.6000000000000001,0,0,0,0.0,0.0,47,46
5235,relax_one,0.6000000000000001,21,19,2,-6.356920988253222,0.0143956759658575,39,64
5236,relax_one,0.6000000000000001,0,0,0,0.0,0.0,17,18
5237,relax_one,0.6000000000000001,1,1,0,0.0,0.0,23,24
5238,relax_one,0.6000000000000001,2,2,0,0.0,0.0,13,16
5239,relax_one,0.6000000000000001,22,22,0,0.0,0.0,40,56
5240,relax_one,0.6000000000000001,1,1,0,0.0,0.0,10,15
5241,relax_one,0.6000000000000001,0,0,0,0.0,0.0,21,20
5242,relax_one,0.6000000000000001,4,4,0,0.0,0.0,30,35
5243,relax_one,0.6000000000000001,1,1,0,0.0,0.0,71,77
5244,just_relax,0.6000000000000001,0,0,0,0.0,-0.0091692815110081,17,18
5245,just_relax,0.6000000000000001,1,1,0,0.0009607869158827,0.0014628518031132,43,48
5246,just_relax,0.6000000000000001,3,3,0,-0.0019521681741139,-7.679999619569777e-05,38,45
5247,just_relax,0.6000000000000001,0,0,0,0.0,-0.0037600566419999,12,12
5248,just_relax,0.6000000000000001,20,14,6,1.9891400956483096,0.1544148745043621,23,38
5249,just_relax,0.6000000000000001,0,1,-1,-78.11694026732484,-0.0295512202700576,19,22
5250,just_relax,0.6000000000000001,976,1188,-212,1.3106081233515638,0.0257948127350838,35,143
5251,just_relax,0.6000000000000001,0,4,-4,-39.1818408082167,-0.0156618414823971,92,91
5252,just_relax,0.6000000000000001,2,2,0,-0.00041775540015,-0.0002552385505018,43,51
5253,just_relax,0.6000000000000001,1,1,0,-0.0016870080925173,6.40249009676297e-05,35,36
5254,just_relax,0.6000000000000001,1,1,0,-0.000156439410091,0.0002508982184644,11,13
5255,just_relax,0.6000000000000001,22,24,-2,-3.49415891827384,0.1000113687896936,10,25
5256,just_relax,0.6000000000000001,16,13,3,0.2088785180214571,-2.2771107622610032e-05,86,136
5257,just_relax,0.6000000000000001,0,0,0,0.0,-1.765503840900351e-06,10,12
5258,just_relax,0.6000000000000001,0,0,0,0.0,-1.014518260578079e-05,32,31
5259,just_relax,0.6000000000000001,2,2,0,4.970962038347736,-0.0904350603192869,20,26
5260,just_relax,0.6000000000000001,0,0,0,0.0,0.000269092021105,11,11
5261,just_relax,0.6000000000000001,2,2,0,0.0009292844165713,-0.0008610890242942,34,42
5262,just_relax,0.6000000000000001,11,11,0,-0.0003616788843885,0.0005035529702898,14,25
5263,just_relax,0.6000000000000001,8,7,1,13.99583228956454,0.1582030612456263,31,46
5264,just_relax,0.6000000000000001,0,0,0,0.0,0.0042083907430441,42,45
5265,just_relax,0.6000000000000001,1265,1285,-20,2.6849459664833404,-0.1292871249874528,39,173
5266,just_relax,0.6000000000000001,11,11,0,0.0001627700527109,0.0015600944076981,14,24
5267,just_relax,0.6000000000000001,0,0,0,0.0,-0.000608053012485,24,25
5268,just_relax,0.6000000000000001,2,2,0,-2.981324638540173e-05,0.0001440646714581,12,19
5269,just_relax,0.6000000000000001,59,59,0,0.4609819410147793,0.0044552421238692,41,72
5270,just_relax,0.6000000000000001,182,178,4,0.0313317398119608,0.0970080713564147,59,115
5271,just_relax,0.6000000000000001,6,6,0,-0.0020404096920856,0.0011964290694836,32,37
5272,just_relax,0.6000000000000001,1,0,1,64.5674534074053,-0.0013228453280204,20,20
5273,just_relax,0.6000000000000001,41,33,8,8.182357833947279,-0.009895766072516,12,31
5274,just_relax,0.6000000000000001,0,0,0,0.0,-1.5942199658169898e-06,10,10
5275,just_relax,0.6000000000000001,0,0,0,0.0,0.0018153466622625,20,21
5276,just_relax,0.6000000000000001,18,18,0,0.0003589278580733,-0.0005865039043362,39,52
5277,just_relax,0.6000000000000001,378,369,9,2.979528253482861,0.0835817869771829,42,109
5278,just_relax,0.6000000000000001,1,1,0,-0.0010366044558338,-5.546321229055184e-05,25,28
5279,just_relax,0.6000000000000001,170,170,0,-0.0002769762706833,-0.0005002245004087,56,106
5280,just_relax,0.6000000000000001,567,521,46,-0.2657392120378574,0.1239070997048957,87,189
5281,just_relax,0.6000000000000001,41,43,-2,2.499128887843675,-0.033528056765164,56,82
5282,just_relax,0.6000000000000001,2,2,0,0.0004861774901456,1.2071037781558047e-06,13,15
5283,just_relax,0.6000000000000001,104,86,18,5.26724471872344,-0.2840091449765524,36,63
5284,just_relax,0.6000000000000001,0,0,0,0.0,4.3915154694929015e-06,16,15
5285,just_relax,0.6000000000000001,0,0,0,0.0,-5.223096419815221e-07,67,66
5286,just_relax,0.6000000000000001,13,13,0,0.0024384647237383,0.004260897920215,42,60
5287,just_relax,0.6000000000000001,0,0,0,0.0,0.0005903979895692,39,38
5288,just_relax,0.6000000000000001,8,8,0,-3.330899971842882e-05,0.0005334774465118,20,36
5289,just_relax,0.6000000000000001,0,0,0,0.0,-0.0010596071395927,10,9
5290,just_relax,0.6000000000000001,1,1,0,0.0009644178095271,-1.805181839154013e-05,13,15
5291,just_relax,0.6000000000000001,6,7,-1,12.522285729298716,0.0299062089849014,34,41
5292,just_relax,0.6000000000000001,3,3,0,-0.0014185667246167,0.0006213779664755,37,42
5293,just_relax,0.6000000000000001,36,36,0,7.196136941445275e-06,5.025038399830706e-06,18,29
5294,just_relax,0.6000000000000001,0,0,0,0.0,-0.0031405837993232,23,22
5295,just_relax,0.6000000000000001,0,0,0,0.0,1.0504657718901632e-05,13,12
5296,just_relax,0.6000000000000001,0,0,0,0.0,-0.0007613272869088,15,14
5297,just_relax,0.6000000000000001,0,0,0,0.0,-0.0017207203528439,69,68
5298,just_relax,0.6000000000000001,0,0,0,0.0,0.001934163275203,40,39
5299,just_relax,0.6000000000000001,0,0,0,0.0,0.0016954512903432,89,93
5300,just_relax,0.6000000000000001,13,13,0,1.511050374969713,-0.0878570612978808,20,32
5301,just_relax,0.6000000000000001,2,3,-1,-4.120223819609976,0.0096644512108772,69,83
5302,just_relax,0.6000000000000001,2,2,0,0.0006766545457281,-0.0007958153584334,12,15
5303,just_relax,0.6000000000000001,0,0,0,0.0,-0.0009758471183408,15,14
5304,just_relax,0.6000000000000001,0,0,0,0.0,-0.0007570529942456,23,26
5305,just_relax,0.6000000000000001,2,2,0,-0.0004670837519427,-0.000552899751354,12,20
5306,just_relax,0.6000000000000001,201,201,0,-5.927609844036397e-05,0.0001073571901385,64,122
5307,just_relax,0.6000000000000001,7,7,0,-0.0099055150386959,0.0003544031231826,58,71
5308,just_relax,0.6000000000000001,0,0,0,0.0,-0.0013086772972689,20,19
5309,just_relax,0.6000000000000001,510,505,5,-0.1096058695008466,0.0001562332230281,100,191
5310,just_relax,0.6000000000000001,34,34,0,0.0046498502251353,3.462795885833536e-05,41,61
5311,just_relax,0.6000000000000001,33,21,12,-0.322372772893118,0.0487025778316814,13,31
5312,just_relax,0.6000000000000001,5,5,0,0.0003476406123752,0.0002826333043987,10,15
5313,just_relax,0.6000000000000001,6,6,0,-0.0004254358946269,0.0003115870201488,37,47
5314,just_relax,0.6000000000000001,0,0,0,0.0,0.0007350584472026,21,21
5315,just_relax,0.6000000000000001,0,0,0,0.0,9.621758975453254e-06,11,10
5316,just_relax,0.6000000000000001,57,55,2,-1.1796960984034186,9.734149291917849e-05,44,80
5317,just_relax,0.6000000000000001,6,6,0,0.0001929725905256,-1.6711583069151104e-05,12,21
5318,just_relax,0.6000000000000001,2,5,-3,10.477360070400792,-0.0167672873232497,37,43
5319,just_relax,0.6000000000000001,6,6,0,-9.27967616917158e-05,0.0005867078171852,41,52
5320,just_relax,0.6000000000000001,0,0,0,0.0,0.0258238191424075,90,89
5321,just_relax,0.6000000000000001,0,0,0,0.0,-0.0001762041220683,22,21
5322,just_relax,0.6000000000000001,1,5,-4,-25.99394547658536,0.034397478016983,37,43
5323,just_relax,0.6000000000000001,0,0,0,0.0,0.009279908390236,47,47
5324,just_relax,0.6000000000000001,4,4,0,-0.0003372893218767,-9.212772776878708e-07,12,20
5325,just_relax,0.6000000000000001,114,95,19,0.8287298242191525,-0.006531385777559,84,124
5326,just_relax,0.6000000000000001,0,0,0,0.0,0.0016708237920683,88,92
5327,just_relax,0.6000000000000001,380,332,48,-1.681066658089314,0.0270328691740772,59,122
5328,just_relax,0.6000000000000001,4,4,0,2.0677824380754828e-05,-0.000363330475558,26,31
5329,just_relax,0.6000000000000001,0,0,0,0.0,4.418930553695688e-06,28,27
5330,just_relax,0.6000000000000001,6,6,0,0.0013890930604816,7.243956427815945e-06,18,26
5331,just_relax,0.6000000000000001,1,1,0,-0.0014241348598034,0.001861633846505,23,26
5332,just_relax,0.6000000000000001,0,0,0,0.0,0.0001814651838247,43,43
5333,just_relax,0.6000000000000001,2,2,0,0.0004949068667485,0.0012137972461528,22,26
5334,just_relax,0.6000000000000001,0,0,0,0.0,8.316094011640018e-06,15,14
5335,just_relax,0.6000000000000001,10,17,-7,3.5874123628873704,0.0856058777554238,36,48
5336,just_relax,0.6000000000000001,6,6,0,2.8016025522275783,-0.3535412006642752,30,37
5337,just_relax,0.6000000000000001,1,1,0,5.455328151526828e-05,-4.433967369288361e-05,10,13
5338,just_relax,0.6000000000000001,0,0,0,0.0,-0.0049855760382295,12,11
5339,just_relax,0.6000000000000001,168,182,-14,1.1771250480206064,-0.0267800915114647,55,105
5340,just_relax,0.6000000000000001,1,1,0,17.12164821735773,0.0578261695456346,13,17
5341,just_relax,0.6000000000000001,0,0,0,0.0,0.0003329515887838,30,29
5342,just_relax,0.6000000000000001,3,3,0,0.000583815366788,0.0008768881680062,36,43
5343,just_relax,0.6000000000000001,36,36,0,0.0010314806767866,-5.393936385500453e-05,40,60
5344,just_relax,0.6000000000000001,0,0,0,0.0,0.0017894746066188,13,17
5345,just_relax,0.6000000000000001,6,7,-1,-5.27235869178908,0.0082826452568239,23,30
5346,just_relax,0.6000000000000001,0,0,0,0.0,-2.940409977925107e-05,12,16
5347,just_relax,0.6000000000000001,0,0,0,0.0,3.901708024223183e-06,26,26
5348,just_relax,0.6000000000000001,0,0,0,0.0,-0.0031688166024113,22,31
5349,just_relax,0.6000000000000001,0,0,0,0.0,0.0008768193667615,68,68
5350,just_relax,0.6000000000000001,0,0,0,0.0,-7.938175057398134e-06,23,22
5351,just_relax,0.6000000000000001,0,0,0,0.0,-0.065399188004364,43,42
5352,just_relax,0.6000000000000001,0,0,0,0.0,-0.002899723134464,18,17
5353,just_relax,0.6000000000000001,3,3,0,-0.003194586812441,0.0012605153222713,28,42
5354,just_relax,0.6000000000000001,45,58,-13,0.9231299892006462,0.088218433779717,21,44
5355,just_relax,0.6000000000000001,0,0,0,0.0,-0.0112811671875761,36,37
5356,just_relax,0.6000000000000001,0,0,0,0.0,-3.4878924121017896e-05,15,14
5357,just_relax,0.6000000000000001,1,1,0,-0.0014549239964907,-0.00058525619921,14,16
5358,just_relax,0.6000000000000001,197,237,-40,1.3477492998050025,0.0885093784332623,61,119
5359,just_relax,0.6000000000000001,0,0,0,0.0,-0.0038599581671643,19,20
5360,just_relax,0.6000000000000001,0,0,0,0.0,-0.0006472841631984,22,22
5361,just_relax,0.6000000000000001,0,0,0,0.0,-0.0011415137972972,54,58
5362,just_relax,0.6000000000000001,651,651,0,-0.0003954210755097,0.0002252638081207,65,135
5363,just_relax,0.6000000000000001,1,1,0,-0.0029471577812358,0.0001749400264638,16,18
5364,just_relax,0.6000000000000001,7,7,0,0.0002013814076775,0.0006636994664107,17,27
5365,just_relax,0.6000000000000001,22,7,15,-12.985895473169307,0.1330374466905183,54,71
5366,just_relax,0.6000000000000001,0,2,-2,-59.99819093035041,-0.0131455917893484,23,22
5367,just_relax,0.6000000000000001,1,0,1,76.88395716132196,-0.1491322016956315,13,16
5368,just_relax,0.6000000000000001,155,185,-30,2.3843149677438973,-0.02495720013905,85,131
5369,just_relax,0.6000000000000001,44,44,0,0.0003032918935019,0.0025857794052007,28,55
5370,just_relax,0.6000000000000001,4,4,0,-0.0007096785766407,-5.4537984728875166e-05,18,24
5371,just_relax,0.6000000000000001,0,0,0,0.0,-0.003226028074061,19,22
5372,just_relax,0.6000000000000001,0,0,0,0.0,0.0048197166778652,47,46
5373,just_relax,0.6000000000000001,21,27,-6,0.0602947270368474,-0.3310372682946312,39,64
5374,just_relax,0.6000000000000001,0,0,0,0.0,-0.0037052423868473,17,18
5375,just_relax,0.6000000000000001,1,1,0,0.0005119856857191,0.0004745196477359,23,24
5376,just_relax,0.6000000000000001,2,2,0,0.0010275548569325,-0.004970471779609,13,16
5377,just_relax,0.6000000000000001,22,22,0,0.0038770082111057,0.0004285387996507,40,56
5378,just_relax,0.6000000000000001,1,1,0,-0.0002865966515059,-0.0003325971221349,10,15
5379,just_relax,0.6000000000000001,0,0,0,0.0,0.0003384089422906,21,20
5380,just_relax,0.6000000000000001,4,4,0,-0.0001029723687508,-0.0013906355929786,30,35
5381,just_relax,0.6000000000000001,1,1,0,0.0051043410712594,-0.0056156512673798,71,77
5382,relax_and_recompute,0.65,0,0,0,0.0,0.0,17,18
5383,relax_and_recompute,0.65,1,1,0,0.0,0.0,43,48
5384,relax_and_recompute,0.65,3,3,0,0.0,0.0,38,45
5385,relax_and_recompute,0.65,0,0,0,0.0,0.0,12,12
5386,relax_and_recompute,0.65,20,18,2,-3.2752299140735204,0.0114158034923678,23,38
5387,relax_and_recompute,0.65,0,0,0,0.0,0.0,19,22
5388,relax_and_recompute,0.65,976,1004,-28,-0.0620531910963606,-0.0009330148689207,35,143
5389,relax_and_recompute,0.65,0,0,0,0.0,0.0,92,91
5390,relax_and_recompute,0.65,2,2,0,0.0,0.0,43,51
5391,relax_and_recompute,0.65,1,1,0,0.0,0.0,35,36
5392,relax_and_recompute,0.65,1,1,0,0.0,0.0,11,13
5393,relax_and_recompute,0.65,22,19,3,-4.957652547927751,0.037406937188411,10,25
5394,relax_and_recompute,0.65,16,16,0,0.0,0.0,86,136
5395,relax_and_recompute,0.65,0,0,0,0.0,0.0,10,12
5396,relax_and_recompute,0.65,0,0,0,0.0,0.0,32,31
5397,relax_and_recompute,0.65,2,2,0,4.970962038347736,-0.0904350603192869,20,26
5398,relax_and_recompute,0.65,0,0,0,0.0,0.0,11,11
5399,relax_and_recompute,0.65,2,2,0,0.0,0.0,34,42
5400,relax_and_recompute,0.65,11,11,0,0.0,0.0,14,25
5401,relax_and_recompute,0.65,8,8,0,0.0,0.0,31,46
5402,relax_and_recompute,0.65,0,0,0,0.0,0.0,42,45
5403,relax_and_recompute,0.65,1265,1233,32,-0.0829886923942524,-0.0013136328692162,39,173
5404,relax_and_recompute,0.65,11,11,0,0.0,0.0,14,24
5405,relax_and_recompute,0.65,0,0,0,0.0,0.0,24,25
5406,relax_and_recompute,0.65,2,2,0,0.0,0.0,12,19
5407,relax_and_recompute,0.65,59,59,0,0.0,0.0,41,72
5408,relax_and_recompute,0.65,182,182,0,0.0,0.0,59,115
5409,relax_and_recompute,0.65,6,6,0,0.0,0.0,32,37
5410,relax_and_recompute,0.65,1,1,0,0.0,0.0,20,20
5411,relax_and_recompute,0.65,41,26,15,-1.6275846340626714,0.0729158968985802,12,31
5412,relax_and_recompute,0.65,0,0,0,0.0,0.0,10,10
5413,relax_and_recompute,0.65,0,0,0,0.0,0.0,20,21
5414,relax_and_recompute,0.65,18,18,0,0.0,0.0,39,52
5415,relax_and_recompute,0.65,378,393,-15,0.6108526484877643,4.422482210819645e-05,42,109
5416,relax_and_recompute,0.65,1,1,0,0.0,0.0,25,28
5417,relax_and_recompute,0.65,170,170,0,0.0,0.0,56,106
5418,relax_and_recompute,0.65,567,575,-8,0.4383057260994292,-0.0017656065849445,87,189
5419,relax_and_recompute,0.65,41,41,0,0.0,0.0,56,82
5420,relax_and_recompute,0.65,2,2,0,0.0,0.0,13,15
5421,relax_and_recompute,0.65,104,88,16,-3.3995451437074067,-0.111275141568526,36,63
5422,relax_and_recompute,0.65,0,0,0,0.0,0.0,16,15
5423,relax_and_recompute,0.65,0,0,0,0.0,0.0,67,66
5424,relax_and_recompute,0.65,13,13,0,0.0,0.0,42,60
5425,relax_and_recompute,0.65,0,0,0,0.0,0.0,39,38
5426,relax_and_recompute,0.65,8,8,0,0.0,0.0,20,36
5427,relax_and_recompute,0.65,0,0,0,0.0,0.0,10,9
5428,relax_and_recompute,0.65,1,1,0,0.0,0.0,13,15
5429,relax_and_recompute,0.65,6,6,0,0.0,0.0,34,41
5430,relax_and_recompute,0.65,3,3,0,0.0,0.0,37,42
5431,relax_and_recompute,0.65,36,36,0,0.0,0.0,18,29
5432,relax_and_recompute,0.65,0,0,0,0.0,0.0,23,22
5433,relax_and_recompute,0.65,0,0,0,0.0,0.0,13,12
5434,relax_and_recompute,0.65,0,0,0,0.0,0.0,15,14
5435,relax_and_recompute,0.65,0,0,0,0.0,0.0,69,68
5436,relax_and_recompute,0.65,0,0,0,0.0,0.0,40,39
5437,relax_and_recompute,0.65,0,0,0,0.0,0.0,89,93
5438,relax_and_recompute,0.65,13,13,0,0.0,0.0,20,32
5439,relax_and_recompute,0.65,2,2,0,0.0,0.0,69,83
5440,relax_and_recompute,0.65,2,2,0,0.0,0.0,12,15
5441,relax_and_recompute,0.65,0,0,0,0.0,0.0,15,14
5442,relax_and_recompute,0.65,0,0,0,0.0,0.0,23,26
5443,relax_and_recompute,0.65,2,2,0,0.0,0.0,12,20
5444,relax_and_recompute,0.65,201,201,0,0.0,0.0,64,122
5445,relax_and_recompute,0.65,7,7,0,0.0,0.0,58,71
5446,relax_and_recompute,0.65,0,0,0,0.0,0.0,20,19
5447,relax_and_recompute,0.65,510,510,0,0.0,0.0,100,191
5448,relax_and_recompute,0.65,34,34,0,0.0,0.0,41,61
5449,relax_and_recompute,0.65,33,34,-1,-0.5384989905164446,0.0398816997391653,13,31
5450,relax_and_recompute,0.65,5,5,0,0.0,0.0,10,15
5451,relax_and_recompute,0.65,6,6,0,0.0,0.0,37,47
5452,relax_and_recompute,0.65,0,0,0,0.0,0.0,21,21
5453,relax_and_recompute,0.65,0,0,0,0.0,0.0,11,10
5454,relax_and_recompute,0.65,57,57,0,0.0,0.0,44,80
5455,relax_and_recompute,0.65,6,6,0,0.0,0.0,12,21
5456,relax_and_recompute,0.65,2,2,0,40.57817790180843,-0.0379305285754828,37,43
5457,relax_and_recompute,0.65,6,6,0,0.0,0.0,41,52
5458,relax_and_recompute,0.65,0,0,0,0.0,0.0,90,89
5459,relax_and_recompute,0.65,0,0,0,0.0,0.0,22,21
5460,relax_and_recompute,0.65,1,1,0,0.0,0.0,37,43
5461,relax_and_recompute,0.65,0,0,0,0.0,0.0,47,47
5462,relax_and_recompute,0.65,4,4,0,0.0,0.0,12,20
5463,relax_and_recompute,0.65,114,114,0,0.0,0.0,84,124
5464,relax_and_recompute,0.65,0,0,0,0.0,0.0,88,92
5465,relax_and_recompute,0.65,380,377,3,-0.3714807714610657,-0.0025427242202904,59,122
5466,relax_and_recompute,0.65,4,4,0,0.0,0.0,26,31
5467,relax_and_recompute,0.65,0,0,0,0.0,0.0,28,27
5468,relax_and_recompute,0.65,6,6,0,0.0,0.0,18,26
5469,relax_and_recompute,0.65,1,1,0,0.0,0.0,23,26
5470,relax_and_recompute,0.65,0,0,0,0.0,0.0,43,43
5471,relax_and_recompute,0.65,2,2,0,0.0,0.0,22,26
5472,relax_and_recompute,0.65,0,0,0,0.0,0.0,15,14
5473,relax_and_recompute,0.65,10,10,0,0.0,0.0,36,48
5474,relax_and_recompute,0.65,6,6,0,0.0,0.0,30,37
5475,relax_and_recompute,0.65,1,1,0,0.0,0.0,10,13
5476,relax_and_recompute,0.65,0,0,0,0.0,0.0,12,11
5477,relax_and_recompute,0.65,168,153,15,-1.4597591062543387,0.1638614131178267,55,105
5478,relax_and_recompute,0.65,1,1,0,0.0,0.0,13,17
5479,relax_and_recompute,0.65,0,0,0,0.0,0.0,30,29
5480,relax_and_recompute,0.65,3,3,0,0.0,0.0,36,43
5481,relax_and_recompute,0.65,36,36,0,0.0,0.0,40,60
5482,relax_and_recompute,0.65,0,0,0,0.0,0.0,13,17
5483,relax_and_recompute,0.65,6,7,-1,-5.27235869178908,0.0082826452568239,23,30
5484,relax_and_recompute,0.65,0,0,0,0.0,0.0,12,16
5485,relax_and_recompute,0.65,0,0,0,0.0,0.0,26,26
5486,relax_and_recompute,0.65,0,0,0,0.0,0.0,22,31
5487,relax_and_recompute,0.65,0,0,0,0.0,0.0,68,68
5488,relax_and_recompute,0.65,0,0,0,0.0,0.0,23,22
5489,relax_and_recompute,0.65,0,0,0,0.0,0.0,43,42
5490,relax_and_recompute,0.65,0,0,0,0.0,0.0,18,17
5491,relax_and_recompute,0.65,3,3,0,0.0,0.0,28,42
5492,relax_and_recompute,0.65,45,45,0,0.1036479088850654,-0.0041754562964496,21,44
5493,relax_and_recompute,0.65,0,0,0,0.0,0.0,36,37
5494,relax_and_recompute,0.65,0,0,0,0.0,0.0,15,14
5495,relax_and_recompute,0.65,1,1,0,0.0,0.0,14,16
5496,relax_and_recompute,0.65,197,204,-7,3.484436282689749,0.1757315340586914,61,119
5497,relax_and_recompute,0.65,0,0,0,0.0,0.0,19,20
5498,relax_and_recompute,0.65,0,0,0,0.0,0.0,22,22
5499,relax_and_recompute,0.65,0,0,0,0.0,0.0,54,58
5500,relax_and_recompute,0.65,651,651,0,0.0,0.0,65,135
5501,relax_and_recompute,0.65,1,1,0,0.0,0.0,16,18
5502,relax_and_recompute,0.65,7,7,0,0.0,0.0,17,27
5503,relax_and_recompute,0.65,22,22,0,0.0,0.0,54,71
5504,relax_and_recompute,0.65,0,0,0,0.0,0.0,23,22
5505,relax_and_recompute,0.65,1,0,1,76.88395716132196,-0.1491322016956315,13,16
5506,relax_and_recompute,0.65,155,146,9,-2.3741667241416664,-0.001397205031107,85,131
5507,relax_and_recompute,0.65,44,44,0,0.0,0.0,28,55
5508,relax_and_recompute,0.65,4,4,0,0.0,0.0,18,24
5509,relax_and_recompute,0.65,0,0,0,0.0,0.0,19,22
5510,relax_and_recompute,0.65,0,0,0,0.0,0.0,47,46
5511,relax_and_recompute,0.65,21,19,2,-6.356920988253222,0.0143956759658575,39,64
5512,relax_and_recompute,0.65,0,0,0,0.0,0.0,17,18
5513,relax_and_recompute,0.65,1,1,0,0.0,0.0,23,24
5514,relax_and_recompute,0.65,2,2,0,0.0,0.0,13,16
5515,relax_and_recompute,0.65,22,22,0,0.0,0.0,40,56
5516,relax_and_recompute,0.65,1,1,0,0.0,0.0,10,15
5517,relax_and_recompute,0.65,0,0,0,0.0,0.0,21,20
5518,relax_and_recompute,0.65,4,4,0,0.0,0.0,30,35
5519,relax_and_recompute,0.65,1,1,0,0.0,0.0,71,77
5520,relax_one,0.65,0,0,0,0.0,0.0,17,18
5521,relax_one,0.65,1,1,0,0.0,0.0,43,48
5522,relax_one,0.65,3,3,0,0.0,0.0,38,45
5523,relax_one,0.65,0,0,0,0.0,0.0,12,12
5524,relax_one,0.65,20,18,2,-3.2752299140735204,0.0114158034923678,23,38
5525,relax_one,0.65,0,1,-1,-78.11694026732484,-0.0295512202700576,19,22
5526,relax_one,0.65,976,978,-2,0.1423455471242221,-0.0025418055405018,35,143
5527,relax_one,0.65,0,1,-1,-50.19567681247512,-0.0041327022016595,92,91
5528,relax_one,0.65,2,2,0,0.0,0.0,43,51
5529,relax_one,0.65,1,1,0,0.0,0.0,35,36
5530,relax_one,0.65,1,1,0,0.0,0.0,11,13
5531,relax_one,0.65,22,20,2,-3.01441643358082,0.0082886474985522,10,25
5532,relax_one,0.65,16,16,0,0.0,0.0,86,136
5533,relax_one,0.65,0,0,0,0.0,0.0,10,12
5534,relax_one,0.65,0,0,0,0.0,0.0,32,31
5535,relax_one,0.65,2,2,0,4.970962038347736,-0.0904350603192869,20,26
5536,relax_one,0.65,0,0,0,0.0,0.0,11,11
5537,relax_one,0.65,2,2,0,0.0,0.0,34,42
5538,relax_one,0.65,11,11,0,0.0,0.0,14,25
5539,relax_one,0.65,8,7,1,13.99583228956454,0.1582030612456263,31,46
5540,relax_one,0.65,0,0,0,0.0,0.0,42,45
5541,relax_one,0.65,1265,1240,25,0.1009906236120983,0.0001682713719424,39,173
5542,relax_one,0.65,11,11,0,0.0,0.0,14,24
5543,relax_one,0.65,0,0,0,0.0,0.0,24,25
5544,relax_one,0.65,2,2,0,0.0,0.0,12,19
5545,relax_one,0.65,59,59,0,0.4609819410147793,0.0044552421238692,41,72
5546,relax_one,0.65,182,191,-9,1.446975953367918,0.0358261975695221,59,115
5547,relax_one,0.65,6,6,0,0.0,0.0,32,37
5548,relax_one,0.65,1,1,0,0.0,0.0,20,20
5549,relax_one,0.65,41,32,9,2.305146048931391,0.0775874222420341,12,31
5550,relax_one,0.65,0,0,0,0.0,0.0,10,10
5551,relax_one,0.65,0,0,0,0.0,0.0,20,21
5552,relax_one,0.65,18,18,0,0.0,0.0,39,52
5553,relax_one,0.65,378,395,-17,-0.4859193577000411,-0.0010324457545943,42,109
5554,relax_one,0.65,1,1,0,0.0,0.0,25,28
5555,relax_one,0.65,170,170,0,0.0,0.0,56,106
5556,relax_one,0.65,567,595,-28,0.7834114754025379,-0.002967395777259,87,189
5557,relax_one,0.65,41,41,0,-3.1762323320181167,-0.0099859384844429,56,82
5558,relax_one,0.65,2,2,0,0.0,0.0,13,15
5559,relax_one,0.65,104,88,16,-3.3995451437074067,-0.111275141568526,36,63
5560,relax_one,0.65,0,0,0,0.0,0.0,16,15
5561,relax_one,0.65,0,0,0,0.0,0.0,67,66
5562,relax_one,0.65,13,13,0,0.0,0.0,42,60
5563,relax_one,0.65,0,0,0,0.0,0.0,39,38
5564,relax_one,0.65,8,8,0,0.0,0.0,20,36
5565,relax_one,0.65,0,0,0,0.0,0.0,10,9
5566,relax_one,0.65,1,1,0,0.0,0.0,13,15
5567,relax_one,0.65,6,7,-1,12.522285729298716,0.0299062089849014,34,41
5568,relax_one,0.65,3,3,0,0.0,0.0,37,42
5569,relax_one,0.65,36,36,0,0.0,0.0,18,29
5570,relax_one,0.65,0,0,0,0.0,0.0,23,22
5571,relax_one,0.65,0,0,0,0.0,0.0,13,12
5572,relax_one,0.65,0,0,0,0.0,0.0,15,14
5573,relax_one,0.65,0,0,0,0.0,0.0,69,68
5574,relax_one,0.65,0,0,0,0.0,0.0,40,39
5575,relax_one,0.65,0,0,0,0.0,0.0,89,93
5576,relax_one,0.65,13,13,0,-2.975681235416161,-0.0847204542309565,20,32
5577,relax_one,0.65,2,2,0,0.0,0.0,69,83
5578,relax_one,0.65,2,2,0,0.0,0.0,12,15
5579,relax_one,0.65,0,0,0,0.0,0.0,15,14
5580,relax_one,0.65,0,0,0,0.0,0.0,23,26
5581,relax_one,0.65,2,2,0,0.0,0.0,12,20
5582,relax_one,0.65,201,201,0,0.0,0.0,64,122
5583,relax_one,0.65,7,7,0,0.0,0.0,58,71
5584,relax_one,0.65,0,0,0,0.0,0.0,20,19
5585,relax_one,0.65,510,510,0,0.0060639005596385,-0.0006916839131552,100,191
5586,relax_one,0.65,34,34,0,0.0,0.0,41,61
5587,relax_one,0.65,33,34,-1,-0.6264707699284884,0.0331924782664471,13,31
5588,relax_one,0.65,5,5,0,0.0,0.0,10,15
5589,relax_one,0.65,6,6,0,0.0,0.0,37,47
5590,relax_one,0.65,0,0,0,0.0,0.0,21,21
5591,relax_one,0.65,0,0,0,0.0,0.0,11,10
5592,relax_one,0.65,57,55,2,-1.1796960984034186,9.734149291917849e-05,44,80
5593,relax_one,0.65,6,6,0,0.0,0.0,12,21
5594,relax_one,0.65,2,2,0,42.15913628345388,-0.0181760816329957,37,43
5595,relax_one,0.65,6,6,0,0.0,0.0,41,52
5596,relax_one,0.65,0,0,0,0.0,0.0,90,89
5597,relax_one,0.65,0,0,0,0.0,0.0,22,21
5598,relax_one,0.65,1,1,0,-4.213527745425694,0.0417394626549948,37,43
5599,relax_one,0.65,0,0,0,0.0,0.0,47,47
5600,relax_one,0.65,4,4,0,0.0,0.0,12,20
5601,relax_one,0.65,114,114,0,0.0,0.0,84,124
5602,relax_one,0.65,0,0,0,0.0,0.0,88,92
5603,relax_one,0.65,380,377,3,-0.3714807714610657,-0.0025427242202904,59,122
5604,relax_one,0.65,4,4,0,0.0,0.0,26,31
5605,relax_one,0.65,0,0,0,0.0,0.0,28,27
5606,relax_one,0.65,6,6,0,0.0,0.0,18,26
5607,relax_one,0.65,1,1,0,0.0,0.0,23,26
5608,relax_one,0.65,0,0,0,0.0,0.0,43,43
5609,relax_one,0.65,2,2,0,0.0,0.0,22,26
5610,relax_one,0.65,0,0,0,0.0,0.0,15,14
5611,relax_one,0.65,10,17,-7,3.5874123628873704,0.0856058777554238,36,48
5612,relax_one,0.65,6,6,0,2.8016025522275783,-0.3535412006642752,30,37
5613,relax_one,0.65,1,1,0,0.0,0.0,10,13
5614,relax_one,0.65,0,0,0,0.0,0.0,12,11
5615,relax_one,0.65,168,167,1,-0.7965879277094672,0.0475430066924907,55,105
5616,relax_one,0.65,1,1,0,17.12164821735773,0.0578261695456346,13,17
5617,relax_one,0.65,0,0,0,0.0,0.0,30,29
5618,relax_one,0.65,3,3,0,0.0,0.0,36,43
5619,relax_one,0.65,36,36,0,0.0,0.0,40,60
5620,relax_one,0.65,0,0,0,0.0,0.0,13,17
5621,relax_one,0.65,6,7,-1,-5.27235869178908,0.0082826452568239,23,30
5622,relax_one,0.65,0,0,0,0.0,0.0,12,16
5623,relax_one,0.65,0,0,0,0.0,0.0,26,26
5624,relax_one,0.65,0,0,0,0.0,0.0,22,31
5625,relax_one,0.65,0,0,0,0.0,0.0,68,68
5626,relax_one,0.65,0,0,0,0.0,0.0,23,22
5627,relax_one,0.65,0,0,0,0.0,-0.0348129737608335,43,42
5628,relax_one,0.65,0,0,0,0.0,0.0,18,17
5629,relax_one,0.65,3,3,0,0.0,0.0,28,42
5630,relax_one,0.65,45,45,0,0.1036479088850654,-0.0041754562964496,21,44
5631,relax_one,0.65,0,0,0,0.0,0.0,36,37
5632,relax_one,0.65,0,0,0,0.0,0.0,15,14
5633,relax_one,0.65,1,1,0,0.0,0.0,14,16
5634,relax_one,0.65,197,204,-7,3.484436282689749,0.1757315340586914,61,119
5635,relax_one,0.65,0,0,0,0.0,0.0,19,20
5636,relax_one,0.65,0,0,0,0.0,0.0,22,22
5637,relax_one,0.65,0,0,0,0.0,0.0,54,58
5638,relax_one,0.65,651,651,0,0.0,0.0,65,135
5639,relax_one,0.65,1,1,0,0.0,0.0,16,18
5640,relax_one,0.65,7,7,0,0.0,0.0,17,27
5641,relax_one,0.65,22,4,18,-19.06910671434205,0.1469333863626725,54,71
5642,relax_one,0.65,0,2,-2,-59.99819093035041,-0.0131455917893484,23,22
5643,relax_one,0.65,1,0,1,76.88395716132196,-0.1491322016956315,13,16
5644,relax_one,0.65,155,146,9,-2.3741667241416664,-0.001397205031107,85,131
5645,relax_one,0.65,44,44,0,0.0,0.0,28,55
5646,relax_one,0.65,4,4,0,0.0,0.0,18,24
5647,relax_one,0.65,0,0,0,0.0,0.0,19,22
5648,relax_one,0.65,0,0,0,0.0,0.0,47,46
5649,relax_one,0.65,21,19,2,-6.356920988253222,0.0143956759658575,39,64
5650,relax_one,0.65,0,0,0,0.0,0.0,17,18
5651,relax_one,0.65,1,1,0,0.0,0.0,23,24
5652,relax_one,0.65,2,2,0,0.0,0.0,13,16
5653,relax_one,0.65,22,22,0,0.0,0.0,40,56
5654,relax_one,0.65,1,1,0,0.0,0.0,10,15
5655,relax_one,0.65,0,0,0,0.0,0.0,21,20
5656,relax_one,0.65,4,4,0,0.0,0.0,30,35
5657,relax_one,0.65,1,1,0,0.0,0.0,71,77
5658,just_relax,0.65,0,0,0,0.0,-0.0091692815110081,17,18
5659,just_relax,0.65,1,1,0,0.0009607869158827,0.0014628518031132,43,48
5660,just_relax,0.65,3,3,0,-0.0019521681741139,-7.679999619569777e-05,38,45
5661,just_relax,0.65,0,0,0,0.0,-0.0037600566419999,12,12
5662,just_relax,0.65,20,14,6,1.9891400956483096,0.1544148745043621,23,38
5663,just_relax,0.65,0,1,-1,-78.11694026732484,-0.0295512202700576,19,22
5664,just_relax,0.65,976,1188,-212,1.3106081233515638,0.0257948127350838,35,143
5665,just_relax,0.65,0,4,-4,-39.1818408082167,-0.0156618414823971,92,91
5666,just_relax,0.65,2,2,0,-0.00041775540015,-0.0002552385505018,43,51
5667,just_relax,0.65,1,1,0,-0.0016870080925173,6.40249009676297e-05,35,36
5668,just_relax,0.65,1,1,0,-0.000156439410091,0.0002508982184644,11,13
5669,just_relax,0.65,22,24,-2,-3.49415891827384,0.1000113687896936,10,25
5670,just_relax,0.65,16,13,3,0.2088785180214571,-2.2771107622610032e-05,86,136
5671,just_relax,0.65,0,0,0,0.0,-1.765503840900351e-06,10,12
5672,just_relax,0.65,0,0,0,0.0,-1.014518260578079e-05,32,31
5673,just_relax,0.65,2,2,0,4.970962038347736,-0.0904350603192869,20,26
5674,just_relax,0.65,0,0,0,0.0,0.000269092021105,11,11
5675,just_relax,0.65,2,2,0,0.0009292844165713,-0.0008610890242942,34,42
5676,just_relax,0.65,11,11,0,-0.0003616788843885,0.0005035529702898,14,25
5677,just_relax,0.65,8,7,1,13.99583228956454,0.1582030612456263,31,46
5678,just_relax,0.65,0,0,0,0.0,0.0042083907430441,42,45
5679,just_relax,0.65,1265,1285,-20,2.6849459664833404,-0.1292871249874528,39,173
5680,just_relax,0.65,11,11,0,0.0001627700527109,0.0015600944076981,14,24
5681,just_relax,0.65,0,0,0,0.0,-0.000608053012485,24,25
5682,just_relax,0.65,2,2,0,-2.981324638540173e-05,0.0001440646714581,12,19
5683,just_relax,0.65,59,59,0,0.4609819410147793,0.0044552421238692,41,72
5684,just_relax,0.65,182,178,4,0.0313317398119608,0.0970080713564147,59,115
5685,just_relax,0.65,6,6,0,-0.0020404096920856,0.0011964290694836,32,37
5686,just_relax,0.65,1,0,1,64.5674534074053,-0.0013228453280204,20,20
5687,just_relax,0.65,41,33,8,8.182357833947279,-0.009895766072516,12,31
5688,just_relax,0.65,0,0,0,0.0,-1.5942199658169898e-06,10,10
5689,just_relax,0.65,0,0,0,0.0,0.0018153466622625,20,21
5690,just_relax,0.65,18,18,0,0.0003589278580733,-0.0005865039043362,39,52
5691,just_relax,0.65,378,369,9,2.979528253482861,0.0835817869771829,42,109
5692,just_relax,0.65,1,1,0,-0.0010366044558338,-5.546321229055184e-05,25,28
5693,just_relax,0.65,170,170,0,-0.0002769762706833,-0.0005002245004087,56,106
5694,just_relax,0.65,567,521,46,-0.2657392120378574,0.1239070997048957,87,189
5695,just_relax,0.65,41,43,-2,2.499128887843675,-0.033528056765164,56,82
5696,just_relax,0.65,2,2,0,0.0004861774901456,1.2071037781558047e-06,13,15
5697,just_relax,0.65,104,86,18,5.26724471872344,-0.2840091449765524,36,63
5698,just_relax,0.65,0,0,0,0.0,4.3915154694929015e-06,16,15
5699,just_relax,0.65,0,0,0,0.0,-5.223096419815221e-07,67,66
5700,just_relax,0.65,13,13,0,0.0024384647237383,0.004260897920215,42,60
5701,just_relax,0.65,0,0,0,0.0,0.0005903979895692,39,38
5702,just_relax,0.65,8,8,0,-3.330899971842882e-05,0.0005334774465118,20,36
5703,just_relax,0.65,0,0,0,0.0,-0.0010596071395927,10,9
5704,just_relax,0.65,1,1,0,0.0009644178095271,-1.805181839154013e-05,13,15
5705,just_relax,0.65,6,7,-1,12.522285729298716,0.0299062089849014,34,41
5706,just_relax,0.65,3,3,0,-0.0014185667246167,0.0006213779664755,37,42
5707,just_relax,0.65,36,36,0,7.196136941445275e-06,5.025038399830706e-06,18,29
5708,just_relax,0.65,0,0,0,0.0,-0.0031405837993232,23,22
5709,just_relax,0.65,0,0,0,0.0,1.0504657718901632e-05,13,12
5710,just_relax,0.65,0,0,0,0.0,-0.0007613272869088,15,14
5711,just_relax,0.65,0,0,0,0.0,-0.0017207203528439,69,68
5712,just_relax,0.65,0,0,0,0.0,0.001934163275203,40,39
5713,just_relax,0.65,0,0,0,0.0,0.0016954512903432,89,93
5714,just_relax,0.65,13,13,0,1.511050374969713,-0.0878570612978808,20,32
5715,just_relax,0.65,2,3,-1,-4.120223819609976,0.0096644512108772,69,83
5716,just_relax,0.65,2,2,0,0.0006766545457281,-0.0007958153584334,12,15
5717,just_relax,0.65,0,0,0,0.0,-0.0009758471183408,15,14
5718,just_relax,0.65,0,0,0,0.0,-0.0007570529942456,23,26
5719,just_relax,0.65,2,2,0,-0.0004670837519427,-0.000552899751354,12,20
5720,just_relax,0.65,201,201,0,-5.927609844036397e-05,0.0001073571901385,64,122
5721,just_relax,0.65,7,7,0,-0.0099055150386959,0.0003544031231826,58,71
5722,just_relax,0.65,0,0,0,0.0,-0.0013086772972689,20,19
5723,just_relax,0.65,510,505,5,-0.1096058695008466,0.0001562332230281,100,191
5724,just_relax,0.65,34,34,0,0.0046498502251353,3.462795885833536e-05,41,61
5725,just_relax,0.65,33,21,12,-0.322372772893118,0.0487025778316814,13,31
5726,just_relax,0.65,5,5,0,0.0003476406123752,0.0002826333043987,10,15
5727,just_relax,0.65,6,6,0,-0.0004254358946269,0.0003115870201488,37,47
5728,just_relax,0.65,0,0,0,0.0,0.0007350584472026,21,21
5729,just_relax,0.65,0,0,0,0.0,9.621758975453254e-06,11,10
5730,just_relax,0.65,57,55,2,-1.1796960984034186,9.734149291917849e-05,44,80
5731,just_relax,0.65,6,6,0,0.0001929725905256,-1.6711583069151104e-05,12,21
5732,just_relax,0.65,2,5,-3,10.477360070400792,-0.0167672873232497,37,43
5733,just_relax,0.65,6,6,0,-9.27967616917158e-05,0.0005867078171852,41,52
5734,just_relax,0.65,0,0,0,0.0,0.0258238191424075,90,89
5735,just_relax,0.65,0,0,0,0.0,-0.0001762041220683,22,21
5736,just_relax,0.65,1,5,-4,-25.99394547658536,0.034397478016983,37,43
5737,just_relax,0.65,0,0,0,0.0,0.009279908390236,47,47
5738,just_relax,0.65,4,4,0,-0.0003372893218767,-9.212772776878708e-07,12,20
5739,just_relax,0.65,114,95,19,0.8287298242191525,-0.006531385777559,84,124
5740,just_relax,0.65,0,0,0,0.0,0.0016708237920683,88,92
5741,just_relax,0.65,380,332,48,-1.681066658089314,0.0270328691740772,59,122
5742,just_relax,0.65,4,4,0,2.0677824380754828e-05,-0.000363330475558,26,31
5743,just_relax,0.65,0,0,0,0.0,4.418930553695688e-06,28,27
5744,just_relax,0.65,6,6,0,0.0013890930604816,7.243956427815945e-06,18,26
5745,just_relax,0.65,1,1,0,-0.0014241348598034,0.001861633846505,23,26
5746,just_relax,0.65,0,0,0,0.0,0.0001814651838247,43,43
5747,just_relax,0.65,2,2,0,0.0004949068667485,0.0012137972461528,22,26
5748,just_relax,0.65,0,0,0,0.0,8.316094011640018e-06,15,14
5749,just_relax,0.65,10,17,-7,3.5874123628873704,0.0856058777554238,36,48
5750,just_relax,0.65,6,6,0,2.8016025522275783,-0.3535412006642752,30,37
5751,just_relax,0.65,1,1,0,5.455328151526828e-05,-4.433967369288361e-05,10,13
5752,just_relax,0.65,0,0,0,0.0,-0.0049855760382295,12,11
5753,just_relax,0.65,168,182,-14,1.1771250480206064,-0.0267800915114647,55,105
5754,just_relax,0.65,1,1,0,17.12164821735773,0.0578261695456346,13,17
5755,just_relax,0.65,0,0,0,0.0,0.0003329515887838,30,29
5756,just_relax,0.65,3,3,0,0.000583815366788,0.0008768881680062,36,43
5757,just_relax,0.65,36,36,0,0.0010314806767866,-5.393936385500453e-05,40,60
5758,just_relax,0.65,0,0,0,0.0,0.0017894746066188,13,17
5759,just_relax,0.65,6,7,-1,-5.27235869178908,0.0082826452568239,23,30
5760,just_relax,0.65,0,0,0,0.0,-2.940409977925107e-05,12,16
5761,just_relax,0.65,0,0,0,0.0,3.901708024223183e-06,26,26
5762,just_relax,0.65,0,0,0,0.0,-0.0031688166024113,22,31
5763,just_relax,0.65,0,0,0,0.0,0.0008768193667615,68,68
5764,just_relax,0.65,0,0,0,0.0,-7.938175057398134e-06,23,22
5765,just_relax,0.65,0,0,0,0.0,-0.065399188004364,43,42
5766,just_relax,0.65,0,0,0,0.0,-0.002899723134464,18,17
5767,just_relax,0.65,3,3,0,-0.003194586812441,0.0012605153222713,28,42
5768,just_relax,0.65,45,58,-13,0.9231299892006462,0.088218433779717,21,44
5769,just_relax,0.65,0,0,0,0.0,-0.0112811671875761,36,37
5770,just_relax,0.65,0,0,0,0.0,-3.4878924121017896e-05,15,14
5771,just_relax,0.65,1,1,0,-0.0014549239964907,-0.00058525619921,14,16
5772,just_relax,0.65,197,237,-40,1.3477492998050025,0.0885093784332623,61,119
5773,just_relax,0.65,0,0,0,0.0,-0.0038599581671643,19,20
5774,just_relax,0.65,0,0,0,0.0,-0.0006472841631984,22,22
5775,just_relax,0.65,0,0,0,0.0,-0.0011415137972972,54,58
5776,just_relax,0.65,651,651,0,-0.0003954210755097,0.0002252638081207,65,135
5777,just_relax,0.65,1,1,0,-0.0029471577812358,0.0001749400264638,16,18
5778,just_relax,0.65,7,7,0,0.0002013814076775,0.0006636994664107,17,27
5779,just_relax,0.65,22,7,15,-12.985895473169307,0.1330374466905183,54,71
5780,just_relax,0.65,0,2,-2,-59.99819093035041,-0.0131455917893484,23,22
5781,just_relax,0.65,1,0,1,76.88395716132196,-0.1491322016956315,13,16
5782,just_relax,0.65,155,185,-30,2.3843149677438973,-0.02495720013905,85,131
5783,just_relax,0.65,44,44,0,0.0003032918935019,0.0025857794052007,28,55
5784,just_relax,0.65,4,4,0,-0.0007096785766407,-5.4537984728875166e-05,18,24
5785,just_relax,0.65,0,0,0,0.0,-0.003226028074061,19,22
5786,just_relax,0.65,0,0,0,0.0,0.0048197166778652,47,46
5787,just_relax,0.65,21,27,-6,0.0602947270368474,-0.3310372682946312,39,64
5788,just_relax,0.65,0,0,0,0.0,-0.0037052423868473,17,18
5789,just_relax,0.65,1,1,0,0.0005119856857191,0.0004745196477359,23,24
5790,just_relax,0.65,2,2,0,0.0010275548569325,-0.004970471779609,13,16
5791,just_relax,0.65,22,22,0,0.0038770082111057,0.0004285387996507,40,56
5792,just_relax,0.65,1,1,0,-0.0002865966515059,-0.0003325971221349,10,15
5793,just_relax,0.65,0,0,0,0.0,0.0003384089422906,21,20
5794,just_relax,0.65,4,4,0,-0.0001029723687508,-0.0013906355929786,30,35
5795,just_relax,0.65,1,1,0,0.0051043410712594,-0.0056156512673798,71,77
5796,relax_and_recompute,0.7000000000000001,0,0,0,0.0,0.0,17,18
5797,relax_and_recompute,0.7000000000000001,1,1,0,0.0,0.0,43,48
5798,relax_and_recompute,0.7000000000000001,3,3,0,0.0,0.0,38,45
5799,relax_and_recompute,0.7000000000000001,0,0,0,0.0,0.0,12,12
5800,relax_and_recompute,0.7000000000000001,20,18,2,-3.2752299140735204,0.0114158034923678,23,38
5801,relax_and_recompute,0.7000000000000001,0,0,0,0.0,0.0,19,22
5802,relax_and_recompute,0.7000000000000001,976,1004,-28,-0.0620531910963606,-0.0009330148689207,35,143
5803,relax_and_recompute,0.7000000000000001,0,0,0,0.0,0.0,92,91
5804,relax_and_recompute,0.7000000000000001,2,2,0,0.0,0.0,43,51
5805,relax_and_recompute,0.7000000000000001,1,1,0,0.0,0.0,35,36
5806,relax_and_recompute,0.7000000000000001,1,1,0,0.0,0.0,11,13
5807,relax_and_recompute,0.7000000000000001,22,20,2,-3.01441643358082,0.0082886474985522,10,25
5808,relax_and_recompute,0.7000000000000001,16,16,0,0.0,0.0,86,136
5809,relax_and_recompute,0.7000000000000001,0,0,0,0.0,0.0,10,12
5810,relax_and_recompute,0.7000000000000001,0,0,0,0.0,0.0,32,31
5811,relax_and_recompute,0.7000000000000001,2,2,0,0.0,0.0,20,26
5812,relax_and_recompute,0.7000000000000001,0,0,0,0.0,0.0,11,11
5813,relax_and_recompute,0.7000000000000001,2,2,0,0.0,0.0,34,42
5814,relax_and_recompute,0.7000000000000001,11,11,0,0.0,0.0,14,25
5815,relax_and_recompute,0.7000000000000001,8,8,0,0.0,0.0,31,46
5816,relax_and_recompute,0.7000000000000001,0,0,0,0.0,0.0,42,45
5817,relax_and_recompute,0.7000000000000001,1265,1233,32,-0.0829886923942524,-0.0013136328692162,39,173
5818,relax_and_recompute,0.7000000000000001,11,11,0,0.0,0.0,14,24
5819,relax_and_recompute,0.7000000000000001,0,0,0,0.0,0.0,24,25
5820,relax_and_recompute,0.7000000000000001,2,2,0,0.0,0.0,12,19
5821,relax_and_recompute,0.7000000000000001,59,59,0,0.0,0.0,41,72
5822,relax_and_recompute,0.7000000000000001,182,182,0,0.0,0.0,59,115
5823,relax_and_recompute,0.7000000000000001,6,6,0,0.0,0.0,32,37
5824,relax_and_recompute,0.7000000000000001,1,1,0,0.0,0.0,20,20
5825,relax_and_recompute,0.7000000000000001,41,26,15,-1.6275846340626714,0.0729158968985802,12,31
5826,relax_and_recompute,0.7000000000000001,0,0,0,0.0,0.0,10,10
5827,relax_and_recompute,0.7000000000000001,0,0,0,0.0,0.0,20,21
5828,relax_and_recompute,0.7000000000000001,18,18,0,0.0,0.0,39,52
5829,relax_and_recompute,0.7000000000000001,378,393,-15,0.6108526484877643,4.422482210819645e-05,42,109
5830,relax_and_recompute,0.7000000000000001,1,1,0,0.0,0.0,25,28
5831,relax_and_recompute,0.7000000000000001,170,170,0,0.0,0.0,56,106
5832,relax_and_recompute,0.7000000000000001,567,575,-8,0.4383057260994292,-0.0017656065849445,87,189
5833,relax_and_recompute,0.7000000000000001,41,41,0,0.0,0.0,56,82
5834,relax_and_recompute,0.7000000000000001,2,2,0,0.0,0.0,13,15
5835,relax_and_recompute,0.7000000000000001,104,88,16,-3.3995451437074067,-0.111275141568526,36,63
5836,relax_and_recompute,0.7000000000000001,0,0,0,0.0,0.0,16,15
5837,relax_and_recompute,0.7000000000000001,0,0,0,0.0,0.0,67,66
5838,relax_and_recompute,0.7000000000000001,13,13,0,0.0,0.0,42,60
5839,relax_and_recompute,0.7000000000000001,0,0,0,0.0,0.0,39,38
5840,relax_and_recompute,0.7000000000000001,8,8,0,0.0,0.0,20,36
5841,relax_and_recompute,0.7000000000000001,0,0,0,0.0,0.0,10,9
5842,relax_and_recompute,0.7000000000000001,1,1,0,0.0,0.0,13,15
5843,relax_and_recompute,0.7000000000000001,6,6,0,0.0,0.0,34,41
5844,relax_and_recompute,0.7000000000000001,3,3,0,0.0,0.0,37,42
5845,relax_and_recompute,0.7000000000000001,36,36,0,0.0,0.0,18,29
5846,relax_and_recompute,0.7000000000000001,0,0,0,0.0,0.0,23,22
5847,relax_and_recompute,0.7000000000000001,0,0,0,0.0,0.0,13,12
5848,relax_and_recompute,0.7000000000000001,0,0,0,0.0,0.0,15,14
5849,relax_and_recompute,0.7000000000000001,0,0,0,0.0,0.0,69,68
5850,relax_and_recompute,0.7000000000000001,0,0,0,0.0,0.0,40,39
5851,relax_and_recompute,0.7000000000000001,0,0,0,0.0,0.0,89,93
5852,relax_and_recompute,0.7000000000000001,13,13,0,0.0,0.0,20,32
5853,relax_and_recompute,0.7000000000000001,2,2,0,0.0,0.0,69,83
5854,relax_and_recompute,0.7000000000000001,2,2,0,0.0,0.0,12,15
5855,relax_and_recompute,0.7000000000000001,0,0,0,0.0,0.0,15,14
5856,relax_and_recompute,0.7000000000000001,0,0,0,0.0,0.0,23,26
5857,relax_and_recompute,0.7000000000000001,2,2,0,0.0,0.0,12,20
5858,relax_and_recompute,0.7000000000000001,201,201,0,0.0,0.0,64,122
5859,relax_and_recompute,0.7000000000000001,7,7,0,0.0,0.0,58,71
5860,relax_and_recompute,0.7000000000000001,0,0,0,0.0,0.0,20,19
5861,relax_and_recompute,0.7000000000000001,510,510,0,0.0,0.0,100,191
5862,relax_and_recompute,0.7000000000000001,34,34,0,0.0,0.0,41,61
5863,relax_and_recompute,0.7000000000000001,33,34,-1,-0.5384989905164446,0.0398816997391653,13,31
5864,relax_and_recompute,0.7000000000000001,5,5,0,0.0,0.0,10,15
5865,relax_and_recompute,0.7000000000000001,6,6,0,0.0,0.0,37,47
5866,relax_and_recompute,0.7000000000000001,0,0,0,0.0,0.0,21,21
5867,relax_and_recompute,0.7000000000000001,0,0,0,0.0,0.0,11,10
5868,relax_and_recompute,0.7000000000000001,57,57,0,0.0,0.0,44,80
5869,relax_and_recompute,0.7000000000000001,6,6,0,0.0,0.0,12,21
5870,relax_and_recompute,0.7000000000000001,2,2,0,0.0,0.0,37,43
5871,relax_and_recompute,0.7000000000000001,6,6,0,0.0,0.0,41,52
5872,relax_and_recompute,0.7000000000000001,0,0,0,0.0,0.0,90,89
5873,relax_and_recompute,0.7000000000000001,0,0,0,0.0,0.0,22,21
5874,relax_and_recompute,0.7000000000000001,1,1,0,0.0,0.0,37,43
5875,relax_and_recompute,0.7000000000000001,0,0,0,0.0,0.0,47,47
5876,relax_and_recompute,0.7000000000000001,4,4,0,0.0,0.0,12,20
5877,relax_and_recompute,0.7000000000000001,114,114,0,0.0,0.0,84,124
5878,relax_and_recompute,0.7000000000000001,0,0,0,0.0,0.0,88,92
5879,relax_and_recompute,0.7000000000000001,380,377,3,-0.3714807714610657,-0.0025427242202904,59,122
5880,relax_and_recompute,0.7000000000000001,4,4,0,0.0,0.0,26,31
5881,relax_and_recompute,0.7000000000000001,0,0,0,0.0,0.0,28,27
5882,relax_and_recompute,0.7000000000000001,6,6,0,0.0,0.0,18,26
5883,relax_and_recompute,0.7000000000000001,1,1,0,0.0,0.0,23,26
5884,relax_and_recompute,0.7000000000000001,0,0,0,0.0,0.0,43,43
5885,relax_and_recompute,0.7000000000000001,2,2,0,0.0,0.0,22,26
5886,relax_and_recompute,0.7000000000000001,0,0,0,0.0,0.0,15,14
5887,relax_and_recompute,0.7000000000000001,10,10,0,0.0,0.0,36,48
5888,relax_and_recompute,0.7000000000000001,6,6,0,0.0,0.0,30,37
5889,relax_and_recompute,0.7000000000000001,1,1,0,0.0,0.0,10,13
5890,relax_and_recompute,0.7000000000000001,0,0,0,0.0,0.0,12,11
5891,relax_and_recompute,0.7000000000000001,168,153,15,-1.4597591062543387,0.1638614131178267,55,105
5892,relax_and_recompute,0.7000000000000001,1,1,0,0.0,0.0,13,17
5893,relax_and_recompute,0.7000000000000001,0,0,0,0.0,0.0,30,29
5894,relax_and_recompute,0.7000000000000001,3,3,0,0.0,0.0,36,43
5895,relax_and_recompute,0.7000000000000001,36,36,0,0.0,0.0,40,60
5896,relax_and_recompute,0.7000000000000001,0,0,0,0.0,0.0,13,17
5897,relax_and_recompute,0.7000000000000001,6,7,-1,-5.27235869178908,0.0082826452568239,23,30
5898,relax_and_recompute,0.7000000000000001,0,0,0,0.0,0.0,12,16
5899,relax_and_recompute,0.7000000000000001,0,0,0,0.0,0.0,26,26
5900,relax_and_recompute,0.7000000000000001,0,0,0,0.0,0.0,22,31
5901,relax_and_recompute,0.7000000000000001,0,0,0,0.0,0.0,68,68
5902,relax_and_recompute,0.7000000000000001,0,0,0,0.0,0.0,23,22
5903,relax_and_recompute,0.7000000000000001,0,0,0,0.0,0.0,43,42
5904,relax_and_recompute,0.7000000000000001,0,0,0,0.0,0.0,18,17
5905,relax_and_recompute,0.7000000000000001,3,3,0,0.0,0.0,28,42
5906,relax_and_recompute,0.7000000000000001,45,45,0,0.0,0.0,21,44
5907,relax_and_recompute,0.7000000000000001,0,0,0,0.0,0.0,36,37
5908,relax_and_recompute,0.7000000000000001,0,0,0,0.0,0.0,15,14
5909,relax_and_recompute,0.7000000000000001,1,1,0,0.0,0.0,14,16
5910,relax_and_recompute,0.7000000000000001,197,204,-7,3.484436282689749,0.1757315340586914,61,119
5911,relax_and_recompute,0.7000000000000001,0,0,0,0.0,0.0,19,20
5912,relax_and_recompute,0.7000000000000001,0,0,0,0.0,0.0,22,22
5913,relax_and_recompute,0.7000000000000001,0,0,0,0.0,0.0,54,58
5914,relax_and_recompute,0.7000000000000001,651,651,0,0.0,0.0,65,135
5915,relax_and_recompute,0.7000000000000001,1,1,0,0.0,0.0,16,18
5916,relax_and_recompute,0.7000000000000001,7,7,0,0.0,0.0,17,27
5917,relax_and_recompute,0.7000000000000001,22,22,0,0.0,0.0,54,71
5918,relax_and_recompute,0.7000000000000001,0,0,0,0.0,0.0,23,22
5919,relax_and_recompute,0.7000000000000001,1,0,1,76.88395716132196,-0.1491322016956315,13,16
5920,relax_and_recompute,0.7000000000000001,155,146,9,-2.3741667241416664,-0.001397205031107,85,131
5921,relax_and_recompute,0.7000000000000001,44,44,0,0.0,0.0,28,55
5922,relax_and_recompute,0.7000000000000001,4,4,0,0.0,0.0,18,24
5923,relax_and_recompute,0.7000000000000001,0,0,0,0.0,0.0,19,22
5924,relax_and_recompute,0.7000000000000001,0,0,0,0.0,0.0,47,46
5925,relax_and_recompute,0.7000000000000001,21,19,2,-6.356920988253222,0.0143956759658575,39,64
5926,relax_and_recompute,0.7000000000000001,0,0,0,0.0,0.0,17,18
5927,relax_and_recompute,0.7000000000000001,1,1,0,0.0,0.0,23,24
5928,relax_and_recompute,0.7000000000000001,2,2,0,0.0,0.0,13,16
5929,relax_and_recompute,0.7000000000000001,22,22,0,0.0,0.0,40,56
5930,relax_and_recompute,0.7000000000000001,1,1,0,0.0,0.0,10,15
5931,relax_and_recompute,0.7000000000000001,0,0,0,0.0,0.0,21,20
5932,relax_and_recompute,0.7000000000000001,4,4,0,0.0,0.0,30,35
5933,relax_and_recompute,0.7000000000000001,1,1,0,0.0,0.0,71,77
5934,relax_one,0.7000000000000001,0,0,0,0.0,0.0,17,18
5935,relax_one,0.7000000000000001,1,1,0,0.0,0.0,43,48
5936,relax_one,0.7000000000000001,3,3,0,0.0,0.0,38,45
5937,relax_one,0.7000000000000001,0,0,0,0.0,0.0,12,12
5938,relax_one,0.7000000000000001,20,18,2,-3.2752299140735204,0.0114158034923678,23,38
5939,relax_one,0.7000000000000001,0,1,-1,-78.11694026732484,-0.0295512202700576,19,22
5940,relax_one,0.7000000000000001,976,978,-2,0.1423455471242221,-0.0025418055405018,35,143
5941,relax_one,0.7000000000000001,0,1,-1,-50.19567681247512,-0.0041327022016595,92,91
5942,relax_one,0.7000000000000001,2,2,0,0.0,0.0,43,51
5943,relax_one,0.7000000000000001,1,1,0,0.0,0.0,35,36
5944,relax_one,0.7000000000000001,1,1,0,0.0,0.0,11,13
5945,relax_one,0.7000000000000001,22,20,2,-3.01441643358082,0.0082886474985522,10,25
5946,relax_one,0.7000000000000001,16,16,0,0.0,0.0,86,136
5947,relax_one,0.7000000000000001,0,0,0,0.0,0.0,10,12
5948,relax_one,0.7000000000000001,0,0,0,0.0,0.0,32,31
5949,relax_one,0.7000000000000001,2,2,0,4.970962038347736,-0.0904350603192869,20,26
5950,relax_one,0.7000000000000001,0,0,0,0.0,0.0,11,11
5951,relax_one,0.7000000000000001,2,2,0,0.0,0.0,34,42
5952,relax_one,0.7000000000000001,11,11,0,0.0,0.0,14,25
5953,relax_one,0.7000000000000001,8,7,1,13.99583228956454,0.1582030612456263,31,46
5954,relax_one,0.7000000000000001,0,0,0,0.0,0.0,42,45
5955,relax_one,0.7000000000000001,1265,1240,25,0.1009906236120983,0.0001682713719424,39,173
5956,relax_one,0.7000000000000001,11,11,0,0.0,0.0,14,24
5957,relax_one,0.7000000000000001,0,0,0,0.0,0.0,24,25
5958,relax_one,0.7000000000000001,2,2,0,0.0,0.0,12,19
5959,relax_one,0.7000000000000001,59,59,0,0.4609819410147793,0.0044552421238692,41,72
5960,relax_one,0.7000000000000001,182,191,-9,1.446975953367918,0.0358261975695221,59,115
5961,relax_one,0.7000000000000001,6,6,0,0.0,0.0,32,37
5962,relax_one,0.7000000000000001,1,1,0,0.0,0.0,20,20
5963,relax_one,0.7000000000000001,41,32,9,2.305146048931391,0.0775874222420341,12,31
5964,relax_one,0.7000000000000001,0,0,0,0.0,0.0,10,10
5965,relax_one,0.7000000000000001,0,0,0,0.0,0.0,20,21
5966,relax_one,0.7000000000000001,18,18,0,0.0,0.0,39,52
5967,relax_one,0.7000000000000001,378,395,-17,-0.4859193577000411,-0.0010324457545943,42,109
5968,relax_one,0.7000000000000001,1,1,0,0.0,0.0,25,28
5969,relax_one,0.7000000000000001,170,170,0,0.0,0.0,56,106
5970,relax_one,0.7000000000000001,567,595,-28,0.7834114754025379,-0.002967395777259,87,189
5971,relax_one,0.7000000000000001,41,41,0,-3.1762323320181167,-0.0099859384844429,56,82
5972,relax_one,0.7000000000000001,2,2,0,0.0,0.0,13,15
5973,relax_one,0.7000000000000001,104,88,16,-3.3995451437074067,-0.111275141568526,36,63
5974,relax_one,0.7000000000000001,0,0,0,0.0,0.0,16,15
5975,relax_one,0.7000000000000001,0,0,0,0.0,0.0,67,66
5976,relax_one,0.7000000000000001,13,13,0,0.0,0.0,42,60
5977,relax_one,0.7000000000000001,0,0,0,0.0,0.0,39,38
5978,relax_one,0.7000000000000001,8,8,0,0.0,0.0,20,36
5979,relax_one,0.7000000000000001,0,0,0,0.0,0.0,10,9
5980,relax_one,0.7000000000000001,1,1,0,0.0,0.0,13,15
5981,relax_one,0.7000000000000001,6,7,-1,12.522285729298716,0.0299062089849014,34,41
5982,relax_one,0.7000000000000001,3,3,0,0.0,0.0,37,42
5983,relax_one,0.7000000000000001,36,36,0,0.0,0.0,18,29
5984,relax_one,0.7000000000000001,0,0,0,0.0,0.0,23,22
5985,relax_one,0.7000000000000001,0,0,0,0.0,0.0,13,12
5986,relax_one,0.7000000000000001,0,0,0,0.0,0.0,15,14
5987,relax_one,0.7000000000000001,0,0,0,0.0,0.0,69,68
5988,relax_one,0.7000000000000001,0,0,0,0.0,0.0,40,39
5989,relax_one,0.7000000000000001,0,0,0,0.0,0.0,89,93
5990,relax_one,0.7000000000000001,13,13,0,-2.975681235416161,-0.0847204542309565,20,32
5991,relax_one,0.7000000000000001,2,2,0,0.0,0.0,69,83
5992,relax_one,0.7000000000000001,2,2,0,0.0,0.0,12,15
5993,relax_one,0.7000000000000001,0,0,0,0.0,0.0,15,14
5994,relax_one,0.7000000000000001,0,0,0,0.0,0.0,23,26
5995,relax_one,0.7000000000000001,2,2,0,0.0,0.0,12,20
5996,relax_one,0.7000000000000001,201,201,0,0.0,0.0,64,122
5997,relax_one,0.7000000000000001,7,7,0,0.0,0.0,58,71
5998,relax_one,0.7000000000000001,0,0,0,0.0,0.0,20,19
5999,relax_one,0.7000000000000001,510,510,0,0.0060639005596385,-0.0006916839131552,100,191
6000,relax_one,0.7000000000000001,34,34,0,0.0,0.0,41,61
6001,relax_one,0.7000000000000001,33,34,-1,-0.6264707699284884,0.0331924782664471,13,31
6002,relax_one,0.7000000000000001,5,5,0,0.0,0.0,10,15
6003,relax_one,0.7000000000000001,6,6,0,0.0,0.0,37,47
6004,relax_one,0.7000000000000001,0,0,0,0.0,0.0,21,21
6005,relax_one,0.7000000000000001,0,0,0,0.0,0.0,11,10
6006,relax_one,0.7000000000000001,57,55,2,-1.1796960984034186,9.734149291917849e-05,44,80
6007,relax_one,0.7000000000000001,6,6,0,0.0,0.0,12,21
6008,relax_one,0.7000000000000001,2,2,0,42.15913628345388,-0.0181760816329957,37,43
6009,relax_one,0.7000000000000001,6,6,0,0.0,0.0,41,52
6010,relax_one,0.7000000000000001,0,0,0,0.0,0.0,90,89
6011,relax_one,0.7000000000000001,0,0,0,0.0,0.0,22,21
6012,relax_one,0.7000000000000001,1,1,0,-4.213527745425694,0.0417394626549948,37,43
6013,relax_one,0.7000000000000001,0,0,0,0.0,0.0,47,47
6014,relax_one,0.7000000000000001,4,4,0,0.0,0.0,12,20
6015,relax_one,0.7000000000000001,114,114,0,0.0,0.0,84,124
6016,relax_one,0.7000000000000001,0,0,0,0.0,0.0,88,92
6017,relax_one,0.7000000000000001,380,377,3,-0.3714807714610657,-0.0025427242202904,59,122
6018,relax_one,0.7000000000000001,4,4,0,0.0,0.0,26,31
6019,relax_one,0.7000000000000001,0,0,0,0.0,0.0,28,27
6020,relax_one,0.7000000000000001,6,6,0,0.0,0.0,18,26
6021,relax_one,0.7000000000000001,1,1,0,0.0,0.0,23,26
6022,relax_one,0.7000000000000001,0,0,0,0.0,0.0,43,43
6023,relax_one,0.7000000000000001,2,2,0,0.0,0.0,22,26
6024,relax_one,0.7000000000000001,0,0,0,0.0,0.0,15,14
6025,relax_one,0.7000000000000001,10,17,-7,3.5874123628873704,0.0856058777554238,36,48
6026,relax_one,0.7000000000000001,6,6,0,2.8016025522275783,-0.3535412006642752,30,37
6027,relax_one,0.7000000000000001,1,1,0,0.0,0.0,10,13
6028,relax_one,0.7000000000000001,0,0,0,0.0,0.0,12,11
6029,relax_one,0.7000000000000001,168,167,1,-0.7965879277094672,0.0475430066924907,55,105
6030,relax_one,0.7000000000000001,1,1,0,17.12164821735773,0.0578261695456346,13,17
6031,relax_one,0.7000000000000001,0,0,0,0.0,0.0,30,29
6032,relax_one,0.7000000000000001,3,3,0,0.0,0.0,36,43
6033,relax_one,0.7000000000000001,36,36,0,0.0,0.0,40,60
6034,relax_one,0.7000000000000001,0,0,0,0.0,0.0,13,17
6035,relax_one,0.7000000000000001,6,7,-1,-5.27235869178908,0.0082826452568239,23,30
6036,relax_one,0.7000000000000001,0,0,0,0.0,0.0,12,16
6037,relax_one,0.7000000000000001,0,0,0,0.0,0.0,26,26
6038,relax_one,0.7000000000000001,0,0,0,0.0,0.0,22,31
6039,relax_one,0.7000000000000001,0,0,0,0.0,0.0,68,68
6040,relax_one,0.7000000000000001,0,0,0,0.0,0.0,23,22
6041,relax_one,0.7000000000000001,0,0,0,0.0,-0.0348129737608335,43,42
6042,relax_one,0.7000000000000001,0,0,0,0.0,0.0,18,17
6043,relax_one,0.7000000000000001,3,3,0,0.0,0.0,28,42
6044,relax_one,0.7000000000000001,45,45,0,0.1036479088850654,-0.0041754562964496,21,44
6045,relax_one,0.7000000000000001,0,0,0,0.0,0.0,36,37
6046,relax_one,0.7000000000000001,0,0,0,0.0,0.0,15,14
6047,relax_one,0.7000000000000001,1,1,0,0.0,0.0,14,16
6048,relax_one,0.7000000000000001,197,204,-7,3.484436282689749,0.1757315340586914,61,119
6049,relax_one,0.7000000000000001,0,0,0,0.0,0.0,19,20
6050,relax_one,0.7000000000000001,0,0,0,0.0,0.0,22,22
6051,relax_one,0.7000000000000001,0,0,0,0.0,0.0,54,58
6052,relax_one,0.7000000000000001,651,651,0,0.0,0.0,65,135
6053,relax_one,0.7000000000000001,1,1,0,0.0,0.0,16,18
6054,relax_one,0.7000000000000001,7,7,0,0.0,0.0,17,27
6055,relax_one,0.7000000000000001,22,4,18,-19.06910671434205,0.1469333863626725,54,71
6056,relax_one,0.7000000000000001,0,2,-2,-59.99819093035041,-0.0131455917893484,23,22
6057,relax_one,0.7000000000000001,1,0,1,76.88395716132196,-0.1491322016956315,13,16
6058,relax_one,0.7000000000000001,155,146,9,-2.3741667241416664,-0.001397205031107,85,131
6059,relax_one,0.7000000000000001,44,44,0,0.0,0.0,28,55
6060,relax_one,0.7000000000000001,4,4,0,0.0,0.0,18,24
6061,relax_one,0.7000000000000001,0,0,0,0.0,0.0,19,22
6062,relax_one,0.7000000000000001,0,0,0,0.0,0.0,47,46
6063,relax_one,0.7000000000000001,21,19,2,-6.356920988253222,0.0143956759658575,39,64
6064,relax_one,0.7000000000000001,0,0,0,0.0,0.0,17,18
6065,relax_one,0.7000000000000001,1,1,0,0.0,0.0,23,24
6066,relax_one,0.7000000000000001,2,2,0,0.0,0.0,13,16
6067,relax_one,0.7000000000000001,22,22,0,0.0,0.0,40,56
6068,relax_one,0.7000000000000001,1,1,0,0.0,0.0,10,15
6069,relax_one,0.7000000000000001,0,0,0,0.0,0.0,21,20
6070,relax_one,0.7000000000000001,4,4,0,0.0,0.0,30,35
6071,relax_one,0.7000000000000001,1,1,0,0.0,0.0,71,77
6072,just_relax,0.7000000000000001,0,0,0,0.0,-0.0091692815110081,17,18
6073,just_relax,0.7000000000000001,1,1,0,0.0009607869158827,0.0014628518031132,43,48
6074,just_relax,0.7000000000000001,3,3,0,-0.0019521681741139,-7.679999619569777e-05,38,45
6075,just_relax,0.7000000000000001,0,0,0,0.0,-0.0037600566419999,12,12
6076,just_relax,0.7000000000000001,20,14,6,1.9891400956483096,0.1544148745043621,23,38
6077,just_relax,0.7000000000000001,0,1,-1,-78.11694026732484,-0.0295512202700576,19,22
6078,just_relax,0.7000000000000001,976,1188,-212,1.3106081233515638,0.0257948127350838,35,143
6079,just_relax,0.7000000000000001,0,4,-4,-39.1818408082167,-0.0156618414823971,92,91
6080,just_relax,0.7000000000000001,2,2,0,-0.00041775540015,-0.0002552385505018,43,51
6081,just_relax,0.7000000000000001,1,1,0,-0.0016870080925173,6.40249009676297e-05,35,36
6082,just_relax,0.7000000000000001,1,1,0,-0.000156439410091,0.0002508982184644,11,13
6083,just_relax,0.7000000000000001,22,24,-2,-3.49415891827384,0.1000113687896936,10,25
6084,just_relax,0.7000000000000001,16,13,3,0.2088785180214571,-2.2771107622610032e-05,86,136
6085,just_relax,0.7000000000000001,0,0,0,0.0,-1.765503840900351e-06,10,12
6086,just_relax,0.7000000000000001,0,0,0,0.0,-1.014518260578079e-05,32,31
6087,just_relax,0.7000000000000001,2,2,0,4.970962038347736,-0.0904350603192869,20,26
6088,just_relax,0.7000000000000001,0,0,0,0.0,0.000269092021105,11,11
6089,just_relax,0.7000000000000001,2,2,0,0.0009292844165713,-0.0008610890242942,34,42
6090,just_relax,0.7000000000000001,11,11,0,-0.0003616788843885,0.0005035529702898,14,25
6091,just_relax,0.7000000000000001,8,7,1,13.99583228956454,0.1582030612456263,31,46
6092,just_relax,0.7000000000000001,0,0,0,0.0,0.0042083907430441,42,45
6093,just_relax,0.7000000000000001,1265,1285,-20,2.6849459664833404,-0.1292871249874528,39,173
6094,just_relax,0.7000000000000001,11,11,0,0.0001627700527109,0.0015600944076981,14,24
6095,just_relax,0.7000000000000001,0,0,0,0.0,-0.000608053012485,24,25
6096,just_relax,0.7000000000000001,2,2,0,-2.981324638540173e-05,0.0001440646714581,12,19
6097,just_relax,0.7000000000000001,59,59,0,0.4609819410147793,0.0044552421238692,41,72
6098,just_relax,0.7000000000000001,182,178,4,0.0313317398119608,0.0970080713564147,59,115
6099,just_relax,0.7000000000000001,6,6,0,-0.0020404096920856,0.0011964290694836,32,37
6100,just_relax,0.7000000000000001,1,0,1,64.5674534074053,-0.0013228453280204,20,20
6101,just_relax,0.7000000000000001,41,33,8,8.182357833947279,-0.009895766072516,12,31
6102,just_relax,0.7000000000000001,0,0,0,0.0,-1.5942199658169898e-06,10,10
6103,just_relax,0.7000000000000001,0,0,0,0.0,0.0018153466622625,20,21
6104,just_relax,0.7000000000000001,18,18,0,0.0003589278580733,-0.0005865039043362,39,52
6105,just_relax,0.7000000000000001,378,369,9,2.979528253482861,0.0835817869771829,42,109
6106,just_relax,0.7000000000000001,1,1,0,-0.0010366044558338,-5.546321229055184e-05,25,28
6107,just_relax,0.7000000000000001,170,170,0,-0.0002769762706833,-0.0005002245004087,56,106
6108,just_relax,0.7000000000000001,567,521,46,-0.2657392120378574,0.1239070997048957,87,189
6109,just_relax,0.7000000000000001,41,43,-2,2.499128887843675,-0.033528056765164,56,82
6110,just_relax,0.7000000000000001,2,2,0,0.0004861774901456,1.2071037781558047e-06,13,15
6111,just_relax,0.7000000000000001,104,86,18,5.26724471872344,-0.2840091449765524,36,63
6112,just_relax,0.7000000000000001,0,0,0,0.0,4.3915154694929015e-06,16,15
6113,just_relax,0.7000000000000001,0,0,0,0.0,-5.223096419815221e-07,67,66
6114,just_relax,0.7000000000000001,13,13,0,0.0024384647237383,0.004260897920215,42,60
6115,just_relax,0.7000000000000001,0,0,0,0.0,0.0005903979895692,39,38
6116,just_relax,0.7000000000000001,8,8,0,-3.330899971842882e-05,0.0005334774465118,20,36
6117,just_relax,0.7000000000000001,0,0,0,0.0,-0.0010596071395927,10,9
6118,just_relax,0.7000000000000001,1,1,0,0.0009644178095271,-1.805181839154013e-05,13,15
6119,just_relax,0.7000000000000001,6,7,-1,12.522285729298716,0.0299062089849014,34,41
6120,just_relax,0.7000000000000001,3,3,0,-0.0014185667246167,0.0006213779664755,37,42
6121,just_relax,0.7000000000000001,36,36,0,7.196136941445275e-06,5.025038399830706e-06,18,29
6122,just_relax,0.7000000000000001,0,0,0,0.0,-0.0031405837993232,23,22
6123,just_relax,0.7000000000000001,0,0,0,0.0,1.0504657718901632e-05,13,12
6124,just_relax,0.7000000000000001,0,0,0,0.0,-0.0007613272869088,15,14
6125,just_relax,0.7000000000000001,0,0,0,0.0,-0.0017207203528439,69,68
6126,just_relax,0.7000000000000001,0,0,0,0.0,0.001934163275203,40,39
6127,just_relax,0.7000000000000001,0,0,0,0.0,0.0016954512903432,89,93
6128,just_relax,0.7000000000000001,13,13,0,1.511050374969713,-0.0878570612978808,20,32
6129,just_relax,0.7000000000000001,2,3,-1,-4.120223819609976,0.0096644512108772,69,83
6130,just_relax,0.7000000000000001,2,2,0,0.0006766545457281,-0.0007958153584334,12,15
6131,just_relax,0.7000000000000001,0,0,0,0.0,-0.0009758471183408,15,14
6132,just_relax,0.7000000000000001,0,0,0,0.0,-0.0007570529942456,23,26
6133,just_relax,0.7000000000000001,2,2,0,-0.0004670837519427,-0.000552899751354,12,20
6134,just_relax,0.7000000000000001,201,201,0,-5.927609844036397e-05,0.0001073571901385,64,122
6135,just_relax,0.7000000000000001,7,7,0,-0.0099055150386959,0.0003544031231826,58,71
6136,just_relax,0.7000000000000001,0,0,0,0.0,-0.0013086772972689,20,19
6137,just_relax,0.7000000000000001,510,505,5,-0.1096058695008466,0.0001562332230281,100,191
6138,just_relax,0.7000000000000001,34,34,0,0.0046498502251353,3.462795885833536e-05,41,61
6139,just_relax,0.7000000000000001,33,21,12,-0.322372772893118,0.0487025778316814,13,31
6140,just_relax,0.7000000000000001,5,5,0,0.0003476406123752,0.0002826333043987,10,15
6141,just_relax,0.7000000000000001,6,6,0,-0.0004254358946269,0.0003115870201488,37,47
6142,just_relax,0.7000000000000001,0,0,0,0.0,0.0007350584472026,21,21
6143,just_relax,0.7000000000000001,0,0,0,0.0,9.621758975453254e-06,11,10
6144,just_relax,0.7000000000000001,57,55,2,-1.1796960984034186,9.734149291917849e-05,44,80
6145,just_relax,0.7000000000000001,6,6,0,0.0001929725905256,-1.6711583069151104e-05,12,21
6146,just_relax,0.7000000000000001,2,5,-3,10.477360070400792,-0.0167672873232497,37,43
6147,just_relax,0.7000000000000001,6,6,0,-9.27967616917158e-05,0.0005867078171852,41,52
6148,just_relax,0.7000000000000001,0,0,0,0.0,0.0258238191424075,90,89
6149,just_relax,0.7000000000000001,0,0,0,0.0,-0.0001762041220683,22,21
6150,just_relax,0.7000000000000001,1,5,-4,-25.99394547658536,0.034397478016983,37,43
6151,just_relax,0.7000000000000001,0,0,0,0.0,0.009279908390236,47,47
6152,just_relax,0.7000000000000001,4,4,0,-0.0003372893218767,-9.212772776878708e-07,12,20
6153,just_relax,0.7000000000000001,114,95,19,0.8287298242191525,-0.006531385777559,84,124
6154,just_relax,0.7000000000000001,0,0,0,0.0,0.0016708237920683,88,92
6155,just_relax,0.7000000000000001,380,332,48,-1.681066658089314,0.0270328691740772,59,122
6156,just_relax,0.7000000000000001,4,4,0,2.0677824380754828e-05,-0.000363330475558,26,31
6157,just_relax,0.7000000000000001,0,0,0,0.0,4.418930553695688e-06,28,27
6158,just_relax,0.7000000000000001,6,6,0,0.0013890930604816,7.243956427815945e-06,18,26
6159,just_relax,0.7000000000000001,1,1,0,-0.0014241348598034,0.001861633846505,23,26
6160,just_relax,0.7000000000000001,0,0,0,0.0,0.0001814651838247,43,43
6161,just_relax,0.7000000000000001,2,2,0,0.0004949068667485,0.0012137972461528,22,26
6162,just_relax,0.7000000000000001,0,0,0,0.0,8.316094011640018e-06,15,14
6163,just_relax,0.7000000000000001,10,17,-7,3.5874123628873704,0.0856058777554238,36,48
6164,just_relax,0.7000000000000001,6,6,0,2.8016025522275783,-0.3535412006642752,30,37
6165,just_relax,0.7000000000000001,1,1,0,5.455328151526828e-05,-4.433967369288361e-05,10,13
6166,just_relax,0.7000000000000001,0,0,0,0.0,-0.0049855760382295,12,11
6167,just_relax,0.7000000000000001,168,182,-14,1.1771250480206064,-0.0267800915114647,55,105
6168,just_relax,0.7000000000000001,1,1,0,17.12164821735773,0.0578261695456346,13,17
6169,just_relax,0.7000000000000001,0,0,0,0.0,0.0003329515887838,30,29
6170,just_relax,0.7000000000000001,3,3,0,0.000583815366788,0.0008768881680062,36,43
6171,just_relax,0.7000000000000001,36,36,0,0.0010314806767866,-5.393936385500453e-05,40,60
6172,just_relax,0.7000000000000001,0,0,0,0.0,0.0017894746066188,13,17
6173,just_relax,0.7000000000000001,6,7,-1,-5.27235869178908,0.0082826452568239,23,30
6174,just_relax,0.7000000000000001,0,0,0,0.0,-2.940409977925107e-05,12,16
6175,just_relax,0.7000000000000001,0,0,0,0.0,3.901708024223183e-06,26,26
6176,just_relax,0.7000000000000001,0,0,0,0.0,-0.0031688166024113,22,31
6177,just_relax,0.7000000000000001,0,0,0,0.0,0.0008768193667615,68,68
6178,just_relax,0.7000000000000001,0,0,0,0.0,-7.938175057398134e-06,23,22
6179,just_relax,0.7000000000000001,0,0,0,0.0,-0.065399188004364,43,42
6180,just_relax,0.7000000000000001,0,0,0,0.0,-0.002899723134464,18,17
6181,just_relax,0.7000000000000001,3,3,0,-0.003194586812441,0.0012605153222713,28,42
6182,just_relax,0.7000000000000001,45,58,-13,0.9231299892006462,0.088218433779717,21,44
6183,just_relax,0.7000000000000001,0,0,0,0.0,-0.0112811671875761,36,37
6184,just_relax,0.7000000000000001,0,0,0,0.0,-3.4878924121017896e-05,15,14
6185,just_relax,0.7000000000000001,1,1,0,-0.0014549239964907,-0.00058525619921,14,16
6186,just_relax,0.7000000000000001,197,237,-40,1.3477492998050025,0.0885093784332623,61,119
6187,just_relax,0.7000000000000001,0,0,0,0.0,-0.0038599581671643,19,20
6188,just_relax,0.7000000000000001,0,0,0,0.0,-0.0006472841631984,22,22
6189,just_relax,0.7000000000000001,0,0,0,0.0,-0.0011415137972972,54,58
6190,just_relax,0.7000000000000001,651,651,0,-0.0003954210755097,0.0002252638081207,65,135
6191,just_relax,0.7000000000000001,1,1,0,-0.0029471577812358,0.0001749400264638,16,18
6192,just_relax,0.7000000000000001,7,7,0,0.0002013814076775,0.0006636994664107,17,27
6193,just_relax,0.7000000000000001,22,7,15,-12.985895473169307,0.1330374466905183,54,71
6194,just_relax,0.7000000000000001,0,2,-2,-59.99819093035041,-0.0131455917893484,23,22
6195,just_relax,0.7000000000000001,1,0,1,76.88395716132196,-0.1491322016956315,13,16
6196,just_relax,0.7000000000000001,155,185,-30,2.3843149677438973,-0.02495720013905,85,131
6197,just_relax,0.7000000000000001,44,44,0,0.0003032918935019,0.0025857794052007,28,55
6198,just_relax,0.7000000000000001,4,4,0,-0.0007096785766407,-5.4537984728875166e-05,18,24
6199,just_relax,0.7000000000000001,0,0,0,0.0,-0.003226028074061,19,22
6200,just_relax,0.7000000000000001,0,0,0,0.0,0.0048197166778652,47,46
6201,just_relax,0.7000000000000001,21,27,-6,0.0602947270368474,-0.3310372682946312,39,64
6202,just_relax,0.7000000000000001,0,0,0,0.0,-0.0037052423868473,17,18
6203,just_relax,0.7000000000000001,1,1,0,0.0005119856857191,0.0004745196477359,23,24
6204,just_relax,0.7000000000000001,2,2,0,0.0010275548569325,-0.004970471779609,13,16
6205,just_relax,0.7000000000000001,22,22,0,0.0038770082111057,0.0004285387996507,40,56
6206,just_relax,0.7000000000000001,1,1,0,-0.0002865966515059,-0.0003325971221349,10,15
6207,just_relax,0.7000000000000001,0,0,0,0.0,0.0003384089422906,21,20
6208,just_relax,0.7000000000000001,4,4,0,-0.0001029723687508,-0.0013906355929786,30,35
6209,just_relax,0.7000000000000001,1,1,0,0.0051043410712594,-0.0056156512673798,71,77
6210,relax_and_recompute,0.75,0,0,0,0.0,0.0,17,18
6211,relax_and_recompute,0.75,1,1,0,0.0,0.0,43,48
6212,relax_and_recompute,0.75,3,3,0,0.0,0.0,38,45
6213,relax_and_recompute,0.75,0,0,0,0.0,0.0,12,12
6214,relax_and_recompute,0.75,20,18,2,-3.2752299140735204,0.0114158034923678,23,38
6215,relax_and_recompute,0.75,0,0,0,0.0,0.0,19,22
6216,relax_and_recompute,0.75,976,1004,-28,-0.0620531910963606,-0.0009330148689207,35,143
6217,relax_and_recompute,0.75,0,0,0,0.0,0.0,92,91
6218,relax_and_recompute,0.75,2,2,0,0.0,0.0,43,51
6219,relax_and_recompute,0.75,1,1,0,0.0,0.0,35,36
6220,relax_and_recompute,0.75,1,1,0,0.0,0.0,11,13
6221,relax_and_recompute,0.75,22,22,0,0.0,0.0,10,25
6222,relax_and_recompute,0.75,16,16,0,0.0,0.0,86,136
6223,relax_and_recompute,0.75,0,0,0,0.0,0.0,10,12
6224,relax_and_recompute,0.75,0,0,0,0.0,0.0,32,31
6225,relax_and_recompute,0.75,2,2,0,0.0,0.0,20,26
6226,relax_and_recompute,0.75,0,0,0,0.0,0.0,11,11
6227,relax_and_recompute,0.75,2,2,0,0.0,0.0,34,42
6228,relax_and_recompute,0.75,11,11,0,0.0,0.0,14,25
6229,relax_and_recompute,0.75,8,8,0,0.0,0.0,31,46
6230,relax_and_recompute,0.75,0,0,0,0.0,0.0,42,45
6231,relax_and_recompute,0.75,1265,1233,32,-0.0829886923942524,-0.0013136328692162,39,173
6232,relax_and_recompute,0.75,11,11,0,0.0,0.0,14,24
6233,relax_and_recompute,0.75,0,0,0,0.0,0.0,24,25
6234,relax_and_recompute,0.75,2,2,0,0.0,0.0,12,19
6235,relax_and_recompute,0.75,59,59,0,0.0,0.0,41,72
6236,relax_and_recompute,0.75,182,182,0,0.0,0.0,59,115
6237,relax_and_recompute,0.75,6,6,0,0.0,0.0,32,37
6238,relax_and_recompute,0.75,1,1,0,0.0,0.0,20,20
6239,relax_and_recompute,0.75,41,26,15,-1.6275846340626714,0.0729158968985802,12,31
6240,relax_and_recompute,0.75,0,0,0,0.0,0.0,10,10
6241,relax_and_recompute,0.75,0,0,0,0.0,0.0,20,21
6242,relax_and_recompute,0.75,18,18,0,0.0,0.0,39,52
6243,relax_and_recompute,0.75,378,378,0,0.0,0.0,42,109
6244,relax_and_recompute,0.75,1,1,0,0.0,0.0,25,28
6245,relax_and_recompute,0.75,170,170,0,0.0,0.0,56,106
6246,relax_and_recompute,0.75,567,575,-8,0.4383057260994292,-0.0017656065849445,87,189
6247,relax_and_recompute,0.75,41,41,0,0.0,0.0,56,82
6248,relax_and_recompute,0.75,2,2,0,0.0,0.0,13,15
6249,relax_and_recompute,0.75,104,104,0,0.0,0.0,36,63
6250,relax_and_recompute,0.75,0,0,0,0.0,0.0,16,15
6251,relax_and_recompute,0.75,0,0,0,0.0,0.0,67,66
6252,relax_and_recompute,0.75,13,13,0,0.0,0.0,42,60
6253,relax_and_recompute,0.75,0,0,0,0.0,0.0,39,38
6254,relax_and_recompute,0.75,8,8,0,0.0,0.0,20,36
6255,relax_and_recompute,0.75,0,0,0,0.0,0.0,10,9
6256,relax_and_recompute,0.75,1,1,0,0.0,0.0,13,15
6257,relax_and_recompute,0.75,6,6,0,0.0,0.0,34,41
6258,relax_and_recompute,0.75,3,3,0,0.0,0.0,37,42
6259,relax_and_recompute,0.75,36,36,0,0.0,0.0,18,29
6260,relax_and_recompute,0.75,0,0,0,0.0,0.0,23,22
6261,relax_and_recompute,0.75,0,0,0,0.0,0.0,13,12
6262,relax_and_recompute,0.75,0,0,0,0.0,0.0,15,14
6263,relax_and_recompute,0.75,0,0,0,0.0,0.0,69,68
6264,relax_and_recompute,0.75,0,0,0,0.0,0.0,40,39
6265,relax_and_recompute,0.75,0,0,0,0.0,0.0,89,93
6266,relax_and_recompute,0.75,13,13,0,0.0,0.0,20,32
6267,relax_and_recompute,0.75,2,2,0,0.0,0.0,69,83
6268,relax_and_recompute,0.75,2,2,0,0.0,0.0,12,15
6269,relax_and_recompute,0.75,0,0,0,0.0,0.0,15,14
6270,relax_and_recompute,0.75,0,0,0,0.0,0.0,23,26
6271,relax_and_recompute,0.75,2,2,0,0.0,0.0,12,20
6272,relax_and_recompute,0.75,201,201,0,0.0,0.0,64,122
6273,relax_and_recompute,0.75,7,7,0,0.0,0.0,58,71
6274,relax_and_recompute,0.75,0,0,0,0.0,0.0,20,19
6275,relax_and_recompute,0.75,510,510,0,0.0,0.0,100,191
6276,relax_and_recompute,0.75,34,34,0,0.0,0.0,41,61
6277,relax_and_recompute,0.75,33,34,-1,-0.5384989905164446,0.0398816997391653,13,31
6278,relax_and_recompute,0.75,5,5,0,0.0,0.0,10,15
6279,relax_and_recompute,0.75,6,6,0,0.0,0.0,37,47
6280,relax_and_recompute,0.75,0,0,0,0.0,0.0,21,21
6281,relax_and_recompute,0.75,0,0,0,0.0,0.0,11,10
6282,relax_and_recompute,0.75,57,57,0,0.0,0.0,44,80
6283,relax_and_recompute,0.75,6,6,0,0.0,0.0,12,21
6284,relax_and_recompute,0.75,2,2,0,0.0,0.0,37,43
6285,relax_and_recompute,0.75,6,6,0,0.0,0.0,41,52
6286,relax_and_recompute,0.75,0,0,0,0.0,0.0,90,89
6287,relax_and_recompute,0.75,0,0,0,0.0,0.0,22,21
6288,relax_and_recompute,0.75,1,1,0,0.0,0.0,37,43
6289,relax_and_recompute,0.75,0,0,0,0.0,0.0,47,47
6290,relax_and_recompute,0.75,4,4,0,0.0,0.0,12,20
6291,relax_and_recompute,0.75,114,114,0,0.0,0.0,84,124
6292,relax_and_recompute,0.75,0,0,0,0.0,0.0,88,92
6293,relax_and_recompute,0.75,380,377,3,-0.3714807714610657,-0.0025427242202904,59,122
6294,relax_and_recompute,0.75,4,4,0,0.0,0.0,26,31
6295,relax_and_recompute,0.75,0,0,0,0.0,0.0,28,27
6296,relax_and_recompute,0.75,6,6,0,0.0,0.0,18,26
6297,relax_and_recompute,0.75,1,1,0,0.0,0.0,23,26
6298,relax_and_recompute,0.75,0,0,0,0.0,0.0,43,43
6299,relax_and_recompute,0.75,2,2,0,0.0,0.0,22,26
6300,relax_and_recompute,0.75,0,0,0,0.0,0.0,15,14
6301,relax_and_recompute,0.75,10,10,0,0.0,0.0,36,48
6302,relax_and_recompute,0.75,6,6,0,0.0,0.0,30,37
6303,relax_and_recompute,0.75,1,1,0,0.0,0.0,10,13
6304,relax_and_recompute,0.75,0,0,0,0.0,0.0,12,11
6305,relax_and_recompute,0.75,168,153,15,-1.4597591062543387,0.1638614131178267,55,105
6306,relax_and_recompute,0.75,1,1,0,0.0,0.0,13,17
6307,relax_and_recompute,0.75,0,0,0,0.0,0.0,30,29
6308,relax_and_recompute,0.75,3,3,0,0.0,0.0,36,43
6309,relax_and_recompute,0.75,36,36,0,0.0,0.0,40,60
6310,relax_and_recompute,0.75,0,0,0,0.0,0.0,13,17
6311,relax_and_recompute,0.75,6,6,0,0.0,0.0,23,30
6312,relax_and_recompute,0.75,0,0,0,0.0,0.0,12,16
6313,relax_and_recompute,0.75,0,0,0,0.0,0.0,26,26
6314,relax_and_recompute,0.75,0,0,0,0.0,0.0,22,31
6315,relax_and_recompute,0.75,0,0,0,0.0,0.0,68,68
6316,relax_and_recompute,0.75,0,0,0,0.0,0.0,23,22
6317,relax_and_recompute,0.75,0,0,0,0.0,0.0,43,42
6318,relax_and_recompute,0.75,0,0,0,0.0,0.0,18,17
6319,relax_and_recompute,0.75,3,3,0,0.0,0.0,28,42
6320,relax_and_recompute,0.75,45,45,0,0.0,0.0,21,44
6321,relax_and_recompute,0.75,0,0,0,0.0,0.0,36,37
6322,relax_and_recompute,0.75,0,0,0,0.0,0.0,15,14
6323,relax_and_recompute,0.75,1,1,0,0.0,0.0,14,16
6324,relax_and_recompute,0.75,197,204,-7,3.484436282689749,0.1757315340586914,61,119
6325,relax_and_recompute,0.75,0,0,0,0.0,0.0,19,20
6326,relax_and_recompute,0.75,0,0,0,0.0,0.0,22,22
6327,relax_and_recompute,0.75,0,0,0,0.0,0.0,54,58
6328,relax_and_recompute,0.75,651,651,0,0.0,0.0,65,135
6329,relax_and_recompute,0.75,1,1,0,0.0,0.0,16,18
6330,relax_and_recompute,0.75,7,7,0,0.0,0.0,17,27
6331,relax_and_recompute,0.75,22,22,0,0.0,0.0,54,71
6332,relax_and_recompute,0.75,0,0,0,0.0,0.0,23,22
6333,relax_and_recompute,0.75,1,1,0,0.0,0.0,13,16
6334,relax_and_recompute,0.75,155,146,9,-2.3741667241416664,-0.001397205031107,85,131
6335,relax_and_recompute,0.75,44,44,0,0.0,0.0,28,55
6336,relax_and_recompute,0.75,4,4,0,0.0,0.0,18,24
6337,relax_and_recompute,0.75,0,0,0,0.0,0.0,19,22
6338,relax_and_recompute,0.75,0,0,0,0.0,0.0,47,46
6339,relax_and_recompute,0.75,21,19,2,-6.356920988253222,0.0143956759658575,39,64
6340,relax_and_recompute,0.75,0,0,0,0.0,0.0,17,18
6341,relax_and_recompute,0.75,1,1,0,0.0,0.0,23,24
6342,relax_and_recompute,0.75,2,2,0,0.0,0.0,13,16
6343,relax_and_recompute,0.75,22,22,0,0.0,0.0,40,56
6344,relax_and_recompute,0.75,1,1,0,0.0,0.0,10,15
6345,relax_and_recompute,0.75,0,0,0,0.0,0.0,21,20
6346,relax_and_recompute,0.75,4,4,0,0.0,0.0,30,35
6347,relax_and_recompute,0.75,1,1,0,0.0,0.0,71,77
6348,relax_one,0.75,0,0,0,0.0,0.0,17,18
6349,relax_one,0.75,1,1,0,0.0,0.0,43,48
6350,relax_one,0.75,3,3,0,0.0,0.0,38,45
6351,relax_one,0.75,0,0,0,0.0,0.0,12,12
6352,relax_one,0.75,20,18,2,-3.2752299140735204,0.0114158034923678,23,38
6353,relax_one,0.75,0,1,-1,-78.11694026732484,-0.0295512202700576,19,22
6354,relax_one,0.75,976,978,-2,0.1423455471242221,-0.0025418055405018,35,143
6355,relax_one,0.75,0,1,-1,-50.19567681247512,-0.0041327022016595,92,91
6356,relax_one,0.75,2,2,0,0.0,0.0,43,51
6357,relax_one,0.75,1,1,0,0.0,0.0,35,36
6358,relax_one,0.75,1,1,0,0.0,0.0,11,13
6359,relax_one,0.75,22,20,2,-3.01441643358082,0.0082886474985522,10,25
6360,relax_one,0.75,16,16,0,0.0,0.0,86,136
6361,relax_one,0.75,0,0,0,0.0,0.0,10,12
6362,relax_one,0.75,0,0,0,0.0,0.0,32,31
6363,relax_one,0.75,2,2,0,4.970962038347736,-0.0904350603192869,20,26
6364,relax_one,0.75,0,0,0,0.0,0.0,11,11
6365,relax_one,0.75,2,2,0,0.0,0.0,34,42
6366,relax_one,0.75,11,11,0,0.0,0.0,14,25
6367,relax_one,0.75,8,7,1,13.99583228956454,0.1582030612456263,31,46
6368,relax_one,0.75,0,0,0,0.0,0.0,42,45
6369,relax_one,0.75,1265,1240,25,0.1009906236120983,0.0001682713719424,39,173
6370,relax_one,0.75,11,11,0,0.0,0.0,14,24
6371,relax_one,0.75,0,0,0,0.0,0.0,24,25
6372,relax_one,0.75,2,2,0,0.0,0.0,12,19
6373,relax_one,0.75,59,59,0,0.4609819410147793,0.0044552421238692,41,72
6374,relax_one,0.75,182,191,-9,1.446975953367918,0.0358261975695221,59,115
6375,relax_one,0.75,6,6,0,0.0,0.0,32,37
6376,relax_one,0.75,1,1,0,0.0,0.0,20,20
6377,relax_one,0.75,41,32,9,2.305146048931391,0.0775874222420341,12,31
6378,relax_one,0.75,0,0,0,0.0,0.0,10,10
6379,relax_one,0.75,0,0,0,0.0,0.0,20,21
6380,relax_one,0.75,18,18,0,0.0,0.0,39,52
6381,relax_one,0.75,378,395,-17,-0.4859193577000411,-0.0010324457545943,42,109
6382,relax_one,0.75,1,1,0,0.0,0.0,25,28
6383,relax_one,0.75,170,170,0,0.0,0.0,56,106
6384,relax_one,0.75,567,595,-28,0.7834114754025379,-0.002967395777259,87,189
6385,relax_one,0.75,41,41,0,-3.1762323320181167,-0.0099859384844429,56,82
6386,relax_one,0.75,2,2,0,0.0,0.0,13,15
6387,relax_one,0.75,104,88,16,-3.3995451437074067,-0.111275141568526,36,63
6388,relax_one,0.75,0,0,0,0.0,0.0,16,15
6389,relax_one,0.75,0,0,0,0.0,0.0,67,66
6390,relax_one,0.75,13,13,0,0.0,0.0,42,60
6391,relax_one,0.75,0,0,0,0.0,0.0,39,38
6392,relax_one,0.75,8,8,0,0.0,0.0,20,36
6393,relax_one,0.75,0,0,0,0.0,0.0,10,9
6394,relax_one,0.75,1,1,0,0.0,0.0,13,15
6395,relax_one,0.75,6,7,-1,12.522285729298716,0.0299062089849014,34,41
6396,relax_one,0.75,3,3,0,0.0,0.0,37,42
6397,relax_one,0.75,36,36,0,0.0,0.0,18,29
6398,relax_one,0.75,0,0,0,0.0,0.0,23,22
6399,relax_one,0.75,0,0,0,0.0,0.0,13,12
6400,relax_one,0.75,0,0,0,0.0,0.0,15,14
6401,relax_one,0.75,0,0,0,0.0,0.0,69,68
6402,relax_one,0.75,0,0,0,0.0,0.0,40,39
6403,relax_one,0.75,0,0,0,0.0,0.0,89,93
6404,relax_one,0.75,13,13,0,-2.975681235416161,-0.0847204542309565,20,32
6405,relax_one,0.75,2,2,0,0.0,0.0,69,83
6406,relax_one,0.75,2,2,0,0.0,0.0,12,15
6407,relax_one,0.75,0,0,0,0.0,0.0,15,14
6408,relax_one,0.75,0,0,0,0.0,0.0,23,26
6409,relax_one,0.75,2,2,0,0.0,0.0,12,20
6410,relax_one,0.75,201,201,0,0.0,0.0,64,122
6411,relax_one,0.75,7,7,0,0.0,0.0,58,71
6412,relax_one,0.75,0,0,0,0.0,0.0,20,19
6413,relax_one,0.75,510,510,0,0.0060639005596385,-0.0006916839131552,100,191
6414,relax_one,0.75,34,34,0,0.0,0.0,41,61
6415,relax_one,0.75,33,34,-1,-0.6264707699284884,0.0331924782664471,13,31
6416,relax_one,0.75,5,5,0,0.0,0.0,10,15
6417,relax_one,0.75,6,6,0,0.0,0.0,37,47
6418,relax_one,0.75,0,0,0,0.0,0.0,21,21
6419,relax_one,0.75,0,0,0,0.0,0.0,11,10
6420,relax_one,0.75,57,55,2,-1.1796960984034186,9.734149291917849e-05,44,80
6421,relax_one,0.75,6,6,0,0.0,0.0,12,21
6422,relax_one,0.75,2,2,0,42.15913628345388,-0.0181760816329957,37,43
6423,relax_one,0.75,6,6,0,0.0,0.0,41,52
6424,relax_one,0.75,0,0,0,0.0,0.0,90,89
6425,relax_one,0.75,0,0,0,0.0,0.0,22,21
6426,relax_one,0.75,1,1,0,-4.213527745425694,0.0417394626549948,37,43
6427,relax_one,0.75,0,0,0,0.0,0.0,47,47
6428,relax_one,0.75,4,4,0,0.0,0.0,12,20
6429,relax_one,0.75,114,114,0,0.0,0.0,84,124
6430,relax_one,0.75,0,0,0,0.0,0.0,88,92
6431,relax_one,0.75,380,377,3,-0.3714807714610657,-0.0025427242202904,59,122
6432,relax_one,0.75,4,4,0,0.0,0.0,26,31
6433,relax_one,0.75,0,0,0,0.0,0.0,28,27
6434,relax_one,0.75,6,6,0,0.0,0.0,18,26
6435,relax_one,0.75,1,1,0,0.0,0.0,23,26
6436,relax_one,0.75,0,0,0,0.0,0.0,43,43
6437,relax_one,0.75,2,2,0,0.0,0.0,22,26
6438,relax_one,0.75,0,0,0,0.0,0.0,15,14
6439,relax_one,0.75,10,17,-7,3.5874123628873704,0.0856058777554238,36,48
6440,relax_one,0.75,6,6,0,2.8016025522275783,-0.3535412006642752,30,37
6441,relax_one,0.75,1,1,0,0.0,0.0,10,13
6442,relax_one,0.75,0,0,0,0.0,0.0,12,11
6443,relax_one,0.75,168,167,1,-0.7965879277094672,0.0475430066924907,55,105
6444,relax_one,0.75,1,1,0,17.12164821735773,0.0578261695456346,13,17
6445,relax_one,0.75,0,0,0,0.0,0.0,30,29
6446,relax_one,0.75,3,3,0,0.0,0.0,36,43
6447,relax_one,0.75,36,36,0,0.0,0.0,40,60
6448,relax_one,0.75,0,0,0,0.0,0.0,13,17
6449,relax_one,0.75,6,7,-1,-5.27235869178908,0.0082826452568239,23,30
6450,relax_one,0.75,0,0,0,0.0,0.0,12,16
6451,relax_one,0.75,0,0,0,0.0,0.0,26,26
6452,relax_one,0.75,0,0,0,0.0,0.0,22,31
6453,relax_one,0.75,0,0,0,0.0,0.0,68,68
6454,relax_one,0.75,0,0,0,0.0,0.0,23,22
6455,relax_one,0.75,0,0,0,0.0,-0.0348129737608335,43,42
6456,relax_one,0.75,0,0,0,0.0,0.0,18,17
6457,relax_one,0.75,3,3,0,0.0,0.0,28,42
6458,relax_one,0.75,45,45,0,0.1036479088850654,-0.0041754562964496,21,44
6459,relax_one,0.75,0,0,0,0.0,0.0,36,37
6460,relax_one,0.75,0,0,0,0.0,0.0,15,14
6461,relax_one,0.75,1,1,0,0.0,0.0,14,16
6462,relax_one,0.75,197,204,-7,3.484436282689749,0.1757315340586914,61,119
6463,relax_one,0.75,0,0,0,0.0,0.0,19,20
6464,relax_one,0.75,0,0,0,0.0,0.0,22,22
6465,relax_one,0.75,0,0,0,0.0,0.0,54,58
6466,relax_one,0.75,651,651,0,0.0,0.0,65,135
6467,relax_one,0.75,1,1,0,0.0,0.0,16,18
6468,relax_one,0.75,7,7,0,0.0,0.0,17,27
6469,relax_one,0.75,22,4,18,-19.06910671434205,0.1469333863626725,54,71
6470,relax_one,0.75,0,2,-2,-59.99819093035041,-0.0131455917893484,23,22
6471,relax_one,0.75,1,0,1,76.88395716132196,-0.1491322016956315,13,16
6472,relax_one,0.75,155,146,9,-2.3741667241416664,-0.001397205031107,85,131
6473,relax_one,0.75,44,44,0,0.0,0.0,28,55
6474,relax_one,0.75,4,4,0,0.0,0.0,18,24
6475,relax_one,0.75,0,0,0,0.0,0.0,19,22
6476,relax_one,0.75,0,0,0,0.0,0.0,47,46
6477,relax_one,0.75,21,19,2,-6.356920988253222,0.0143956759658575,39,64
6478,relax_one,0.75,0,0,0,0.0,0.0,17,18
6479,relax_one,0.75,1,1,0,0.0,0.0,23,24
6480,relax_one,0.75,2,2,0,0.0,0.0,13,16
6481,relax_one,0.75,22,22,0,0.0,0.0,40,56
6482,relax_one,0.75,1,1,0,0.0,0.0,10,15
6483,relax_one,0.75,0,0,0,0.0,0.0,21,20
6484,relax_one,0.75,4,4,0,0.0,0.0,30,35
6485,relax_one,0.75,1,1,0,0.0,0.0,71,77
6486,just_relax,0.75,0,0,0,0.0,-0.0091692815110081,17,18
6487,just_relax,0.75,1,1,0,0.0009607869158827,0.0014628518031132,43,48
6488,just_relax,0.75,3,3,0,-0.0019521681741139,-7.679999619569777e-05,38,45
6489,just_relax,0.75,0,0,0,0.0,-0.0037600566419999,12,12
6490,just_relax,0.75,20,14,6,1.9891400956483096,0.1544148745043621,23,38
6491,just_relax,0.75,0,1,-1,-78.11694026732484,-0.0295512202700576,19,22
6492,just_relax,0.75,976,1188,-212,1.3106081233515638,0.0257948127350838,35,143
6493,just_relax,0.75,0,4,-4,-39.1818408082167,-0.0156618414823971,92,91
6494,just_relax,0.75,2,2,0,-0.00041775540015,-0.0002552385505018,43,51
6495,just_relax,0.75,1,1,0,-0.0016870080925173,6.40249009676297e-05,35,36
6496,just_relax,0.75,1,1,0,-0.000156439410091,0.0002508982184644,11,13
6497,just_relax,0.75,22,24,-2,-3.49415891827384,0.1000113687896936,10,25
6498,just_relax,0.75,16,13,3,0.2088785180214571,-2.2771107622610032e-05,86,136
6499,just_relax,0.75,0,0,0,0.0,-1.765503840900351e-06,10,12
6500,just_relax,0.75,0,0,0,0.0,-1.014518260578079e-05,32,31
6501,just_relax,0.75,2,2,0,4.970962038347736,-0.0904350603192869,20,26
6502,just_relax,0.75,0,0,0,0.0,0.000269092021105,11,11
6503,just_relax,0.75,2,2,0,0.0009292844165713,-0.0008610890242942,34,42
6504,just_relax,0.75,11,11,0,-0.0003616788843885,0.0005035529702898,14,25
6505,just_relax,0.75,8,7,1,13.99583228956454,0.1582030612456263,31,46
6506,just_relax,0.75,0,0,0,0.0,0.0042083907430441,42,45
6507,just_relax,0.75,1265,1285,-20,2.6849459664833404,-0.1292871249874528,39,173
6508,just_relax,0.75,11,11,0,0.0001627700527109,0.0015600944076981,14,24
6509,just_relax,0.75,0,0,0,0.0,-0.000608053012485,24,25
6510,just_relax,0.75,2,2,0,-2.981324638540173e-05,0.0001440646714581,12,19
6511,just_relax,0.75,59,59,0,0.4609819410147793,0.0044552421238692,41,72
6512,just_relax,0.75,182,178,4,0.0313317398119608,0.0970080713564147,59,115
6513,just_relax,0.75,6,6,0,-0.0020404096920856,0.0011964290694836,32,37
6514,just_relax,0.75,1,0,1,64.5674534074053,-0.0013228453280204,20,20
6515,just_relax,0.75,41,33,8,8.182357833947279,-0.009895766072516,12,31
6516,just_relax,0.75,0,0,0,0.0,-1.5942199658169898e-06,10,10
6517,just_relax,0.75,0,0,0,0.0,0.0018153466622625,20,21
6518,just_relax,0.75,18,18,0,0.0003589278580733,-0.0005865039043362,39,52
6519,just_relax,0.75,378,369,9,2.979528253482861,0.0835817869771829,42,109
6520,just_relax,0.75,1,1,0,-0.0010366044558338,-5.546321229055184e-05,25,28
6521,just_relax,0.75,170,170,0,-0.0002769762706833,-0.0005002245004087,56,106
6522,just_relax,0.75,567,521,46,-0.2657392120378574,0.1239070997048957,87,189
6523,just_relax,0.75,41,43,-2,2.499128887843675,-0.033528056765164,56,82
6524,just_relax,0.75,2,2,0,0.0004861774901456,1.2071037781558047e-06,13,15
6525,just_relax,0.75,104,86,18,5.26724471872344,-0.2840091449765524,36,63
6526,just_relax,0.75,0,0,0,0.0,4.3915154694929015e-06,16,15
6527,just_relax,0.75,0,0,0,0.0,-5.223096419815221e-07,67,66
6528,just_relax,0.75,13,13,0,0.0024384647237383,0.004260897920215,42,60
6529,just_relax,0.75,0,0,0,0.0,0.0005903979895692,39,38
6530,just_relax,0.75,8,8,0,-3.330899971842882e-05,0.0005334774465118,20,36
6531,just_relax,0.75,0,0,0,0.0,-0.0010596071395927,10,9
6532,just_relax,0.75,1,1,0,0.0009644178095271,-1.805181839154013e-05,13,15
6533,just_relax,0.75,6,7,-1,12.522285729298716,0.0299062089849014,34,41
6534,just_relax,0.75,3,3,0,-0.0014185667246167,0.0006213779664755,37,42
6535,just_relax,0.75,36,36,0,7.196136941445275e-06,5.025038399830706e-06,18,29
6536,just_relax,0.75,0,0,0,0.0,-0.0031405837993232,23,22
6537,just_relax,0.75,0,0,0,0.0,1.0504657718901632e-05,13,12
6538,just_relax,0.75,0,0,0,0.0,-0.0007613272869088,15,14
6539,just_relax,0.75,0,0,0,0.0,-0.0017207203528439,69,68
6540,just_relax,0.75,0,0,0,0.0,0.001934163275203,40,39
6541,just_relax,0.75,0,0,0,0.0,0.0016954512903432,89,93
6542,just_relax,0.75,13,13,0,1.511050374969713,-0.0878570612978808,20,32
6543,just_relax,0.75,2,3,-1,-4.120223819609976,0.0096644512108772,69,83
6544,just_relax,0.75,2,2,0,0.0006766545457281,-0.0007958153584334,12,15
6545,just_relax,0.75,0,0,0,0.0,-0.0009758471183408,15,14
6546,just_relax,0.75,0,0,0,0.0,-0.0007570529942456,23,26
6547,just_relax,0.75,2,2,0,-0.0004670837519427,-0.000552899751354,12,20
6548,just_relax,0.75,201,201,0,-5.927609844036397e-05,0.0001073571901385,64,122
6549,just_relax,0.75,7,7,0,-0.0099055150386959,0.0003544031231826,58,71
6550,just_relax,0.75,0,0,0,0.0,-0.0013086772972689,20,19
6551,just_relax,0.75,510,505,5,-0.1096058695008466,0.0001562332230281,100,191
6552,just_relax,0.75,34,34,0,0.0046498502251353,3.462795885833536e-05,41,61
6553,just_relax,0.75,33,21,12,-0.322372772893118,0.0487025778316814,13,31
6554,just_relax,0.75,5,5,0,0.0003476406123752,0.0002826333043987,10,15
6555,just_relax,0.75,6,6,0,-0.0004254358946269,0.0003115870201488,37,47
6556,just_relax,0.75,0,0,0,0.0,0.0007350584472026,21,21
6557,just_relax,0.75,0,0,0,0.0,9.621758975453254e-06,11,10
6558,just_relax,0.75,57,55,2,-1.1796960984034186,9.734149291917849e-05,44,80
6559,just_relax,0.75,6,6,0,0.0001929725905256,-1.6711583069151104e-05,12,21
6560,just_relax,0.75,2,5,-3,10.477360070400792,-0.0167672873232497,37,43
6561,just_relax,0.75,6,6,0,-9.27967616917158e-05,0.0005867078171852,41,52
6562,just_relax,0.75,0,0,0,0.0,0.0258238191424075,90,89
6563,just_relax,0.75,0,0,0,0.0,-0.0001762041220683,22,21
6564,just_relax,0.75,1,5,-4,-25.99394547658536,0.034397478016983,37,43
6565,just_relax,0.75,0,0,0,0.0,0.009279908390236,47,47
6566,just_relax,0.75,4,4,0,-0.0003372893218767,-9.212772776878708e-07,12,20
6567,just_relax,0.75,114,95,19,0.8287298242191525,-0.006531385777559,84,124
6568,just_relax,0.75,0,0,0,0.0,0.0016708237920683,88,92
6569,just_relax,0.75,380,332,48,-1.681066658089314,0.0270328691740772,59,122
6570,just_relax,0.75,4,4,0,2.0677824380754828e-05,-0.000363330475558,26,31
6571,just_relax,0.75,0,0,0,0.0,4.418930553695688e-06,28,27
6572,just_relax,0.75,6,6,0,0.0013890930604816,7.243956427815945e-06,18,26
6573,just_relax,0.75,1,1,0,-0.0014241348598034,0.001861633846505,23,26
6574,just_relax,0.75,0,0,0,0.0,0.0001814651838247,43,43
6575,just_relax,0.75,2,2,0,0.0004949068667485,0.0012137972461528,22,26
6576,just_relax,0.75,0,0,0,0.0,8.316094011640018e-06,15,14
6577,just_relax,0.75,10,17,-7,3.5874123628873704,0.0856058777554238,36,48
6578,just_relax,0.75,6,6,0,2.8016025522275783,-0.3535412006642752,30,37
6579,just_relax,0.75,1,1,0,5.455328151526828e-05,-4.433967369288361e-05,10,13
6580,just_relax,0.75,0,0,0,0.0,-0.0049855760382295,12,11
6581,just_relax,0.75,168,182,-14,1.1771250480206064,-0.0267800915114647,55,105
6582,just_relax,0.75,1,1,0,17.12164821735773,0.0578261695456346,13,17
6583,just_relax,0.75,0,0,0,0.0,0.0003329515887838,30,29
6584,just_relax,0.75,3,3,0,0.000583815366788,0.0008768881680062,36,43
6585,just_relax,0.75,36,36,0,0.0010314806767866,-5.393936385500453e-05,40,60
6586,just_relax,0.75,0,0,0,0.0,0.0017894746066188,13,17
6587,just_relax,0.75,6,7,-1,-5.27235869178908,0.0082826452568239,23,30
6588,just_relax,0.75,0,0,0,0.0,-2.940409977925107e-05,12,16
6589,just_relax,0.75,0,0,0,0.0,3.901708024223183e-06,26,26
6590,just_relax,0.75,0,0,0,0.0,-0.0031688166024113,22,31
6591,just_relax,0.75,0,0,0,0.0,0.0008768193667615,68,68
6592,just_relax,0.75,0,0,0,0.0,-7.938175057398134e-06,23,22
6593,just_relax,0.75,0,0,0,0.0,-0.065399188004364,43,42
6594,just_relax,0.75,0,0,0,0.0,-0.002899723134464,18,17
6595,just_relax,0.75,3,3,0,-0.003194586812441,0.0012605153222713,28,42
6596,just_relax,0.75,45,58,-13,0.9231299892006462,0.088218433779717,21,44
6597,just_relax,0.75,0,0,0,0.0,-0.0112811671875761,36,37
6598,just_relax,0.75,0,0,0,0.0,-3.4878924121017896e-05,15,14
6599,just_relax,0.75,1,1,0,-0.0014549239964907,-0.00058525619921,14,16
6600,just_relax,0.75,197,237,-40,1.3477492998050025,0.0885093784332623,61,119
6601,just_relax,0.75,0,0,0,0.0,-0.0038599581671643,19,20
6602,just_relax,0.75,0,0,0,0.0,-0.0006472841631984,22,22
6603,just_relax,0.75,0,0,0,0.0,-0.0011415137972972,54,58
6604,just_relax,0.75,651,651,0,-0.0003954210755097,0.0002252638081207,65,135
6605,just_relax,0.75,1,1,0,-0.0029471577812358,0.0001749400264638,16,18
6606,just_relax,0.75,7,7,0,0.0002013814076775,0.0006636994664107,17,27
6607,just_relax,0.75,22,7,15,-12.985895473169307,0.1330374466905183,54,71
6608,just_relax,0.75,0,2,-2,-59.99819093035041,-0.0131455917893484,23,22
6609,just_relax,0.75,1,0,1,76.88395716132196,-0.1491322016956315,13,16
6610,just_relax,0.75,155,185,-30,2.3843149677438973,-0.02495720013905,85,131
6611,just_relax,0.75,44,44,0,0.0003032918935019,0.0025857794052007,28,55
6612,just_relax,0.75,4,4,0,-0.0007096785766407,-5.4537984728875166e-05,18,24
6613,just_relax,0.75,0,0,0,0.0,-0.003226028074061,19,22
6614,just_relax,0.75,0,0,0,0.0,0.0048197166778652,47,46
6615,just_relax,0.75,21,27,-6,0.0602947270368474,-0.3310372682946312,39,64
6616,just_relax,0.75,0,0,0,0.0,-0.0037052423868473,17,18
6617,just_relax,0.75,1,1,0,0.0005119856857191,0.0004745196477359,23,24
6618,just_relax,0.75,2,2,0,0.0010275548569325,-0.004970471779609,13,16
6619,just_relax,0.75,22,22,0,0.0038770082111057,0.0004285387996507,40,56
6620,just_relax,0.75,1,1,0,-0.0002865966515059,-0.0003325971221349,10,15
6621,just_relax,0.75,0,0,0,0.0,0.0003384089422906,21,20
6622,just_relax,0.75,4,4,0,-0.0001029723687508,-0.0013906355929786,30,35
6623,just_relax,0.75,1,1,0,0.0051043410712594,-0.0056156512673798,71,77
6624,relax_and_recompute,0.8,0,0,0,0.0,0.0,17,18
6625,relax_and_recompute,0.8,1,1,0,0.0,0.0,43,48
6626,relax_and_recompute,0.8,3,3,0,0.0,0.0,38,45
6627,relax_and_recompute,0.8,0,0,0,0.0,0.0,12,12
6628,relax_and_recompute,0.8,20,18,2,-3.2752299140735204,0.0114158034923678,23,38
6629,relax_and_recompute,0.8,0,0,0,0.0,0.0,19,22
6630,relax_and_recompute,0.8,976,1004,-28,-0.0620531910963606,-0.0009330148689207,35,143
6631,relax_and_recompute,0.8,0,0,0,0.0,0.0,92,91
6632,relax_and_recompute,0.8,2,2,0,0.0,0.0,43,51
6633,relax_and_recompute,0.8,1,1,0,0.0,0.0,35,36
6634,relax_and_recompute,0.8,1,1,0,0.0,0.0,11,13
6635,relax_and_recompute,0.8,22,22,0,0.0,0.0,10,25
6636,relax_and_recompute,0.8,16,16,0,0.0,0.0,86,136
6637,relax_and_recompute,0.8,0,0,0,0.0,0.0,10,12
6638,relax_and_recompute,0.8,0,0,0,0.0,0.0,32,31
6639,relax_and_recompute,0.8,2,2,0,0.0,0.0,20,26
6640,relax_and_recompute,0.8,0,0,0,0.0,0.0,11,11
6641,relax_and_recompute,0.8,2,2,0,0.0,0.0,34,42
6642,relax_and_recompute,0.8,11,11,0,0.0,0.0,14,25
6643,relax_and_recompute,0.8,8,8,0,0.0,0.0,31,46
6644,relax_and_recompute,0.8,0,0,0,0.0,0.0,42,45
6645,relax_and_recompute,0.8,1265,1233,32,-0.0829886923942524,-0.0013136328692162,39,173
6646,relax_and_recompute,0.8,11,11,0,0.0,0.0,14,24
6647,relax_and_recompute,0.8,0,0,0,0.0,0.0,24,25
6648,relax_and_recompute,0.8,2,2,0,0.0,0.0,12,19
6649,relax_and_recompute,0.8,59,59,0,0.0,0.0,41,72
6650,relax_and_recompute,0.8,182,182,0,0.0,0.0,59,115
6651,relax_and_recompute,0.8,6,6,0,0.0,0.0,32,37
6652,relax_and_recompute,0.8,1,1,0,0.0,0.0,20,20
6653,relax_and_recompute,0.8,41,26,15,-1.6275846340626714,0.0729158968985802,12,31
6654,relax_and_recompute,0.8,0,0,0,0.0,0.0,10,10
6655,relax_and_recompute,0.8,0,0,0,0.0,0.0,20,21
6656,relax_and_recompute,0.8,18,18,0,0.0,0.0,39,52
6657,relax_and_recompute,0.8,378,378,0,0.0,0.0,42,109
6658,relax_and_recompute,0.8,1,1,0,0.0,0.0,25,28
6659,relax_and_recompute,0.8,170,170,0,0.0,0.0,56,106
6660,relax_and_recompute,0.8,567,575,-8,0.4383057260994292,-0.0017656065849445,87,189
6661,relax_and_recompute,0.8,41,41,0,0.0,0.0,56,82
6662,relax_and_recompute,0.8,2,2,0,0.0,0.0,13,15
6663,relax_and_recompute,0.8,104,104,0,0.0,0.0,36,63
6664,relax_and_recompute,0.8,0,0,0,0.0,0.0,16,15
6665,relax_and_recompute,0.8,0,0,0,0.0,0.0,67,66
6666,relax_and_recompute,0.8,13,13,0,0.0,0.0,42,60
6667,relax_and_recompute,0.8,0,0,0,0.0,0.0,39,38
6668,relax_and_recompute,0.8,8,8,0,0.0,0.0,20,36
6669,relax_and_recompute,0.8,0,0,0,0.0,0.0,10,9
6670,relax_and_recompute,0.8,1,1,0,0.0,0.0,13,15
6671,relax_and_recompute,0.8,6,6,0,0.0,0.0,34,41
6672,relax_and_recompute,0.8,3,3,0,0.0,0.0,37,42
6673,relax_and_recompute,0.8,36,36,0,0.0,0.0,18,29
6674,relax_and_recompute,0.8,0,0,0,0.0,0.0,23,22
6675,relax_and_recompute,0.8,0,0,0,0.0,0.0,13,12
6676,relax_and_recompute,0.8,0,0,0,0.0,0.0,15,14
6677,relax_and_recompute,0.8,0,0,0,0.0,0.0,69,68
6678,relax_and_recompute,0.8,0,0,0,0.0,0.0,40,39
6679,relax_and_recompute,0.8,0,0,0,0.0,0.0,89,93
6680,relax_and_recompute,0.8,13,13,0,0.0,0.0,20,32
6681,relax_and_recompute,0.8,2,2,0,0.0,0.0,69,83
6682,relax_and_recompute,0.8,2,2,0,0.0,0.0,12,15
6683,relax_and_recompute,0.8,0,0,0,0.0,0.0,15,14
6684,relax_and_recompute,0.8,0,0,0,0.0,0.0,23,26
6685,relax_and_recompute,0.8,2,2,0,0.0,0.0,12,20
6686,relax_and_recompute,0.8,201,201,0,0.0,0.0,64,122
6687,relax_and_recompute,0.8,7,7,0,0.0,0.0,58,71
6688,relax_and_recompute,0.8,0,0,0,0.0,0.0,20,19
6689,relax_and_recompute,0.8,510,510,0,0.0,0.0,100,191
6690,relax_and_recompute,0.8,34,34,0,0.0,0.0,41,61
6691,relax_and_recompute,0.8,33,34,-1,-0.5384989905164446,0.0398816997391653,13,31
6692,relax_and_recompute,0.8,5,5,0,0.0,0.0,10,15
6693,relax_and_recompute,0.8,6,6,0,0.0,0.0,37,47
6694,relax_and_recompute,0.8,0,0,0,0.0,0.0,21,21
6695,relax_and_recompute,0.8,0,0,0,0.0,0.0,11,10
6696,relax_and_recompute,0.8,57,57,0,0.0,0.0,44,80
6697,relax_and_recompute,0.8,6,6,0,0.0,0.0,12,21
6698,relax_and_recompute,0.8,2,2,0,0.0,0.0,37,43
6699,relax_and_recompute,0.8,6,6,0,0.0,0.0,41,52
6700,relax_and_recompute,0.8,0,0,0,0.0,0.0,90,89
6701,relax_and_recompute,0.8,0,0,0,0.0,0.0,22,21
6702,relax_and_recompute,0.8,1,1,0,0.0,0.0,37,43
6703,relax_and_recompute,0.8,0,0,0,0.0,0.0,47,47
6704,relax_and_recompute,0.8,4,4,0,0.0,0.0,12,20
6705,relax_and_recompute,0.8,114,114,0,0.0,0.0,84,124
6706,relax_and_recompute,0.8,0,0,0,0.0,0.0,88,92
6707,relax_and_recompute,0.8,380,377,3,-0.3714807714610657,-0.0025427242202904,59,122
6708,relax_and_recompute,0.8,4,4,0,0.0,0.0,26,31
6709,relax_and_recompute,0.8,0,0,0,0.0,0.0,28,27
6710,relax_and_recompute,0.8,6,6,0,0.0,0.0,18,26
6711,relax_and_recompute,0.8,1,1,0,0.0,0.0,23,26
6712,relax_and_recompute,0.8,0,0,0,0.0,0.0,43,43
6713,relax_and_recompute,0.8,2,2,0,0.0,0.0,22,26
6714,relax_and_recompute,0.8,0,0,0,0.0,0.0,15,14
6715,relax_and_recompute,0.8,10,10,0,0.0,0.0,36,48
6716,relax_and_recompute,0.8,6,6,0,0.0,0.0,30,37
6717,relax_and_recompute,0.8,1,1,0,0.0,0.0,10,13
6718,relax_and_recompute,0.8,0,0,0,0.0,0.0,12,11
6719,relax_and_recompute,0.8,168,153,15,-1.4597591062543387,0.1638614131178267,55,105
6720,relax_and_recompute,0.8,1,1,0,0.0,0.0,13,17
6721,relax_and_recompute,0.8,0,0,0,0.0,0.0,30,29
6722,relax_and_recompute,0.8,3,3,0,0.0,0.0,36,43
6723,relax_and_recompute,0.8,36,36,0,0.0,0.0,40,60
6724,relax_and_recompute,0.8,0,0,0,0.0,0.0,13,17
6725,relax_and_recompute,0.8,6,6,0,0.0,0.0,23,30
6726,relax_and_recompute,0.8,0,0,0,0.0,0.0,12,16
6727,relax_and_recompute,0.8,0,0,0,0.0,0.0,26,26
6728,relax_and_recompute,0.8,0,0,0,0.0,0.0,22,31
6729,relax_and_recompute,0.8,0,0,0,0.0,0.0,68,68
6730,relax_and_recompute,0.8,0,0,0,0.0,0.0,23,22
6731,relax_and_recompute,0.8,0,0,0,0.0,0.0,43,42
6732,relax_and_recompute,0.8,0,0,0,0.0,0.0,18,17
6733,relax_and_recompute,0.8,3,3,0,0.0,0.0,28,42
6734,relax_and_recompute,0.8,45,45,0,0.0,0.0,21,44
6735,relax_and_recompute,0.8,0,0,0,0.0,0.0,36,37
6736,relax_and_recompute,0.8,0,0,0,0.0,0.0,15,14
6737,relax_and_recompute,0.8,1,1,0,0.0,0.0,14,16
6738,relax_and_recompute,0.8,197,204,-7,3.484436282689749,0.1757315340586914,61,119
6739,relax_and_recompute,0.8,0,0,0,0.0,0.0,19,20
6740,relax_and_recompute,0.8,0,0,0,0.0,0.0,22,22
6741,relax_and_recompute,0.8,0,0,0,0.0,0.0,54,58
6742,relax_and_recompute,0.8,651,651,0,0.0,0.0,65,135
6743,relax_and_recompute,0.8,1,1,0,0.0,0.0,16,18
6744,relax_and_recompute,0.8,7,7,0,0.0,0.0,17,27
6745,relax_and_recompute,0.8,22,22,0,0.0,0.0,54,71
6746,relax_and_recompute,0.8,0,0,0,0.0,0.0,23,22
6747,relax_and_recompute,0.8,1,1,0,0.0,0.0,13,16
6748,relax_and_recompute,0.8,155,146,9,-2.3741667241416664,-0.001397205031107,85,131
6749,relax_and_recompute,0.8,44,44,0,0.0,0.0,28,55
6750,relax_and_recompute,0.8,4,4,0,0.0,0.0,18,24
6751,relax_and_recompute,0.8,0,0,0,0.0,0.0,19,22
6752,relax_and_recompute,0.8,0,0,0,0.0,0.0,47,46
6753,relax_and_recompute,0.8,21,21,0,0.0,0.0,39,64
6754,relax_and_recompute,0.8,0,0,0,0.0,0.0,17,18
6755,relax_and_recompute,0.8,1,1,0,0.0,0.0,23,24
6756,relax_and_recompute,0.8,2,2,0,0.0,0.0,13,16
6757,relax_and_recompute,0.8,22,22,0,0.0,0.0,40,56
6758,relax_and_recompute,0.8,1,1,0,0.0,0.0,10,15
6759,relax_and_recompute,0.8,0,0,0,0.0,0.0,21,20
6760,relax_and_recompute,0.8,4,4,0,0.0,0.0,30,35
6761,relax_and_recompute,0.8,1,1,0,0.0,0.0,71,77
6762,relax_one,0.8,0,0,0,0.0,0.0,17,18
6763,relax_one,0.8,1,1,0,0.0,0.0,43,48
6764,relax_one,0.8,3,3,0,0.0,0.0,38,45
6765,relax_one,0.8,0,0,0,0.0,0.0,12,12
6766,relax_one,0.8,20,18,2,-3.2752299140735204,0.0114158034923678,23,38
6767,relax_one,0.8,0,1,-1,-78.11694026732484,-0.0295512202700576,19,22
6768,relax_one,0.8,976,978,-2,0.1423455471242221,-0.0025418055405018,35,143
6769,relax_one,0.8,0,1,-1,-50.19567681247512,-0.0041327022016595,92,91
6770,relax_one,0.8,2,2,0,0.0,0.0,43,51
6771,relax_one,0.8,1,1,0,0.0,0.0,35,36
6772,relax_one,0.8,1,1,0,0.0,0.0,11,13
6773,relax_one,0.8,22,20,2,-3.01441643358082,0.0082886474985522,10,25
6774,relax_one,0.8,16,16,0,0.0,0.0,86,136
6775,relax_one,0.8,0,0,0,0.0,0.0,10,12
6776,relax_one,0.8,0,0,0,0.0,0.0,32,31
6777,relax_one,0.8,2,2,0,4.970962038347736,-0.0904350603192869,20,26
6778,relax_one,0.8,0,0,0,0.0,0.0,11,11
6779,relax_one,0.8,2,2,0,0.0,0.0,34,42
6780,relax_one,0.8,11,11,0,0.0,0.0,14,25
6781,relax_one,0.8,8,7,1,13.99583228956454,0.1582030612456263,31,46
6782,relax_one,0.8,0,0,0,0.0,0.0,42,45
6783,relax_one,0.8,1265,1240,25,0.1009906236120983,0.0001682713719424,39,173
6784,relax_one,0.8,11,11,0,0.0,0.0,14,24
6785,relax_one,0.8,0,0,0,0.0,0.0,24,25
6786,relax_one,0.8,2,2,0,0.0,0.0,12,19
6787,relax_one,0.8,59,59,0,0.4609819410147793,0.0044552421238692,41,72
6788,relax_one,0.8,182,191,-9,1.446975953367918,0.0358261975695221,59,115
6789,relax_one,0.8,6,6,0,0.0,0.0,32,37
6790,relax_one,0.8,1,1,0,0.0,0.0,20,20
6791,relax_one,0.8,41,32,9,2.305146048931391,0.0775874222420341,12,31
6792,relax_one,0.8,0,0,0,0.0,0.0,10,10
6793,relax_one,0.8,0,0,0,0.0,0.0,20,21
6794,relax_one,0.8,18,18,0,0.0,0.0,39,52
6795,relax_one,0.8,378,395,-17,-0.4859193577000411,-0.0010324457545943,42,109
6796,relax_one,0.8,1,1,0,0.0,0.0,25,28
6797,relax_one,0.8,170,170,0,0.0,0.0,56,106
6798,relax_one,0.8,567,595,-28,0.7834114754025379,-0.002967395777259,87,189
6799,relax_one,0.8,41,41,0,-3.1762323320181167,-0.0099859384844429,56,82
6800,relax_one,0.8,2,2,0,0.0,0.0,13,15
6801,relax_one,0.8,104,88,16,-3.3995451437074067,-0.111275141568526,36,63
6802,relax_one,0.8,0,0,0,0.0,0.0,16,15
6803,relax_one,0.8,0,0,0,0.0,0.0,67,66
6804,relax_one,0.8,13,13,0,0.0,0.0,42,60
6805,relax_one,0.8,0,0,0,0.0,0.0,39,38
6806,relax_one,0.8,8,8,0,0.0,0.0,20,36
6807,relax_one,0.8,0,0,0,0.0,0.0,10,9
6808,relax_one,0.8,1,1,0,0.0,0.0,13,15
6809,relax_one,0.8,6,7,-1,12.522285729298716,0.0299062089849014,34,41
6810,relax_one,0.8,3,3,0,0.0,0.0,37,42
6811,relax_one,0.8,36,36,0,0.0,0.0,18,29
6812,relax_one,0.8,0,0,0,0.0,0.0,23,22
6813,relax_one,0.8,0,0,0,0.0,0.0,13,12
6814,relax_one,0.8,0,0,0,0.0,0.0,15,14
6815,relax_one,0.8,0,0,0,0.0,0.0,69,68
6816,relax_one,0.8,0,0,0,0.0,0.0,40,39
6817,relax_one,0.8,0,0,0,0.0,0.0,89,93
6818,relax_one,0.8,13,13,0,-2.975681235416161,-0.0847204542309565,20,32
6819,relax_one,0.8,2,2,0,0.0,0.0,69,83
6820,relax_one,0.8,2,2,0,0.0,0.0,12,15
6821,relax_one,0.8,0,0,0,0.0,0.0,15,14
6822,relax_one,0.8,0,0,0,0.0,0.0,23,26
6823,relax_one,0.8,2,2,0,0.0,0.0,12,20
6824,relax_one,0.8,201,201,0,0.0,0.0,64,122
6825,relax_one,0.8,7,7,0,0.0,0.0,58,71
6826,relax_one,0.8,0,0,0,0.0,0.0,20,19
6827,relax_one,0.8,510,510,0,0.0060639005596385,-0.0006916839131552,100,191
6828,relax_one,0.8,34,34,0,0.0,0.0,41,61
6829,relax_one,0.8,33,34,-1,-0.6264707699284884,0.0331924782664471,13,31
6830,relax_one,0.8,5,5,0,0.0,0.0,10,15
6831,relax_one,0.8,6,6,0,0.0,0.0,37,47
6832,relax_one,0.8,0,0,0,0.0,0.0,21,21
6833,relax_one,0.8,0,0,0,0.0,0.0,11,10
6834,relax_one,0.8,57,55,2,-1.1796960984034186,9.734149291917849e-05,44,80
6835,relax_one,0.8,6,6,0,0.0,0.0,12,21
6836,relax_one,0.8,2,2,0,42.15913628345388,-0.0181760816329957,37,43
6837,relax_one,0.8,6,6,0,0.0,0.0,41,52
6838,relax_one,0.8,0,0,0,0.0,0.0,90,89
6839,relax_one,0.8,0,0,0,0.0,0.0,22,21
6840,relax_one,0.8,1,1,0,-4.213527745425694,0.0417394626549948,37,43
6841,relax_one,0.8,0,0,0,0.0,0.0,47,47
6842,relax_one,0.8,4,4,0,0.0,0.0,12,20
6843,relax_one,0.8,114,114,0,0.0,0.0,84,124
6844,relax_one,0.8,0,0,0,0.0,0.0,88,92
6845,relax_one,0.8,380,377,3,-0.3714807714610657,-0.0025427242202904,59,122
6846,relax_one,0.8,4,4,0,0.0,0.0,26,31
6847,relax_one,0.8,0,0,0,0.0,0.0,28,27
6848,relax_one,0.8,6,6,0,0.0,0.0,18,26
6849,relax_one,0.8,1,1,0,0.0,0.0,23,26
6850,relax_one,0.8,0,0,0,0.0,0.0,43,43
6851,relax_one,0.8,2,2,0,0.0,0.0,22,26
6852,relax_one,0.8,0,0,0,0.0,0.0,15,14
6853,relax_one,0.8,10,17,-7,3.5874123628873704,0.0856058777554238,36,48
6854,relax_one,0.8,6,6,0,2.8016025522275783,-0.3535412006642752,30,37
6855,relax_one,0.8,1,1,0,0.0,0.0,10,13
6856,relax_one,0.8,0,0,0,0.0,0.0,12,11
6857,relax_one,0.8,168,167,1,-0.7965879277094672,0.0475430066924907,55,105
6858,relax_one,0.8,1,1,0,17.12164821735773,0.0578261695456346,13,17
6859,relax_one,0.8,0,0,0,0.0,0.0,30,29
6860,relax_one,0.8,3,3,0,0.0,0.0,36,43
6861,relax_one,0.8,36,36,0,0.0,0.0,40,60
6862,relax_one,0.8,0,0,0,0.0,0.0,13,17
6863,relax_one,0.8,6,7,-1,-5.27235869178908,0.0082826452568239,23,30
6864,relax_one,0.8,0,0,0,0.0,0.0,12,16
6865,relax_one,0.8,0,0,0,0.0,0.0,26,26
6866,relax_one,0.8,0,0,0,0.0,0.0,22,31
6867,relax_one,0.8,0,0,0,0.0,0.0,68,68
6868,relax_one,0.8,0,0,0,0.0,0.0,23,22
6869,relax_one,0.8,0,0,0,0.0,-0.0348129737608335,43,42
6870,relax_one,0.8,0,0,0,0.0,0.0,18,17
6871,relax_one,0.8,3,3,0,0.0,0.0,28,42
6872,relax_one,0.8,45,45,0,0.1036479088850654,-0.0041754562964496,21,44
6873,relax_one,0.8,0,0,0,0.0,0.0,36,37
6874,relax_one,0.8,0,0,0,0.0,0.0,15,14
6875,relax_one,0.8,1,1,0,0.0,0.0,14,16
6876,relax_one,0.8,197,204,-7,3.484436282689749,0.1757315340586914,61,119
6877,relax_one,0.8,0,0,0,0.0,0.0,19,20
6878,relax_one,0.8,0,0,0,0.0,0.0,22,22
6879,relax_one,0.8,0,0,0,0.0,0.0,54,58
6880,relax_one,0.8,651,651,0,0.0,0.0,65,135
6881,relax_one,0.8,1,1,0,0.0,0.0,16,18
6882,relax_one,0.8,7,7,0,0.0,0.0,17,27
6883,relax_one,0.8,22,4,18,-19.06910671434205,0.1469333863626725,54,71
6884,relax_one,0.8,0,2,-2,-59.99819093035041,-0.0131455917893484,23,22
6885,relax_one,0.8,1,0,1,76.88395716132196,-0.1491322016956315,13,16
6886,relax_one,0.8,155,146,9,-2.3741667241416664,-0.001397205031107,85,131
6887,relax_one,0.8,44,44,0,0.0,0.0,28,55
6888,relax_one,0.8,4,4,0,0.0,0.0,18,24
6889,relax_one,0.8,0,0,0,0.0,0.0,19,22
6890,relax_one,0.8,0,0,0,0.0,0.0,47,46
6891,relax_one,0.8,21,19,2,-6.356920988253222,0.0143956759658575,39,64
6892,relax_one,0.8,0,0,0,0.0,0.0,17,18
6893,relax_one,0.8,1,1,0,0.0,0.0,23,24
6894,relax_one,0.8,2,2,0,0.0,0.0,13,16
6895,relax_one,0.8,22,22,0,0.0,0.0,40,56
6896,relax_one,0.8,1,1,0,0.0,0.0,10,15
6897,relax_one,0.8,0,0,0,0.0,0.0,21,20
6898,relax_one,0.8,4,4,0,0.0,0.0,30,35
6899,relax_one,0.8,1,1,0,0.0,0.0,71,77
6900,just_relax,0.8,0,0,0,0.0,-0.0091692815110081,17,18
6901,just_relax,0.8,1,1,0,0.0009607869158827,0.0014628518031132,43,48
6902,just_relax,0.8,3,3,0,-0.0019521681741139,-7.679999619569777e-05,38,45
6903,just_relax,0.8,0,0,0,0.0,-0.0037600566419999,12,12
6904,just_relax,0.8,20,14,6,1.9891400956483096,0.1544148745043621,23,38
6905,just_relax,0.8,0,1,-1,-78.11694026732484,-0.0295512202700576,19,22
6906,just_relax,0.8,976,1188,-212,1.3106081233515638,0.0257948127350838,35,143
6907,just_relax,0.8,0,4,-4,-39.1818408082167,-0.0156618414823971,92,91
6908,just_relax,0.8,2,2,0,-0.00041775540015,-0.0002552385505018,43,51
6909,just_relax,0.8,1,1,0,-0.0016870080925173,6.40249009676297e-05,35,36
6910,just_relax,0.8,1,1,0,-0.000156439410091,0.0002508982184644,11,13
6911,just_relax,0.8,22,24,-2,-3.49415891827384,0.1000113687896936,10,25
6912,just_relax,0.8,16,13,3,0.2088785180214571,-2.2771107622610032e-05,86,136
6913,just_relax,0.8,0,0,0,0.0,-1.765503840900351e-06,10,12
6914,just_relax,0.8,0,0,0,0.0,-1.014518260578079e-05,32,31
6915,just_relax,0.8,2,2,0,4.970962038347736,-0.0904350603192869,20,26
6916,just_relax,0.8,0,0,0,0.0,0.000269092021105,11,11
6917,just_relax,0.8,2,2,0,0.0009292844165713,-0.0008610890242942,34,42
6918,just_relax,0.8,11,11,0,-0.0003616788843885,0.0005035529702898,14,25
6919,just_relax,0.8,8,7,1,13.99583228956454,0.1582030612456263,31,46
6920,just_relax,0.8,0,0,0,0.0,0.0042083907430441,42,45
6921,just_relax,0.8,1265,1285,-20,2.6849459664833404,-0.1292871249874528,39,173
6922,just_relax,0.8,11,11,0,0.0001627700527109,0.0015600944076981,14,24
6923,just_relax,0.8,0,0,0,0.0,-0.000608053012485,24,25
6924,just_relax,0.8,2,2,0,-2.981324638540173e-05,0.0001440646714581,12,19
6925,just_relax,0.8,59,59,0,0.4609819410147793,0.0044552421238692,41,72
6926,just_relax,0.8,182,178,4,0.0313317398119608,0.0970080713564147,59,115
6927,just_relax,0.8,6,6,0,-0.0020404096920856,0.0011964290694836,32,37
6928,just_relax,0.8,1,0,1,64.5674534074053,-0.0013228453280204,20,20
6929,just_relax,0.8,41,33,8,8.182357833947279,-0.009895766072516,12,31
6930,just_relax,0.8,0,0,0,0.0,-1.5942199658169898e-06,10,10
6931,just_relax,0.8,0,0,0,0.0,0.0018153466622625,20,21
6932,just_relax,0.8,18,18,0,0.0003589278580733,-0.0005865039043362,39,52
6933,just_relax,0.8,378,369,9,2.979528253482861,0.0835817869771829,42,109
6934,just_relax,0.8,1,1,0,-0.0010366044558338,-5.546321229055184e-05,25,28
6935,just_relax,0.8,170,170,0,-0.0002769762706833,-0.0005002245004087,56,106
6936,just_relax,0.8,567,521,46,-0.2657392120378574,0.1239070997048957,87,189
6937,just_relax,0.8,41,43,-2,2.499128887843675,-0.033528056765164,56,82
6938,just_relax,0.8,2,2,0,0.0004861774901456,1.2071037781558047e-06,13,15
6939,just_relax,0.8,104,86,18,5.26724471872344,-0.2840091449765524,36,63
6940,just_relax,0.8,0,0,0,0.0,4.3915154694929015e-06,16,15
6941,just_relax,0.8,0,0,0,0.0,-5.223096419815221e-07,67,66
6942,just_relax,0.8,13,13,0,0.0024384647237383,0.004260897920215,42,60
6943,just_relax,0.8,0,0,0,0.0,0.0005903979895692,39,38
6944,just_relax,0.8,8,8,0,-3.330899971842882e-05,0.0005334774465118,20,36
6945,just_relax,0.8,0,0,0,0.0,-0.0010596071395927,10,9
6946,just_relax,0.8,1,1,0,0.0009644178095271,-1.805181839154013e-05,13,15
6947,just_relax,0.8,6,7,-1,12.522285729298716,0.0299062089849014,34,41
6948,just_relax,0.8,3,3,0,-0.0014185667246167,0.0006213779664755,37,42
6949,just_relax,0.8,36,36,0,7.196136941445275e-06,5.025038399830706e-06,18,29
6950,just_relax,0.8,0,0,0,0.0,-0.0031405837993232,23,22
6951,just_relax,0.8,0,0,0,0.0,1.0504657718901632e-05,13,12
6952,just_relax,0.8,0,0,0,0.0,-0.0007613272869088,15,14
6953,just_relax,0.8,0,0,0,0.0,-0.0017207203528439,69,68
6954,just_relax,0.8,0,0,0,0.0,0.001934163275203,40,39
6955,just_relax,0.8,0,0,0,0.0,0.0016954512903432,89,93
6956,just_relax,0.8,13,13,0,1.511050374969713,-0.0878570612978808,20,32
6957,just_relax,0.8,2,3,-1,-4.120223819609976,0.0096644512108772,69,83
6958,just_relax,0.8,2,2,0,0.0006766545457281,-0.0007958153584334,12,15
6959,just_relax,0.8,0,0,0,0.0,-0.0009758471183408,15,14
6960,just_relax,0.8,0,0,0,0.0,-0.0007570529942456,23,26
6961,just_relax,0.8,2,2,0,-0.0004670837519427,-0.000552899751354,12,20
6962,just_relax,0.8,201,201,0,-5.927609844036397e-05,0.0001073571901385,64,122
6963,just_relax,0.8,7,7,0,-0.0099055150386959,0.0003544031231826,58,71
6964,just_relax,0.8,0,0,0,0.0,-0.0013086772972689,20,19
6965,just_relax,0.8,510,505,5,-0.1096058695008466,0.0001562332230281,100,191
6966,just_relax,0.8,34,34,0,0.0046498502251353,3.462795885833536e-05,41,61
6967,just_relax,0.8,33,21,12,-0.322372772893118,0.0487025778316814,13,31
6968,just_relax,0.8,5,5,0,0.0003476406123752,0.0002826333043987,10,15
6969,just_relax,0.8,6,6,0,-0.0004254358946269,0.0003115870201488,37,47
6970,just_relax,0.8,0,0,0,0.0,0.0007350584472026,21,21
6971,just_relax,0.8,0,0,0,0.0,9.621758975453254e-06,11,10
6972,just_relax,0.8,57,55,2,-1.1796960984034186,9.734149291917849e-05,44,80
6973,just_relax,0.8,6,6,0,0.0001929725905256,-1.6711583069151104e-05,12,21
6974,just_relax,0.8,2,5,-3,10.477360070400792,-0.0167672873232497,37,43
6975,just_relax,0.8,6,6,0,-9.27967616917158e-05,0.0005867078171852,41,52
6976,just_relax,0.8,0,0,0,0.0,0.0258238191424075,90,89
6977,just_relax,0.8,0,0,0,0.0,-0.0001762041220683,22,21
6978,just_relax,0.8,1,5,-4,-25.99394547658536,0.034397478016983,37,43
6979,just_relax,0.8,0,0,0,0.0,0.009279908390236,47,47
6980,just_relax,0.8,4,4,0,-0.0003372893218767,-9.212772776878708e-07,12,20
6981,just_relax,0.8,114,95,19,0.8287298242191525,-0.006531385777559,84,124
6982,just_relax,0.8,0,0,0,0.0,0.0016708237920683,88,92
6983,just_relax,0.8,380,332,48,-1.681066658089314,0.0270328691740772,59,122
6984,just_relax,0.8,4,4,0,2.0677824380754828e-05,-0.000363330475558,26,31
6985,just_relax,0.8,0,0,0,0.0,4.418930553695688e-06,28,27
6986,just_relax,0.8,6,6,0,0.0013890930604816,7.243956427815945e-06,18,26
6987,just_relax,0.8,1,1,0,-0.0014241348598034,0.001861633846505,23,26
6988,just_relax,0.8,0,0,0,0.0,0.0001814651838247,43,43
6989,just_relax,0.8,2,2,0,0.0004949068667485,0.0012137972461528,22,26
6990,just_relax,0.8,0,0,0,0.0,8.316094011640018e-06,15,14
6991,just_relax,0.8,10,17,-7,3.5874123628873704,0.0856058777554238,36,48
6992,just_relax,0.8,6,6,0,2.8016025522275783,-0.3535412006642752,30,37
6993,just_relax,0.8,1,1,0,5.455328151526828e-05,-4.433967369288361e-05,10,13
6994,just_relax,0.8,0,0,0,0.0,-0.0049855760382295,12,11
6995,just_relax,0.8,168,182,-14,1.1771250480206064,-0.0267800915114647,55,105
6996,just_relax,0.8,1,1,0,17.12164821735773,0.0578261695456346,13,17
6997,just_relax,0.8,0,0,0,0.0,0.0003329515887838,30,29
6998,just_relax,0.8,3,3,0,0.000583815366788,0.0008768881680062,36,43
6999,just_relax,0.8,36,36,0,0.0010314806767866,-5.393936385500453e-05,40,60
7000,just_relax,0.8,0,0,0,0.0,0.0017894746066188,13,17
7001,just_relax,0.8,6,7,-1,-5.27235869178908,0.0082826452568239,23,30
7002,just_relax,0.8,0,0,0,0.0,-2.940409977925107e-05,12,16
7003,just_relax,0.8,0,0,0,0.0,3.901708024223183e-06,26,26
7004,just_relax,0.8,0,0,0,0.0,-0.0031688166024113,22,31
7005,just_relax,0.8,0,0,0,0.0,0.0008768193667615,68,68
7006,just_relax,0.8,0,0,0,0.0,-7.938175057398134e-06,23,22
7007,just_relax,0.8,0,0,0,0.0,-0.065399188004364,43,42
7008,just_relax,0.8,0,0,0,0.0,-0.002899723134464,18,17
7009,just_relax,0.8,3,3,0,-0.003194586812441,0.0012605153222713,28,42
7010,just_relax,0.8,45,58,-13,0.9231299892006462,0.088218433779717,21,44
7011,just_relax,0.8,0,0,0,0.0,-0.0112811671875761,36,37
7012,just_relax,0.8,0,0,0,0.0,-3.4878924121017896e-05,15,14
7013,just_relax,0.8,1,1,0,-0.0014549239964907,-0.00058525619921,14,16
7014,just_relax,0.8,197,237,-40,1.3477492998050025,0.0885093784332623,61,119
7015,just_relax,0.8,0,0,0,0.0,-0.0038599581671643,19,20
7016,just_relax,0.8,0,0,0,0.0,-0.0006472841631984,22,22
7017,just_relax,0.8,0,0,0,0.0,-0.0011415137972972,54,58
7018,just_relax,0.8,651,651,0,-0.0003954210755097,0.0002252638081207,65,135
7019,just_relax,0.8,1,1,0,-0.0029471577812358,0.0001749400264638,16,18
7020,just_relax,0.8,7,7,0,0.0002013814076775,0.0006636994664107,17,27
7021,just_relax,0.8,22,7,15,-12.985895473169307,0.1330374466905183,54,71
7022,just_relax,0.8,0,2,-2,-59.99819093035041,-0.0131455917893484,23,22
7023,just_relax,0.8,1,0,1,76.88395716132196,-0.1491322016956315,13,16
7024,just_relax,0.8,155,185,-30,2.3843149677438973,-0.02495720013905,85,131
7025,just_relax,0.8,44,44,0,0.0003032918935019,0.0025857794052007,28,55
7026,just_relax,0.8,4,4,0,-0.0007096785766407,-5.4537984728875166e-05,18,24
7027,just_relax,0.8,0,0,0,0.0,-0.003226028074061,19,22
7028,just_relax,0.8,0,0,0,0.0,0.0048197166778652,47,46
7029,just_relax,0.8,21,27,-6,0.0602947270368474,-0.3310372682946312,39,64
7030,just_relax,0.8,0,0,0,0.0,-0.0037052423868473,17,18
7031,just_relax,0.8,1,1,0,0.0005119856857191,0.0004745196477359,23,24
7032,just_relax,0.8,2,2,0,0.0010275548569325,-0.004970471779609,13,16
7033,just_relax,0.8,22,22,0,0.0038770082111057,0.0004285387996507,40,56
7034,just_relax,0.8,1,1,0,-0.0002865966515059,-0.0003325971221349,10,15
7035,just_relax,0.8,0,0,0,0.0,0.0003384089422906,21,20
7036,just_relax,0.8,4,4,0,-0.0001029723687508,-0.0013906355929786,30,35
7037,just_relax,0.8,1,1,0,0.0051043410712594,-0.0056156512673798,71,77
7038,relax_and_recompute,0.8500000000000001,0,0,0,0.0,0.0,17,18
7039,relax_and_recompute,0.8500000000000001,1,1,0,0.0,0.0,43,48
7040,relax_and_recompute,0.8500000000000001,3,3,0,0.0,0.0,38,45
7041,relax_and_recompute,0.8500000000000001,0,0,0,0.0,0.0,12,12
7042,relax_and_recompute,0.8500000000000001,20,18,2,-3.2752299140735204,0.0114158034923678,23,38
7043,relax_and_recompute,0.8500000000000001,0,0,0,0.0,0.0,19,22
7044,relax_and_recompute,0.8500000000000001,976,976,0,0.0,0.0,35,143
7045,relax_and_recompute,0.8500000000000001,0,0,0,0.0,0.0,92,91
7046,relax_and_recompute,0.8500000000000001,2,2,0,0.0,0.0,43,51
7047,relax_and_recompute,0.8500000000000001,1,1,0,0.0,0.0,35,36
7048,relax_and_recompute,0.8500000000000001,1,1,0,0.0,0.0,11,13
7049,relax_and_recompute,0.8500000000000001,22,22,0,0.0,0.0,10,25
7050,relax_and_recompute,0.8500000000000001,16,16,0,0.0,0.0,86,136
7051,relax_and_recompute,0.8500000000000001,0,0,0,0.0,0.0,10,12
7052,relax_and_recompute,0.8500000000000001,0,0,0,0.0,0.0,32,31
7053,relax_and_recompute,0.8500000000000001,2,2,0,0.0,0.0,20,26
7054,relax_and_recompute,0.8500000000000001,0,0,0,0.0,0.0,11,11
7055,relax_and_recompute,0.8500000000000001,2,2,0,0.0,0.0,34,42
7056,relax_and_recompute,0.8500000000000001,11,11,0,0.0,0.0,14,25
7057,relax_and_recompute,0.8500000000000001,8,8,0,0.0,0.0,31,46
7058,relax_and_recompute,0.8500000000000001,0,0,0,0.0,0.0,42,45
7059,relax_and_recompute,0.8500000000000001,1265,1233,32,-0.0829886923942524,-0.0013136328692162,39,173
7060,relax_and_recompute,0.8500000000000001,11,11,0,0.0,0.0,14,24
7061,relax_and_recompute,0.8500000000000001,0,0,0,0.0,0.0,24,25
7062,relax_and_recompute,0.8500000000000001,2,2,0,0.0,0.0,12,19
7063,relax_and_recompute,0.8500000000000001,59,59,0,0.0,0.0,41,72
7064,relax_and_recompute,0.8500000000000001,182,182,0,0.0,0.0,59,115
7065,relax_and_recompute,0.8500000000000001,6,6,0,0.0,0.0,32,37
7066,relax_and_recompute,0.8500000000000001,1,1,0,0.0,0.0,20,20
7067,relax_and_recompute,0.8500000000000001,41,32,9,2.305146048931391,0.0775874222420341,12,31
7068,relax_and_recompute,0.8500000000000001,0,0,0,0.0,0.0,10,10
7069,relax_and_recompute,0.8500000000000001,0,0,0,0.0,0.0,20,21
7070,relax_and_recompute,0.8500000000000001,18,18,0,0.0,0.0,39,52
7071,relax_and_recompute,0.8500000000000001,378,378,0,0.0,0.0,42,109
7072,relax_and_recompute,0.8500000000000001,1,1,0,0.0,0.0,25,28
7073,relax_and_recompute,0.8500000000000001,170,170,0,0.0,0.0,56,106
7074,relax_and_recompute,0.8500000000000001,567,595,-28,0.7834114754025379,-0.002967395777259,87,189
7075,relax_and_recompute,0.8500000000000001,41,41,0,0.0,0.0,56,82
7076,relax_and_recompute,0.8500000000000001,2,2,0,0.0,0.0,13,15
7077,relax_and_recompute,0.8500000000000001,104,104,0,0.0,0.0,36,63
7078,relax_and_recompute,0.8500000000000001,0,0,0,0.0,0.0,16,15
7079,relax_and_recompute,0.8500000000000001,0,0,0,0.0,0.0,67,66
7080,relax_and_recompute,0.8500000000000001,13,13,0,0.0,0.0,42,60
7081,relax_and_recompute,0.8500000000000001,0,0,0,0.0,0.0,39,38
7082,relax_and_recompute,0.8500000000000001,8,8,0,0.0,0.0,20,36
7083,relax_and_recompute,0.8500000000000001,0,0,0,0.0,0.0,10,9
7084,relax_and_recompute,0.8500000000000001,1,1,0,0.0,0.0,13,15
7085,relax_and_recompute,0.8500000000000001,6,6,0,0.0,0.0,34,41
7086,relax_and_recompute,0.8500000000000001,3,3,0,0.0,0.0,37,42
7087,relax_and_recompute,0.8500000000000001,36,36,0,0.0,0.0,18,29
7088,relax_and_recompute,0.8500000000000001,0,0,0,0.0,0.0,23,22
7089,relax_and_recompute,0.8500000000000001,0,0,0,0.0,0.0,13,12
7090,relax_and_recompute,0.8500000000000001,0,0,0,0.0,0.0,15,14
7091,relax_and_recompute,0.8500000000000001,0,0,0,0.0,0.0,69,68
7092,relax_and_recompute,0.8500000000000001,0,0,0,0.0,0.0,40,39
7093,relax_and_recompute,0.8500000000000001,0,0,0,0.0,0.0,89,93
7094,relax_and_recompute,0.8500000000000001,13,13,0,0.0,0.0,20,32
7095,relax_and_recompute,0.8500000000000001,2,2,0,0.0,0.0,69,83
7096,relax_and_recompute,0.8500000000000001,2,2,0,0.0,0.0,12,15
7097,relax_and_recompute,0.8500000000000001,0,0,0,0.0,0.0,15,14
7098,relax_and_recompute,0.8500000000000001,0,0,0,0.0,0.0,23,26
7099,relax_and_recompute,0.8500000000000001,2,2,0,0.0,0.0,12,20
7100,relax_and_recompute,0.8500000000000001,201,201,0,0.0,0.0,64,122
7101,relax_and_recompute,0.8500000000000001,7,7,0,0.0,0.0,58,71
7102,relax_and_recompute,0.8500000000000001,0,0,0,0.0,0.0,20,19
7103,relax_and_recompute,0.8500000000000001,510,510,0,0.0,0.0,100,191
7104,relax_and_recompute,0.8500000000000001,34,34,0,0.0,0.0,41,61
7105,relax_and_recompute,0.8500000000000001,33,34,-1,-0.5384989905164446,0.0398816997391653,13,31
7106,relax_and_recompute,0.8500000000000001,5,5,0,0.0,0.0,10,15
7107,relax_and_recompute,0.8500000000000001,6,6,0,0.0,0.0,37,47
7108,relax_and_recompute,0.8500000000000001,0,0,0,0.0,0.0,21,21
7109,relax_and_recompute,0.8500000000000001,0,0,0,0.0,0.0,11,10
7110,relax_and_recompute,0.8500000000000001,57,57,0,0.0,0.0,44,80
7111,relax_and_recompute,0.8500000000000001,6,6,0,0.0,0.0,12,21
7112,relax_and_recompute,0.8500000000000001,2,2,0,0.0,0.0,37,43
7113,relax_and_recompute,0.8500000000000001,6,6,0,0.0,0.0,41,52
7114,relax_and_recompute,0.8500000000000001,0,0,0,0.0,0.0,90,89
7115,relax_and_recompute,0.8500000000000001,0,0,0,0.0,0.0,22,21
7116,relax_and_recompute,0.8500000000000001,1,1,0,0.0,0.0,37,43
7117,relax_and_recompute,0.8500000000000001,0,0,0,0.0,0.0,47,47
7118,relax_and_recompute,0.8500000000000001,4,4,0,0.0,0.0,12,20
7119,relax_and_recompute,0.8500000000000001,114,114,0,0.0,0.0,84,124
7120,relax_and_recompute,0.8500000000000001,0,0,0,0.0,0.0,88,92
7121,relax_and_recompute,0.8500000000000001,380,380,0,0.0,0.0,59,122
7122,relax_and_recompute,0.8500000000000001,4,4,0,0.0,0.0,26,31
7123,relax_and_recompute,0.8500000000000001,0,0,0,0.0,0.0,28,27
7124,relax_and_recompute,0.8500000000000001,6,6,0,0.0,0.0,18,26
7125,relax_and_recompute,0.8500000000000001,1,1,0,0.0,0.0,23,26
7126,relax_and_recompute,0.8500000000000001,0,0,0,0.0,0.0,43,43
7127,relax_and_recompute,0.8500000000000001,2,2,0,0.0,0.0,22,26
7128,relax_and_recompute,0.8500000000000001,0,0,0,0.0,0.0,15,14
7129,relax_and_recompute,0.8500000000000001,10,10,0,0.0,0.0,36,48
7130,relax_and_recompute,0.8500000000000001,6,6,0,0.0,0.0,30,37
7131,relax_and_recompute,0.8500000000000001,1,1,0,0.0,0.0,10,13
7132,relax_and_recompute,0.8500000000000001,0,0,0,0.0,0.0,12,11
7133,relax_and_recompute,0.8500000000000001,168,153,15,-1.4597591062543387,0.1638614131178267,55,105
7134,relax_and_recompute,0.8500000000000001,1,1,0,0.0,0.0,13,17
7135,relax_and_recompute,0.8500000000000001,0,0,0,0.0,0.0,30,29
7136,relax_and_recompute,0.8500000000000001,3,3,0,0.0,0.0,36,43
7137,relax_and_recompute,0.8500000000000001,36,36,0,0.0,0.0,40,60
7138,relax_and_recompute,0.8500000000000001,0,0,0,0.0,0.0,13,17
7139,relax_and_recompute,0.8500000000000001,6,6,0,0.0,0.0,23,30
7140,relax_and_recompute,0.8500000000000001,0,0,0,0.0,0.0,12,16
7141,relax_and_recompute,0.8500000000000001,0,0,0,0.0,0.0,26,26
7142,relax_and_recompute,0.8500000000000001,0,0,0,0.0,0.0,22,31
7143,relax_and_recompute,0.8500000000000001,0,0,0,0.0,0.0,68,68
7144,relax_and_recompute,0.8500000000000001,0,0,0,0.0,0.0,23,22
7145,relax_and_recompute,0.8500000000000001,0,0,0,0.0,0.0,43,42
7146,relax_and_recompute,0.8500000000000001,0,0,0,0.0,0.0,18,17
7147,relax_and_recompute,0.8500000000000001,3,3,0,0.0,0.0,28,42
7148,relax_and_recompute,0.8500000000000001,45,45,0,0.0,0.0,21,44
7149,relax_and_recompute,0.8500000000000001,0,0,0,0.0,0.0,36,37
7150,relax_and_recompute,0.8500000000000001,0,0,0,0.0,0.0,15,14
7151,relax_and_recompute,0.8500000000000001,1,1,0,0.0,0.0,14,16
7152,relax_and_recompute,0.8500000000000001,197,204,-7,3.484436282689749,0.1757315340586914,61,119
7153,relax_and_recompute,0.8500000000000001,0,0,0,0.0,0.0,19,20
7154,relax_and_recompute,0.8500000000000001,0,0,0,0.0,0.0,22,22
7155,relax_and_recompute,0.8500000000000001,0,0,0,0.0,0.0,54,58
7156,relax_and_recompute,0.8500000000000001,651,651,0,0.0,0.0,65,135
7157,relax_and_recompute,0.8500000000000001,1,1,0,0.0,0.0,16,18
7158,relax_and_recompute,0.8500000000000001,7,7,0,0.0,0.0,17,27
7159,relax_and_recompute,0.8500000000000001,22,22,0,0.0,0.0,54,71
7160,relax_and_recompute,0.8500000000000001,0,0,0,0.0,0.0,23,22
7161,relax_and_recompute,0.8500000000000001,1,1,0,0.0,0.0,13,16
7162,relax_and_recompute,0.8500000000000001,155,146,9,-2.3741667241416664,-0.001397205031107,85,131
7163,relax_and_recompute,0.8500000000000001,44,44,0,0.0,0.0,28,55
7164,relax_and_recompute,0.8500000000000001,4,4,0,0.0,0.0,18,24
7165,relax_and_recompute,0.8500000000000001,0,0,0,0.0,0.0,19,22
7166,relax_and_recompute,0.8500000000000001,0,0,0,0.0,0.0,47,46
7167,relax_and_recompute,0.8500000000000001,21,21,0,0.0,0.0,39,64
7168,relax_and_recompute,0.8500000000000001,0,0,0,0.0,0.0,17,18
7169,relax_and_recompute,0.8500000000000001,1,1,0,0.0,0.0,23,24
7170,relax_and_recompute,0.8500000000000001,2,2,0,0.0,0.0,13,16
7171,relax_and_recompute,0.8500000000000001,22,22,0,0.0,0.0,40,56
7172,relax_and_recompute,0.8500000000000001,1,1,0,0.0,0.0,10,15
7173,relax_and_recompute,0.8500000000000001,0,0,0,0.0,0.0,21,20
7174,relax_and_recompute,0.8500000000000001,4,4,0,0.0,0.0,30,35
7175,relax_and_recompute,0.8500000000000001,1,1,0,0.0,0.0,71,77
7176,relax_one,0.8500000000000001,0,0,0,0.0,0.0,17,18
7177,relax_one,0.8500000000000001,1,1,0,0.0,0.0,43,48
7178,relax_one,0.8500000000000001,3,3,0,0.0,0.0,38,45
7179,relax_one,0.8500000000000001,0,0,0,0.0,0.0,12,12
7180,relax_one,0.8500000000000001,20,18,2,-3.2752299140735204,0.0114158034923678,23,38
7181,relax_one,0.8500000000000001,0,1,-1,-78.11694026732484,-0.0295512202700576,19,22
7182,relax_one,0.8500000000000001,976,978,-2,0.1423455471242221,-0.0025418055405018,35,143
7183,relax_one,0.8500000000000001,0,1,-1,-50.19567681247512,-0.0041327022016595,92,91
7184,relax_one,0.8500000000000001,2,2,0,0.0,0.0,43,51
7185,relax_one,0.8500000000000001,1,1,0,0.0,0.0,35,36
7186,relax_one,0.8500000000000001,1,1,0,0.0,0.0,11,13
7187,relax_one,0.8500000000000001,22,20,2,-3.01441643358082,0.0082886474985522,10,25
7188,relax_one,0.8500000000000001,16,16,0,0.0,0.0,86,136
7189,relax_one,0.8500000000000001,0,0,0,0.0,0.0,10,12
7190,relax_one,0.8500000000000001,0,0,0,0.0,0.0,32,31
7191,relax_one,0.8500000000000001,2,2,0,4.970962038347736,-0.0904350603192869,20,26
7192,relax_one,0.8500000000000001,0,0,0,0.0,0.0,11,11
7193,relax_one,0.8500000000000001,2,2,0,0.0,0.0,34,42
7194,relax_one,0.8500000000000001,11,11,0,0.0,0.0,14,25
7195,relax_one,0.8500000000000001,8,7,1,13.99583228956454,0.1582030612456263,31,46
7196,relax_one,0.8500000000000001,0,0,0,0.0,0.0,42,45
7197,relax_one,0.8500000000000001,1265,1240,25,0.1009906236120983,0.0001682713719424,39,173
7198,relax_one,0.8500000000000001,11,11,0,0.0,0.0,14,24
7199,relax_one,0.8500000000000001,0,0,0,0.0,0.0,24,25
7200,relax_one,0.8500000000000001,2,2,0,0.0,0.0,12,19
7201,relax_one,0.8500000000000001,59,59,0,0.4609819410147793,0.0044552421238692,41,72
7202,relax_one,0.8500000000000001,182,191,-9,1.446975953367918,0.0358261975695221,59,115
7203,relax_one,0.8500000000000001,6,6,0,0.0,0.0,32,37
7204,relax_one,0.8500000000000001,1,1,0,0.0,0.0,20,20
7205,relax_one,0.8500000000000001,41,32,9,2.305146048931391,0.0775874222420341,12,31
7206,relax_one,0.8500000000000001,0,0,0,0.0,0.0,10,10
7207,relax_one,0.8500000000000001,0,0,0,0.0,0.0,20,21
7208,relax_one,0.8500000000000001,18,18,0,0.0,0.0,39,52
7209,relax_one,0.8500000000000001,378,395,-17,-0.4859193577000411,-0.0010324457545943,42,109
7210,relax_one,0.8500000000000001,1,1,0,0.0,0.0,25,28
7211,relax_one,0.8500000000000001,170,170,0,0.0,0.0,56,106
7212,relax_one,0.8500000000000001,567,595,-28,0.7834114754025379,-0.002967395777259,87,189
7213,relax_one,0.8500000000000001,41,41,0,-3.1762323320181167,-0.0099859384844429,56,82
7214,relax_one,0.8500000000000001,2,2,0,0.0,0.0,13,15
7215,relax_one,0.8500000000000001,104,88,16,-3.3995451437074067,-0.111275141568526,36,63
7216,relax_one,0.8500000000000001,0,0,0,0.0,0.0,16,15
7217,relax_one,0.8500000000000001,0,0,0,0.0,0.0,67,66
7218,relax_one,0.8500000000000001,13,13,0,0.0,0.0,42,60
7219,relax_one,0.8500000000000001,0,0,0,0.0,0.0,39,38
7220,relax_one,0.8500000000000001,8,8,0,0.0,0.0,20,36
7221,relax_one,0.8500000000000001,0,0,0,0.0,0.0,10,9
7222,relax_one,0.8500000000000001,1,1,0,0.0,0.0,13,15
7223,relax_one,0.8500000000000001,6,7,-1,12.522285729298716,0.0299062089849014,34,41
7224,relax_one,0.8500000000000001,3,3,0,0.0,0.0,37,42
7225,relax_one,0.8500000000000001,36,36,0,0.0,0.0,18,29
7226,relax_one,0.8500000000000001,0,0,0,0.0,0.0,23,22
7227,relax_one,0.8500000000000001,0,0,0,0.0,0.0,13,12
7228,relax_one,0.8500000000000001,0,0,0,0.0,0.0,15,14
7229,relax_one,0.8500000000000001,0,0,0,0.0,0.0,69,68
7230,relax_one,0.8500000000000001,0,0,0,0.0,0.0,40,39
7231,relax_one,0.8500000000000001,0,0,0,0.0,0.0,89,93
7232,relax_one,0.8500000000000001,13,13,0,-2.975681235416161,-0.0847204542309565,20,32
7233,relax_one,0.8500000000000001,2,2,0,0.0,0.0,69,83
7234,relax_one,0.8500000000000001,2,2,0,0.0,0.0,12,15
7235,relax_one,0.8500000000000001,0,0,0,0.0,0.0,15,14
7236,relax_one,0.8500000000000001,0,0,0,0.0,0.0,23,26
7237,relax_one,0.8500000000000001,2,2,0,0.0,0.0,12,20
7238,relax_one,0.8500000000000001,201,201,0,0.0,0.0,64,122
7239,relax_one,0.8500000000000001,7,7,0,0.0,0.0,58,71
7240,relax_one,0.8500000000000001,0,0,0,0.0,0.0,20,19
7241,relax_one,0.8500000000000001,510,510,0,0.0060639005596385,-0.0006916839131552,100,191
7242,relax_one,0.8500000000000001,34,34,0,0.0,0.0,41,61
7243,relax_one,0.8500000000000001,33,34,-1,-0.6264707699284884,0.0331924782664471,13,31
7244,relax_one,0.8500000000000001,5,5,0,0.0,0.0,10,15
7245,relax_one,0.8500000000000001,6,6,0,0.0,0.0,37,47
7246,relax_one,0.8500000000000001,0,0,0,0.0,0.0,21,21
7247,relax_one,0.8500000000000001,0,0,0,0.0,0.0,11,10
7248,relax_one,0.8500000000000001,57,55,2,-1.1796960984034186,9.734149291917849e-05,44,80
7249,relax_one,0.8500000000000001,6,6,0,0.0,0.0,12,21
7250,relax_one,0.8500000000000001,2,2,0,42.15913628345388,-0.0181760816329957,37,43
7251,relax_one,0.8500000000000001,6,6,0,0.0,0.0,41,52
7252,relax_one,0.8500000000000001,0,0,0,0.0,0.0,90,89
7253,relax_one,0.8500000000000001,0,0,0,0.0,0.0,22,21
7254,relax_one,0.8500000000000001,1,1,0,-4.213527745425694,0.0417394626549948,37,43
7255,relax_one,0.8500000000000001,0,0,0,0.0,0.0,47,47
7256,relax_one,0.8500000000000001,4,4,0,0.0,0.0,12,20
7257,relax_one,0.8500000000000001,114,114,0,0.0,0.0,84,124
7258,relax_one,0.8500000000000001,0,0,0,0.0,0.0,88,92
7259,relax_one,0.8500000000000001,380,377,3,-0.3714807714610657,-0.0025427242202904,59,122
7260,relax_one,0.8500000000000001,4,4,0,0.0,0.0,26,31
7261,relax_one,0.8500000000000001,0,0,0,0.0,0.0,28,27
7262,relax_one,0.8500000000000001,6,6,0,0.0,0.0,18,26
7263,relax_one,0.8500000000000001,1,1,0,0.0,0.0,23,26
7264,relax_one,0.8500000000000001,0,0,0,0.0,0.0,43,43
7265,relax_one,0.8500000000000001,2,2,0,0.0,0.0,22,26
7266,relax_one,0.8500000000000001,0,0,0,0.0,0.0,15,14
7267,relax_one,0.8500000000000001,10,17,-7,3.5874123628873704,0.0856058777554238,36,48
7268,relax_one,0.8500000000000001,6,6,0,2.8016025522275783,-0.3535412006642752,30,37
7269,relax_one,0.8500000000000001,1,1,0,0.0,0.0,10,13
7270,relax_one,0.8500000000000001,0,0,0,0.0,0.0,12,11
7271,relax_one,0.8500000000000001,168,167,1,-0.7965879277094672,0.0475430066924907,55,105
7272,relax_one,0.8500000000000001,1,1,0,17.12164821735773,0.0578261695456346,13,17
7273,relax_one,0.8500000000000001,0,0,0,0.0,0.0,30,29
7274,relax_one,0.8500000000000001,3,3,0,0.0,0.0,36,43
7275,relax_one,0.8500000000000001,36,36,0,0.0,0.0,40,60
7276,relax_one,0.8500000000000001,0,0,0,0.0,0.0,13,17
7277,relax_one,0.8500000000000001,6,7,-1,-5.27235869178908,0.0082826452568239,23,30
7278,relax_one,0.8500000000000001,0,0,0,0.0,0.0,12,16
7279,relax_one,0.8500000000000001,0,0,0,0.0,0.0,26,26
7280,relax_one,0.8500000000000001,0,0,0,0.0,0.0,22,31
7281,relax_one,0.8500000000000001,0,0,0,0.0,0.0,68,68
7282,relax_one,0.8500000000000001,0,0,0,0.0,0.0,23,22
7283,relax_one,0.8500000000000001,0,0,0,0.0,-0.0348129737608335,43,42
7284,relax_one,0.8500000000000001,0,0,0,0.0,0.0,18,17
7285,relax_one,0.8500000000000001,3,3,0,0.0,0.0,28,42
7286,relax_one,0.8500000000000001,45,45,0,0.1036479088850654,-0.0041754562964496,21,44
7287,relax_one,0.8500000000000001,0,0,0,0.0,0.0,36,37
7288,relax_one,0.8500000000000001,0,0,0,0.0,0.0,15,14
7289,relax_one,0.8500000000000001,1,1,0,0.0,0.0,14,16
7290,relax_one,0.8500000000000001,197,204,-7,3.484436282689749,0.1757315340586914,61,119
7291,relax_one,0.8500000000000001,0,0,0,0.0,0.0,19,20
7292,relax_one,0.8500000000000001,0,0,0,0.0,0.0,22,22
7293,relax_one,0.8500000000000001,0,0,0,0.0,0.0,54,58
7294,relax_one,0.8500000000000001,651,651,0,0.0,0.0,65,135
7295,relax_one,0.8500000000000001,1,1,0,0.0,0.0,16,18
7296,relax_one,0.8500000000000001,7,7,0,0.0,0.0,17,27
7297,relax_one,0.8500000000000001,22,4,18,-19.06910671434205,0.1469333863626725,54,71
7298,relax_one,0.8500000000000001,0,2,-2,-59.99819093035041,-0.0131455917893484,23,22
7299,relax_one,0.8500000000000001,1,0,1,76.88395716132196,-0.1491322016956315,13,16
7300,relax_one,0.8500000000000001,155,146,9,-2.3741667241416664,-0.001397205031107,85,131
7301,relax_one,0.8500000000000001,44,44,0,0.0,0.0,28,55
7302,relax_one,0.8500000000000001,4,4,0,0.0,0.0,18,24
7303,relax_one,0.8500000000000001,0,0,0,0.0,0.0,19,22
7304,relax_one,0.8500000000000001,0,0,0,0.0,0.0,47,46
7305,relax_one,0.8500000000000001,21,19,2,-6.356920988253222,0.0143956759658575,39,64
7306,relax_one,0.8500000000000001,0,0,0,0.0,0.0,17,18
7307,relax_one,0.8500000000000001,1,1,0,0.0,0.0,23,24
7308,relax_one,0.8500000000000001,2,2,0,0.0,0.0,13,16
7309,relax_one,0.8500000000000001,22,22,0,0.0,0.0,40,56
7310,relax_one,0.8500000000000001,1,1,0,0.0,0.0,10,15
7311,relax_one,0.8500000000000001,0,0,0,0.0,0.0,21,20
7312,relax_one,0.8500000000000001,4,4,0,0.0,0.0,30,35
7313,relax_one,0.8500000000000001,1,1,0,0.0,0.0,71,77
7314,just_relax,0.8500000000000001,0,0,0,0.0,-0.0091692815110081,17,18
7315,just_relax,0.8500000000000001,1,1,0,0.0009607869158827,0.0014628518031132,43,48
7316,just_relax,0.8500000000000001,3,3,0,-0.0019521681741139,-7.679999619569777e-05,38,45
7317,just_relax,0.8500000000000001,0,0,0,0.0,-0.0037600566419999,12,12
7318,just_relax,0.8500000000000001,20,14,6,1.9891400956483096,0.1544148745043621,23,38
7319,just_relax,0.8500000000000001,0,1,-1,-78.11694026732484,-0.0295512202700576,19,22
7320,just_relax,0.8500000000000001,976,1188,-212,1.3106081233515638,0.0257948127350838,35,143
7321,just_relax,0.8500000000000001,0,4,-4,-39.1818408082167,-0.0156618414823971,92,91
7322,just_relax,0.8500000000000001,2,2,0,-0.00041775540015,-0.0002552385505018,43,51
7323,just_relax,0.8500000000000001,1,1,0,-0.0016870080925173,6.40249009676297e-05,35,36
7324,just_relax,0.8500000000000001,1,1,0,-0.000156439410091,0.0002508982184644,11,13
7325,just_relax,0.8500000000000001,22,24,-2,-3.49415891827384,0.1000113687896936,10,25
7326,just_relax,0.8500000000000001,16,13,3,0.2088785180214571,-2.2771107622610032e-05,86,136
7327,just_relax,0.8500000000000001,0,0,0,0.0,-1.765503840900351e-06,10,12
7328,just_relax,0.8500000000000001,0,0,0,0.0,-1.014518260578079e-05,32,31
7329,just_relax,0.8500000000000001,2,2,0,4.970962038347736,-0.0904350603192869,20,26
7330,just_relax,0.8500000000000001,0,0,0,0.0,0.000269092021105,11,11
7331,just_relax,0.8500000000000001,2,2,0,0.0009292844165713,-0.0008610890242942,34,42
7332,just_relax,0.8500000000000001,11,11,0,-0.0003616788843885,0.0005035529702898,14,25
7333,just_relax,0.8500000000000001,8,7,1,13.99583228956454,0.1582030612456263,31,46
7334,just_relax,0.8500000000000001,0,0,0,0.0,0.0042083907430441,42,45
7335,just_relax,0.8500000000000001,1265,1285,-20,2.6849459664833404,-0.1292871249874528,39,173
7336,just_relax,0.8500000000000001,11,11,0,0.0001627700527109,0.0015600944076981,14,24
7337,just_relax,0.8500000000000001,0,0,0,0.0,-0.000608053012485,24,25
7338,just_relax,0.8500000000000001,2,2,0,-2.981324638540173e-05,0.0001440646714581,12,19
7339,just_relax,0.8500000000000001,59,59,0,0.4609819410147793,0.0044552421238692,41,72
7340,just_relax,0.8500000000000001,182,178,4,0.0313317398119608,0.0970080713564147,59,115
7341,just_relax,0.8500000000000001,6,6,0,-0.0020404096920856,0.0011964290694836,32,37
7342,just_relax,0.8500000000000001,1,0,1,64.5674534074053,-0.0013228453280204,20,20
7343,just_relax,0.8500000000000001,41,33,8,8.182357833947279,-0.009895766072516,12,31
7344,just_relax,0.8500000000000001,0,0,0,0.0,-1.5942199658169898e-06,10,10
7345,just_relax,0.8500000000000001,0,0,0,0.0,0.0018153466622625,20,21
7346,just_relax,0.8500000000000001,18,18,0,0.0003589278580733,-0.0005865039043362,39,52
7347,just_relax,0.8500000000000001,378,369,9,2.979528253482861,0.0835817869771829,42,109
7348,just_relax,0.8500000000000001,1,1,0,-0.0010366044558338,-5.546321229055184e-05,25,28
7349,just_relax,0.8500000000000001,170,170,0,-0.0002769762706833,-0.0005002245004087,56,106
7350,just_relax,0.8500000000000001,567,521,46,-0.2657392120378574,0.1239070997048957,87,189
7351,just_relax,0.8500000000000001,41,43,-2,2.499128887843675,-0.033528056765164,56,82
7352,just_relax,0.8500000000000001,2,2,0,0.0004861774901456,1.2071037781558047e-06,13,15
7353,just_relax,0.8500000000000001,104,86,18,5.26724471872344,-0.2840091449765524,36,63
7354,just_relax,0.8500000000000001,0,0,0,0.0,4.3915154694929015e-06,16,15
7355,just_relax,0.8500000000000001,0,0,0,0.0,-5.223096419815221e-07,67,66
7356,just_relax,0.8500000000000001,13,13,0,0.0024384647237383,0.004260897920215,42,60
7357,just_relax,0.8500000000000001,0,0,0,0.0,0.0005903979895692,39,38
7358,just_relax,0.8500000000000001,8,8,0,-3.330899971842882e-05,0.0005334774465118,20,36
7359,just_relax,0.8500000000000001,0,0,0,0.0,-0.0010596071395927,10,9
7360,just_relax,0.8500000000000001,1,1,0,0.0009644178095271,-1.805181839154013e-05,13,15
7361,just_relax,0.8500000000000001,6,7,-1,12.522285729298716,0.0299062089849014,34,41
7362,just_relax,0.8500000000000001,3,3,0,-0.0014185667246167,0.0006213779664755,37,42
7363,just_relax,0.8500000000000001,36,36,0,7.196136941445275e-06,5.025038399830706e-06,18,29
7364,just_relax,0.8500000000000001,0,0,0,0.0,-0.0031405837993232,23,22
7365,just_relax,0.8500000000000001,0,0,0,0.0,1.0504657718901632e-05,13,12
7366,just_relax,0.8500000000000001,0,0,0,0.0,-0.0007613272869088,15,14
7367,just_relax,0.8500000000000001,0,0,0,0.0,-0.0017207203528439,69,68
7368,just_relax,0.8500000000000001,0,0,0,0.0,0.001934163275203,40,39
7369,just_relax,0.8500000000000001,0,0,0,0.0,0.0016954512903432,89,93
7370,just_relax,0.8500000000000001,13,13,0,1.511050374969713,-0.0878570612978808,20,32
7371,just_relax,0.8500000000000001,2,3,-1,-4.120223819609976,0.0096644512108772,69,83
7372,just_relax,0.8500000000000001,2,2,0,0.0006766545457281,-0.0007958153584334,12,15
7373,just_relax,0.8500000000000001,0,0,0,0.0,-0.0009758471183408,15,14
7374,just_relax,0.8500000000000001,0,0,0,0.0,-0.0007570529942456,23,26
7375,just_relax,0.8500000000000001,2,2,0,-0.0004670837519427,-0.000552899751354,12,20
7376,just_relax,0.8500000000000001,201,201,0,-5.927609844036397e-05,0.0001073571901385,64,122
7377,just_relax,0.8500000000000001,7,7,0,-0.0099055150386959,0.0003544031231826,58,71
7378,just_relax,0.8500000000000001,0,0,0,0.0,-0.0013086772972689,20,19
7379,just_relax,0.8500000000000001,510,505,5,-0.1096058695008466,0.0001562332230281,100,191
7380,just_relax,0.8500000000000001,34,34,0,0.0046498502251353,3.462795885833536e-05,41,61
7381,just_relax,0.8500000000000001,33,21,12,-0.322372772893118,0.0487025778316814,13,31
7382,just_relax,0.8500000000000001,5,5,0,0.0003476406123752,0.0002826333043987,10,15
7383,just_relax,0.8500000000000001,6,6,0,-0.0004254358946269,0.0003115870201488,37,47
7384,just_relax,0.8500000000000001,0,0,0,0.0,0.0007350584472026,21,21
7385,just_relax,0.8500000000000001,0,0,0,0.0,9.621758975453254e-06,11,10
7386,just_relax,0.8500000000000001,57,55,2,-1.1796960984034186,9.734149291917849e-05,44,80
7387,just_relax,0.8500000000000001,6,6,0,0.0001929725905256,-1.6711583069151104e-05,12,21
7388,just_relax,0.8500000000000001,2,5,-3,10.477360070400792,-0.0167672873232497,37,43
7389,just_relax,0.8500000000000001,6,6,0,-9.27967616917158e-05,0.0005867078171852,41,52
7390,just_relax,0.8500000000000001,0,0,0,0.0,0.0258238191424075,90,89
7391,just_relax,0.8500000000000001,0,0,0,0.0,-0.0001762041220683,22,21
7392,just_relax,0.8500000000000001,1,5,-4,-25.99394547658536,0.034397478016983,37,43
7393,just_relax,0.8500000000000001,0,0,0,0.0,0.009279908390236,47,47
7394,just_relax,0.8500000000000001,4,4,0,-0.0003372893218767,-9.212772776878708e-07,12,20
7395,just_relax,0.8500000000000001,114,95,19,0.8287298242191525,-0.006531385777559,84,124
7396,just_relax,0.8500000000000001,0,0,0,0.0,0.0016708237920683,88,92
7397,just_relax,0.8500000000000001,380,332,48,-1.681066658089314,0.0270328691740772,59,122
7398,just_relax,0.8500000000000001,4,4,0,2.0677824380754828e-05,-0.000363330475558,26,31
7399,just_relax,0.8500000000000001,0,0,0,0.0,4.418930553695688e-06,28,27
7400,just_relax,0.8500000000000001,6,6,0,0.0013890930604816,7.243956427815945e-06,18,26
7401,just_relax,0.8500000000000001,1,1,0,-0.0014241348598034,0.001861633846505,23,26
7402,just_relax,0.8500000000000001,0,0,0,0.0,0.0001814651838247,43,43
7403,just_relax,0.8500000000000001,2,2,0,0.0004949068667485,0.0012137972461528,22,26
7404,just_relax,0.8500000000000001,0,0,0,0.0,8.316094011640018e-06,15,14
7405,just_relax,0.8500000000000001,10,17,-7,3.5874123628873704,0.0856058777554238,36,48
7406,just_relax,0.8500000000000001,6,6,0,2.8016025522275783,-0.3535412006642752,30,37
7407,just_relax,0.8500000000000001,1,1,0,5.455328151526828e-05,-4.433967369288361e-05,10,13
7408,just_relax,0.8500000000000001,0,0,0,0.0,-0.0049855760382295,12,11
7409,just_relax,0.8500000000000001,168,182,-14,1.1771250480206064,-0.0267800915114647,55,105
7410,just_relax,0.8500000000000001,1,1,0,17.12164821735773,0.0578261695456346,13,17
7411,just_relax,0.8500000000000001,0,0,0,0.0,0.0003329515887838,30,29
7412,just_relax,0.8500000000000001,3,3,0,0.000583815366788,0.0008768881680062,36,43
7413,just_relax,0.8500000000000001,36,36,0,0.0010314806767866,-5.393936385500453e-05,40,60
7414,just_relax,0.8500000000000001,0,0,0,0.0,0.0017894746066188,13,17
7415,just_relax,0.8500000000000001,6,7,-1,-5.27235869178908,0.0082826452568239,23,30
7416,just_relax,0.8500000000000001,0,0,0,0.0,-2.940409977925107e-05,12,16
7417,just_relax,0.8500000000000001,0,0,0,0.0,3.901708024223183e-06,26,26
7418,just_relax,0.8500000000000001,0,0,0,0.0,-0.0031688166024113,22,31
7419,just_relax,0.8500000000000001,0,0,0,0.0,0.0008768193667615,68,68
7420,just_relax,0.8500000000000001,0,0,0,0.0,-7.938175057398134e-06,23,22
7421,just_relax,0.8500000000000001,0,0,0,0.0,-0.065399188004364,43,42
7422,just_relax,0.8500000000000001,0,0,0,0.0,-0.002899723134464,18,17
7423,just_relax,0.8500000000000001,3,3,0,-0.003194586812441,0.0012605153222713,28,42
7424,just_relax,0.8500000000000001,45,58,-13,0.9231299892006462,0.088218433779717,21,44
7425,just_relax,0.8500000000000001,0,0,0,0.0,-0.0112811671875761,36,37
7426,just_relax,0.8500000000000001,0,0,0,0.0,-3.4878924121017896e-05,15,14
7427,just_relax,0.8500000000000001,1,1,0,-0.0014549239964907,-0.00058525619921,14,16
7428,just_relax,0.8500000000000001,197,237,-40,1.3477492998050025,0.0885093784332623,61,119
7429,just_relax,0.8500000000000001,0,0,0,0.0,-0.0038599581671643,19,20
7430,just_relax,0.8500000000000001,0,0,0,0.0,-0.0006472841631984,22,22
7431,just_relax,0.8500000000000001,0,0,0,0.0,-0.0011415137972972,54,58
7432,just_relax,0.8500000000000001,651,651,0,-0.0003954210755097,0.0002252638081207,65,135
7433,just_relax,0.8500000000000001,1,1,0,-0.0029471577812358,0.0001749400264638,16,18
7434,just_relax,0.8500000000000001,7,7,0,0.0002013814076775,0.0006636994664107,17,27
7435,just_relax,0.8500000000000001,22,7,15,-12.985895473169307,0.1330374466905183,54,71
7436,just_relax,0.8500000000000001,0,2,-2,-59.99819093035041,-0.0131455917893484,23,22
7437,just_relax,0.8500000000000001,1,0,1,76.88395716132196,-0.1491322016956315,13,16
7438,just_relax,0.8500000000000001,155,185,-30,2.3843149677438973,-0.02495720013905,85,131
7439,just_relax,0.8500000000000001,44,44,0,0.0003032918935019,0.0025857794052007,28,55
7440,just_relax,0.8500000000000001,4,4,0,-0.0007096785766407,-5.4537984728875166e-05,18,24
7441,just_relax,0.8500000000000001,0,0,0,0.0,-0.003226028074061,19,22
7442,just_relax,0.8500000000000001,0,0,0,0.0,0.0048197166778652,47,46
7443,just_relax,0.8500000000000001,21,27,-6,0.0602947270368474,-0.3310372682946312,39,64
7444,just_relax,0.8500000000000001,0,0,0,0.0,-0.0037052423868473,17,18
7445,just_relax,0.8500000000000001,1,1,0,0.0005119856857191,0.0004745196477359,23,24
7446,just_relax,0.8500000000000001,2,2,0,0.0010275548569325,-0.004970471779609,13,16
7447,just_relax,0.8500000000000001,22,22,0,0.0038770082111057,0.0004285387996507,40,56
7448,just_relax,0.8500000000000001,1,1,0,-0.0002865966515059,-0.0003325971221349,10,15
7449,just_relax,0.8500000000000001,0,0,0,0.0,0.0003384089422906,21,20
7450,just_relax,0.8500000000000001,4,4,0,-0.0001029723687508,-0.0013906355929786,30,35
7451,just_relax,0.8500000000000001,1,1,0,0.0051043410712594,-0.0056156512673798,71,77
7452,relax_and_recompute,0.9,0,0,0,0.0,0.0,17,18
7453,relax_and_recompute,0.9,1,1,0,0.0,0.0,43,48
7454,relax_and_recompute,0.9,3,3,0,0.0,0.0,38,45
7455,relax_and_recompute,0.9,0,0,0,0.0,0.0,12,12
7456,relax_and_recompute,0.9,20,18,2,-3.2752299140735204,0.0114158034923678,23,38
7457,relax_and_recompute,0.9,0,0,0,0.0,0.0,19,22
7458,relax_and_recompute,0.9,976,976,0,0.0,0.0,35,143
7459,relax_and_recompute,0.9,0,0,0,0.0,0.0,92,91
7460,relax_and_recompute,0.9,2,2,0,0.0,0.0,43,51
7461,relax_and_recompute,0.9,1,1,0,0.0,0.0,35,36
7462,relax_and_recompute,0.9,1,1,0,0.0,0.0,11,13
7463,relax_and_recompute,0.9,22,22,0,0.0,0.0,10,25
7464,relax_and_recompute,0.9,16,16,0,0.0,0.0,86,136
7465,relax_and_recompute,0.9,0,0,0,0.0,0.0,10,12
7466,relax_and_recompute,0.9,0,0,0,0.0,0.0,32,31
7467,relax_and_recompute,0.9,2,2,0,0.0,0.0,20,26
7468,relax_and_recompute,0.9,0,0,0,0.0,0.0,11,11
7469,relax_and_recompute,0.9,2,2,0,0.0,0.0,34,42
7470,relax_and_recompute,0.9,11,11,0,0.0,0.0,14,25
7471,relax_and_recompute,0.9,8,8,0,0.0,0.0,31,46
7472,relax_and_recompute,0.9,0,0,0,0.0,0.0,42,45
7473,relax_and_recompute,0.9,1265,1265,0,0.0,0.0,39,173
7474,relax_and_recompute,0.9,11,11,0,0.0,0.0,14,24
7475,relax_and_recompute,0.9,0,0,0,0.0,0.0,24,25
7476,relax_and_recompute,0.9,2,2,0,0.0,0.0,12,19
7477,relax_and_recompute,0.9,59,59,0,0.0,0.0,41,72
7478,relax_and_recompute,0.9,182,182,0,0.0,0.0,59,115
7479,relax_and_recompute,0.9,6,6,0,0.0,0.0,32,37
7480,relax_and_recompute,0.9,1,1,0,0.0,0.0,20,20
7481,relax_and_recompute,0.9,41,41,0,0.0,0.0,12,31
7482,relax_and_recompute,0.9,0,0,0,0.0,0.0,10,10
7483,relax_and_recompute,0.9,0,0,0,0.0,0.0,20,21
7484,relax_and_recompute,0.9,18,18,0,0.0,0.0,39,52
7485,relax_and_recompute,0.9,378,378,0,0.0,0.0,42,109
7486,relax_and_recompute,0.9,1,1,0,0.0,0.0,25,28
7487,relax_and_recompute,0.9,170,170,0,0.0,0.0,56,106
7488,relax_and_recompute,0.9,567,595,-28,0.7834114754025379,-0.002967395777259,87,189
7489,relax_and_recompute,0.9,41,41,0,0.0,0.0,56,82
7490,relax_and_recompute,0.9,2,2,0,0.0,0.0,13,15
7491,relax_and_recompute,0.9,104,104,0,0.0,0.0,36,63
7492,relax_and_recompute,0.9,0,0,0,0.0,0.0,16,15
7493,relax_and_recompute,0.9,0,0,0,0.0,0.0,67,66
7494,relax_and_recompute,0.9,13,13,0,0.0,0.0,42,60
7495,relax_and_recompute,0.9,0,0,0,0.0,0.0,39,38
7496,relax_and_recompute,0.9,8,8,0,0.0,0.0,20,36
7497,relax_and_recompute,0.9,0,0,0,0.0,0.0,10,9
7498,relax_and_recompute,0.9,1,1,0,0.0,0.0,13,15
7499,relax_and_recompute,0.9,6,6,0,0.0,0.0,34,41
7500,relax_and_recompute,0.9,3,3,0,0.0,0.0,37,42
7501,relax_and_recompute,0.9,36,36,0,0.0,0.0,18,29
7502,relax_and_recompute,0.9,0,0,0,0.0,0.0,23,22
7503,relax_and_recompute,0.9,0,0,0,0.0,0.0,13,12
7504,relax_and_recompute,0.9,0,0,0,0.0,0.0,15,14
7505,relax_and_recompute,0.9,0,0,0,0.0,0.0,69,68
7506,relax_and_recompute,0.9,0,0,0,0.0,0.0,40,39
7507,relax_and_recompute,0.9,0,0,0,0.0,0.0,89,93
7508,relax_and_recompute,0.9,13,13,0,0.0,0.0,20,32
7509,relax_and_recompute,0.9,2,2,0,0.0,0.0,69,83
7510,relax_and_recompute,0.9,2,2,0,0.0,0.0,12,15
7511,relax_and_recompute,0.9,0,0,0,0.0,0.0,15,14
7512,relax_and_recompute,0.9,0,0,0,0.0,0.0,23,26
7513,relax_and_recompute,0.9,2,2,0,0.0,0.0,12,20
7514,relax_and_recompute,0.9,201,201,0,0.0,0.0,64,122
7515,relax_and_recompute,0.9,7,7,0,0.0,0.0,58,71
7516,relax_and_recompute,0.9,0,0,0,0.0,0.0,20,19
7517,relax_and_recompute,0.9,510,510,0,0.0,0.0,100,191
7518,relax_and_recompute,0.9,34,34,0,0.0,0.0,41,61
7519,relax_and_recompute,0.9,33,34,-1,-0.6264707699284884,0.0331924782664471,13,31
7520,relax_and_recompute,0.9,5,5,0,0.0,0.0,10,15
7521,relax_and_recompute,0.9,6,6,0,0.0,0.0,37,47
7522,relax_and_recompute,0.9,0,0,0,0.0,0.0,21,21
7523,relax_and_recompute,0.9,0,0,0,0.0,0.0,11,10
7524,relax_and_recompute,0.9,57,57,0,0.0,0.0,44,80
7525,relax_and_recompute,0.9,6,6,0,0.0,0.0,12,21
7526,relax_and_recompute,0.9,2,2,0,0.0,0.0,37,43
7527,relax_and_recompute,0.9,6,6,0,0.0,0.0,41,52
7528,relax_and_recompute,0.9,0,0,0,0.0,0.0,90,89
7529,relax_and_recompute,0.9,0,0,0,0.0,0.0,22,21
7530,relax_and_recompute,0.9,1,1,0,0.0,0.0,37,43
7531,relax_and_recompute,0.9,0,0,0,0.0,0.0,47,47
7532,relax_and_recompute,0.9,4,4,0,0.0,0.0,12,20
7533,relax_and_recompute,0.9,114,114,0,0.0,0.0,84,124
7534,relax_and_recompute,0.9,0,0,0,0.0,0.0,88,92
7535,relax_and_recompute,0.9,380,380,0,0.0,0.0,59,122
7536,relax_and_recompute,0.9,4,4,0,0.0,0.0,26,31
7537,relax_and_recompute,0.9,0,0,0,0.0,0.0,28,27
7538,relax_and_recompute,0.9,6,6,0,0.0,0.0,18,26
7539,relax_and_recompute,0.9,1,1,0,0.0,0.0,23,26
7540,relax_and_recompute,0.9,0,0,0,0.0,0.0,43,43
7541,relax_and_recompute,0.9,2,2,0,0.0,0.0,22,26
7542,relax_and_recompute,0.9,0,0,0,0.0,0.0,15,14
7543,relax_and_recompute,0.9,10,10,0,0.0,0.0,36,48
7544,relax_and_recompute,0.9,6,6,0,0.0,0.0,30,37
7545,relax_and_recompute,0.9,1,1,0,0.0,0.0,10,13
7546,relax_and_recompute,0.9,0,0,0,0.0,0.0,12,11
7547,relax_and_recompute,0.9,168,153,15,-1.4597591062543387,0.1638614131178267,55,105
7548,relax_and_recompute,0.9,1,1,0,0.0,0.0,13,17
7549,relax_and_recompute,0.9,0,0,0,0.0,0.0,30,29
7550,relax_and_recompute,0.9,3,3,0,0.0,0.0,36,43
7551,relax_and_recompute,0.9,36,36,0,0.0,0.0,40,60
7552,relax_and_recompute,0.9,0,0,0,0.0,0.0,13,17
7553,relax_and_recompute,0.9,6,6,0,0.0,0.0,23,30
7554,relax_and_recompute,0.9,0,0,0,0.0,0.0,12,16
7555,relax_and_recompute,0.9,0,0,0,0.0,0.0,26,26
7556,relax_and_recompute,0.9,0,0,0,0.0,0.0,22,31
7557,relax_and_recompute,0.9,0,0,0,0.0,0.0,68,68
7558,relax_and_recompute,0.9,0,0,0,0.0,0.0,23,22
7559,relax_and_recompute,0.9,0,0,0,0.0,0.0,43,42
7560,relax_and_recompute,0.9,0,0,0,0.0,0.0,18,17
7561,relax_and_recompute,0.9,3,3,0,0.0,0.0,28,42
7562,relax_and_recompute,0.9,45,45,0,0.0,0.0,21,44
7563,relax_and_recompute,0.9,0,0,0,0.0,0.0,36,37
7564,relax_and_recompute,0.9,0,0,0,0.0,0.0,15,14
7565,relax_and_recompute,0.9,1,1,0,0.0,0.0,14,16
7566,relax_and_recompute,0.9,197,197,0,0.0,0.0,61,119
7567,relax_and_recompute,0.9,0,0,0,0.0,0.0,19,20
7568,relax_and_recompute,0.9,0,0,0,0.0,0.0,22,22
7569,relax_and_recompute,0.9,0,0,0,0.0,0.0,54,58
7570,relax_and_recompute,0.9,651,651,0,0.0,0.0,65,135
7571,relax_and_recompute,0.9,1,1,0,0.0,0.0,16,18
7572,relax_and_recompute,0.9,7,7,0,0.0,0.0,17,27
7573,relax_and_recompute,0.9,22,22,0,0.0,0.0,54,71
7574,relax_and_recompute,0.9,0,0,0,0.0,0.0,23,22
7575,relax_and_recompute,0.9,1,1,0,0.0,0.0,13,16
7576,relax_and_recompute,0.9,155,155,0,0.0,0.0,85,131
7577,relax_and_recompute,0.9,44,44,0,0.0,0.0,28,55
7578,relax_and_recompute,0.9,4,4,0,0.0,0.0,18,24
7579,relax_and_recompute,0.9,0,0,0,0.0,0.0,19,22
7580,relax_and_recompute,0.9,0,0,0,0.0,0.0,47,46
7581,relax_and_recompute,0.9,21,21,0,0.0,0.0,39,64
7582,relax_and_recompute,0.9,0,0,0,0.0,0.0,17,18
7583,relax_and_recompute,0.9,1,1,0,0.0,0.0,23,24
7584,relax_and_recompute,0.9,2,2,0,0.0,0.0,13,16
7585,relax_and_recompute,0.9,22,22,0,0.0,0.0,40,56
7586,relax_and_recompute,0.9,1,1,0,0.0,0.0,10,15
7587,relax_and_recompute,0.9,0,0,0,0.0,0.0,21,20
7588,relax_and_recompute,0.9,4,4,0,0.0,0.0,30,35
7589,relax_and_recompute,0.9,1,1,0,0.0,0.0,71,77
7590,relax_one,0.9,0,0,0,0.0,0.0,17,18
7591,relax_one,0.9,1,1,0,0.0,0.0,43,48
7592,relax_one,0.9,3,3,0,0.0,0.0,38,45
7593,relax_one,0.9,0,0,0,0.0,0.0,12,12
7594,relax_one,0.9,20,18,2,-3.2752299140735204,0.0114158034923678,23,38
7595,relax_one,0.9,0,1,-1,-78.11694026732484,-0.0295512202700576,19,22
7596,relax_one,0.9,976,978,-2,0.1423455471242221,-0.0025418055405018,35,143
7597,relax_one,0.9,0,1,-1,-50.19567681247512,-0.0041327022016595,92,91
7598,relax_one,0.9,2,2,0,0.0,0.0,43,51
7599,relax_one,0.9,1,1,0,0.0,0.0,35,36
7600,relax_one,0.9,1,1,0,0.0,0.0,11,13
7601,relax_one,0.9,22,20,2,-3.01441643358082,0.0082886474985522,10,25
7602,relax_one,0.9,16,16,0,0.0,0.0,86,136
7603,relax_one,0.9,0,0,0,0.0,0.0,10,12
7604,relax_one,0.9,0,0,0,0.0,0.0,32,31
7605,relax_one,0.9,2,2,0,4.970962038347736,-0.0904350603192869,20,26
7606,relax_one,0.9,0,0,0,0.0,0.0,11,11
7607,relax_one,0.9,2,2,0,0.0,0.0,34,42
7608,relax_one,0.9,11,11,0,0.0,0.0,14,25
7609,relax_one,0.9,8,7,1,13.99583228956454,0.1582030612456263,31,46
7610,relax_one,0.9,0,0,0,0.0,0.0,42,45
7611,relax_one,0.9,1265,1240,25,0.1009906236120983,0.0001682713719424,39,173
7612,relax_one,0.9,11,11,0,0.0,0.0,14,24
7613,relax_one,0.9,0,0,0,0.0,0.0,24,25
7614,relax_one,0.9,2,2,0,0.0,0.0,12,19
7615,relax_one,0.9,59,59,0,0.4609819410147793,0.0044552421238692,41,72
7616,relax_one,0.9,182,191,-9,1.446975953367918,0.0358261975695221,59,115
7617,relax_one,0.9,6,6,0,0.0,0.0,32,37
7618,relax_one,0.9,1,1,0,0.0,0.0,20,20
7619,relax_one,0.9,41,32,9,2.305146048931391,0.0775874222420341,12,31
7620,relax_one,0.9,0,0,0,0.0,0.0,10,10
7621,relax_one,0.9,0,0,0,0.0,0.0,20,21
7622,relax_one,0.9,18,18,0,0.0,0.0,39,52
7623,relax_one,0.9,378,395,-17,-0.4859193577000411,-0.0010324457545943,42,109
7624,relax_one,0.9,1,1,0,0.0,0.0,25,28
7625,relax_one,0.9,170,170,0,0.0,0.0,56,106
7626,relax_one,0.9,567,595,-28,0.7834114754025379,-0.002967395777259,87,189
7627,relax_one,0.9,41,41,0,-3.1762323320181167,-0.0099859384844429,56,82
7628,relax_one,0.9,2,2,0,0.0,0.0,13,15
7629,relax_one,0.9,104,88,16,-3.3995451437074067,-0.111275141568526,36,63
7630,relax_one,0.9,0,0,0,0.0,0.0,16,15
7631,relax_one,0.9,0,0,0,0.0,0.0,67,66
7632,relax_one,0.9,13,13,0,0.0,0.0,42,60
7633,relax_one,0.9,0,0,0,0.0,0.0,39,38
7634,relax_one,0.9,8,8,0,0.0,0.0,20,36
7635,relax_one,0.9,0,0,0,0.0,0.0,10,9
7636,relax_one,0.9,1,1,0,0.0,0.0,13,15
7637,relax_one,0.9,6,7,-1,12.522285729298716,0.0299062089849014,34,41
7638,relax_one,0.9,3,3,0,0.0,0.0,37,42
7639,relax_one,0.9,36,36,0,0.0,0.0,18,29
7640,relax_one,0.9,0,0,0,0.0,0.0,23,22
7641,relax_one,0.9,0,0,0,0.0,0.0,13,12
7642,relax_one,0.9,0,0,0,0.0,0.0,15,14
7643,relax_one,0.9,0,0,0,0.0,0.0,69,68
7644,relax_one,0.9,0,0,0,0.0,0.0,40,39
7645,relax_one,0.9,0,0,0,0.0,0.0,89,93
7646,relax_one,0.9,13,13,0,-2.975681235416161,-0.0847204542309565,20,32
7647,relax_one,0.9,2,2,0,0.0,0.0,69,83
7648,relax_one,0.9,2,2,0,0.0,0.0,12,15
7649,relax_one,0.9,0,0,0,0.0,0.0,15,14
7650,relax_one,0.9,0,0,0,0.0,0.0,23,26
7651,relax_one,0.9,2,2,0,0.0,0.0,12,20
7652,relax_one,0.9,201,201,0,0.0,0.0,64,122
7653,relax_one,0.9,7,7,0,0.0,0.0,58,71
7654,relax_one,0.9,0,0,0,0.0,0.0,20,19
7655,relax_one,0.9,510,510,0,0.0060639005596385,-0.0006916839131552,100,191
7656,relax_one,0.9,34,34,0,0.0,0.0,41,61
7657,relax_one,0.9,33,34,-1,-0.6264707699284884,0.0331924782664471,13,31
7658,relax_one,0.9,5,5,0,0.0,0.0,10,15
7659,relax_one,0.9,6,6,0,0.0,0.0,37,47
7660,relax_one,0.9,0,0,0,0.0,0.0,21,21
7661,relax_one,0.9,0,0,0,0.0,0.0,11,10
7662,relax_one,0.9,57,55,2,-1.1796960984034186,9.734149291917849e-05,44,80
7663,relax_one,0.9,6,6,0,0.0,0.0,12,21
7664,relax_one,0.9,2,2,0,42.15913628345388,-0.0181760816329957,37,43
7665,relax_one,0.9,6,6,0,0.0,0.0,41,52
7666,relax_one,0.9,0,0,0,0.0,0.0,90,89
7667,relax_one,0.9,0,0,0,0.0,0.0,22,21
7668,relax_one,0.9,1,1,0,-4.213527745425694,0.0417394626549948,37,43
7669,relax_one,0.9,0,0,0,0.0,0.0,47,47
7670,relax_one,0.9,4,4,0,0.0,0.0,12,20
7671,relax_one,0.9,114,114,0,0.0,0.0,84,124
7672,relax_one,0.9,0,0,0,0.0,0.0,88,92
7673,relax_one,0.9,380,377,3,-0.3714807714610657,-0.0025427242202904,59,122
7674,relax_one,0.9,4,4,0,0.0,0.0,26,31
7675,relax_one,0.9,0,0,0,0.0,0.0,28,27
7676,relax_one,0.9,6,6,0,0.0,0.0,18,26
7677,relax_one,0.9,1,1,0,0.0,0.0,23,26
7678,relax_one,0.9,0,0,0,0.0,0.0,43,43
7679,relax_one,0.9,2,2,0,0.0,0.0,22,26
7680,relax_one,0.9,0,0,0,0.0,0.0,15,14
7681,relax_one,0.9,10,17,-7,3.5874123628873704,0.0856058777554238,36,48
7682,relax_one,0.9,6,6,0,2.8016025522275783,-0.3535412006642752,30,37
7683,relax_one,0.9,1,1,0,0.0,0.0,10,13
7684,relax_one,0.9,0,0,0,0.0,0.0,12,11
7685,relax_one,0.9,168,167,1,-0.7965879277094672,0.0475430066924907,55,105
7686,relax_one,0.9,1,1,0,17.12164821735773,0.0578261695456346,13,17
7687,relax_one,0.9,0,0,0,0.0,0.0,30,29
7688,relax_one,0.9,3,3,0,0.0,0.0,36,43
7689,relax_one,0.9,36,36,0,0.0,0.0,40,60
7690,relax_one,0.9,0,0,0,0.0,0.0,13,17
7691,relax_one,0.9,6,7,-1,-5.27235869178908,0.0082826452568239,23,30
7692,relax_one,0.9,0,0,0,0.0,0.0,12,16
7693,relax_one,0.9,0,0,0,0.0,0.0,26,26
7694,relax_one,0.9,0,0,0,0.0,0.0,22,31
7695,relax_one,0.9,0,0,0,0.0,0.0,68,68
7696,relax_one,0.9,0,0,0,0.0,0.0,23,22
7697,relax_one,0.9,0,0,0,0.0,-0.0348129737608335,43,42
7698,relax_one,0.9,0,0,0,0.0,0.0,18,17
7699,relax_one,0.9,3,3,0,0.0,0.0,28,42
7700,relax_one,0.9,45,45,0,0.1036479088850654,-0.0041754562964496,21,44
7701,relax_one,0.9,0,0,0,0.0,0.0,36,37
7702,relax_one,0.9,0,0,0,0.0,0.0,15,14
7703,relax_one,0.9,1,1,0,0.0,0.0,14,16
7704,relax_one,0.9,197,204,-7,3.484436282689749,0.1757315340586914,61,119
7705,relax_one,0.9,0,0,0,0.0,0.0,19,20
7706,relax_one,0.9,0,0,0,0.0,0.0,22,22
7707,relax_one,0.9,0,0,0,0.0,0.0,54,58
7708,relax_one,0.9,651,651,0,0.0,0.0,65,135
7709,relax_one,0.9,1,1,0,0.0,0.0,16,18
7710,relax_one,0.9,7,7,0,0.0,0.0,17,27
7711,relax_one,0.9,22,4,18,-19.06910671434205,0.1469333863626725,54,71
7712,relax_one,0.9,0,2,-2,-59.99819093035041,-0.0131455917893484,23,22
7713,relax_one,0.9,1,0,1,76.88395716132196,-0.1491322016956315,13,16
7714,relax_one,0.9,155,146,9,-2.3741667241416664,-0.001397205031107,85,131
7715,relax_one,0.9,44,44,0,0.0,0.0,28,55
7716,relax_one,0.9,4,4,0,0.0,0.0,18,24
7717,relax_one,0.9,0,0,0,0.0,0.0,19,22
7718,relax_one,0.9,0,0,0,0.0,0.0,47,46
7719,relax_one,0.9,21,19,2,-6.356920988253222,0.0143956759658575,39,64
7720,relax_one,0.9,0,0,0,0.0,0.0,17,18
7721,relax_one,0.9,1,1,0,0.0,0.0,23,24
7722,relax_one,0.9,2,2,0,0.0,0.0,13,16
7723,relax_one,0.9,22,22,0,0.0,0.0,40,56
7724,relax_one,0.9,1,1,0,0.0,0.0,10,15
7725,relax_one,0.9,0,0,0,0.0,0.0,21,20
7726,relax_one,0.9,4,4,0,0.0,0.0,30,35
7727,relax_one,0.9,1,1,0,0.0,0.0,71,77
7728,just_relax,0.9,0,0,0,0.0,-0.0091692815110081,17,18
7729,just_relax,0.9,1,1,0,0.0009607869158827,0.0014628518031132,43,48
7730,just_relax,0.9,3,3,0,-0.0019521681741139,-7.679999619569777e-05,38,45
7731,just_relax,0.9,0,0,0,0.0,-0.0037600566419999,12,12
7732,just_relax,0.9,20,14,6,1.9891400956483096,0.1544148745043621,23,38
7733,just_relax,0.9,0,1,-1,-78.11694026732484,-0.0295512202700576,19,22
7734,just_relax,0.9,976,1188,-212,1.3106081233515638,0.0257948127350838,35,143
7735,just_relax,0.9,0,4,-4,-39.1818408082167,-0.0156618414823971,92,91
7736,just_relax,0.9,2,2,0,-0.00041775540015,-0.0002552385505018,43,51
7737,just_relax,0.9,1,1,0,-0.0016870080925173,6.40249009676297e-05,35,36
7738,just_relax,0.9,1,1,0,-0.000156439410091,0.0002508982184644,11,13
7739,just_relax,0.9,22,24,-2,-3.49415891827384,0.1000113687896936,10,25
7740,just_relax,0.9,16,13,3,0.2088785180214571,-2.2771107622610032e-05,86,136
7741,just_relax,0.9,0,0,0,0.0,-1.765503840900351e-06,10,12
7742,just_relax,0.9,0,0,0,0.0,-1.014518260578079e-05,32,31
7743,just_relax,0.9,2,2,0,4.970962038347736,-0.0904350603192869,20,26
7744,just_relax,0.9,0,0,0,0.0,0.000269092021105,11,11
7745,just_relax,0.9,2,2,0,0.0009292844165713,-0.0008610890242942,34,42
7746,just_relax,0.9,11,11,0,-0.0003616788843885,0.0005035529702898,14,25
7747,just_relax,0.9,8,7,1,13.99583228956454,0.1582030612456263,31,46
7748,just_relax,0.9,0,0,0,0.0,0.0042083907430441,42,45
7749,just_relax,0.9,1265,1285,-20,2.6849459664833404,-0.1292871249874528,39,173
7750,just_relax,0.9,11,11,0,0.0001627700527109,0.0015600944076981,14,24
7751,just_relax,0.9,0,0,0,0.0,-0.000608053012485,24,25
7752,just_relax,0.9,2,2,0,-2.981324638540173e-05,0.0001440646714581,12,19
7753,just_relax,0.9,59,59,0,0.4609819410147793,0.0044552421238692,41,72
7754,just_relax,0.9,182,178,4,0.0313317398119608,0.0970080713564147,59,115
7755,just_relax,0.9,6,6,0,-0.0020404096920856,0.0011964290694836,32,37
7756,just_relax,0.9,1,0,1,64.5674534074053,-0.0013228453280204,20,20
7757,just_relax,0.9,41,33,8,8.182357833947279,-0.009895766072516,12,31
7758,just_relax,0.9,0,0,0,0.0,-1.5942199658169898e-06,10,10
7759,just_relax,0.9,0,0,0,0.0,0.0018153466622625,20,21
7760,just_relax,0.9,18,18,0,0.0003589278580733,-0.0005865039043362,39,52
7761,just_relax,0.9,378,369,9,2.979528253482861,0.0835817869771829,42,109
7762,just_relax,0.9,1,1,0,-0.0010366044558338,-5.546321229055184e-05,25,28
7763,just_relax,0.9,170,170,0,-0.0002769762706833,-0.0005002245004087,56,106
7764,just_relax,0.9,567,521,46,-0.2657392120378574,0.1239070997048957,87,189
7765,just_relax,0.9,41,43,-2,2.499128887843675,-0.033528056765164,56,82
7766,just_relax,0.9,2,2,0,0.0004861774901456,1.2071037781558047e-06,13,15
7767,just_relax,0.9,104,86,18,5.26724471872344,-0.2840091449765524,36,63
7768,just_relax,0.9,0,0,0,0.0,4.3915154694929015e-06,16,15
7769,just_relax,0.9,0,0,0,0.0,-5.223096419815221e-07,67,66
7770,just_relax,0.9,13,13,0,0.0024384647237383,0.004260897920215,42,60
7771,just_relax,0.9,0,0,0,0.0,0.0005903979895692,39,38
7772,just_relax,0.9,8,8,0,-3.330899971842882e-05,0.0005334774465118,20,36
7773,just_relax,0.9,0,0,0,0.0,-0.0010596071395927,10,9
7774,just_relax,0.9,1,1,0,0.0009644178095271,-1.805181839154013e-05,13,15
7775,just_relax,0.9,6,7,-1,12.522285729298716,0.0299062089849014,34,41
7776,just_relax,0.9,3,3,0,-0.0014185667246167,0.0006213779664755,37,42
7777,just_relax,0.9,36,36,0,7.196136941445275e-06,5.025038399830706e-06,18,29
7778,just_relax,0.9,0,0,0,0.0,-0.0031405837993232,23,22
7779,just_relax,0.9,0,0,0,0.0,1.0504657718901632e-05,13,12
7780,just_relax,0.9,0,0,0,0.0,-0.0007613272869088,15,14
7781,just_relax,0.9,0,0,0,0.0,-0.0017207203528439,69,68
7782,just_relax,0.9,0,0,0,0.0,0.001934163275203,40,39
7783,just_relax,0.9,0,0,0,0.0,0.0016954512903432,89,93
7784,just_relax,0.9,13,13,0,1.511050374969713,-0.0878570612978808,20,32
7785,just_relax,0.9,2,3,-1,-4.120223819609976,0.0096644512108772,69,83
7786,just_relax,0.9,2,2,0,0.0006766545457281,-0.0007958153584334,12,15
7787,just_relax,0.9,0,0,0,0.0,-0.0009758471183408,15,14
7788,just_relax,0.9,0,0,0,0.0,-0.0007570529942456,23,26
7789,just_relax,0.9,2,2,0,-0.0004670837519427,-0.000552899751354,12,20
7790,just_relax,0.9,201,201,0,-5.927609844036397e-05,0.0001073571901385,64,122
7791,just_relax,0.9,7,7,0,-0.0099055150386959,0.0003544031231826,58,71
7792,just_relax,0.9,0,0,0,0.0,-0.0013086772972689,20,19
7793,just_relax,0.9,510,505,5,-0.1096058695008466,0.0001562332230281,100,191
7794,just_relax,0.9,34,34,0,0.0046498502251353,3.462795885833536e-05,41,61
7795,just_relax,0.9,33,21,12,-0.322372772893118,0.0487025778316814,13,31
7796,just_relax,0.9,5,5,0,0.0003476406123752,0.0002826333043987,10,15
7797,just_relax,0.9,6,6,0,-0.0004254358946269,0.0003115870201488,37,47
7798,just_relax,0.9,0,0,0,0.0,0.0007350584472026,21,21
7799,just_relax,0.9,0,0,0,0.0,9.621758975453254e-06,11,10
7800,just_relax,0.9,57,55,2,-1.1796960984034186,9.734149291917849e-05,44,80
7801,just_relax,0.9,6,6,0,0.0001929725905256,-1.6711583069151104e-05,12,21
7802,just_relax,0.9,2,5,-3,10.477360070400792,-0.0167672873232497,37,43
7803,just_relax,0.9,6,6,0,-9.27967616917158e-05,0.0005867078171852,41,52
7804,just_relax,0.9,0,0,0,0.0,0.0258238191424075,90,89
7805,just_relax,0.9,0,0,0,0.0,-0.0001762041220683,22,21
7806,just_relax,0.9,1,5,-4,-25.99394547658536,0.034397478016983,37,43
7807,just_relax,0.9,0,0,0,0.0,0.009279908390236,47,47
7808,just_relax,0.9,4,4,0,-0.0003372893218767,-9.212772776878708e-07,12,20
7809,just_relax,0.9,114,95,19,0.8287298242191525,-0.006531385777559,84,124
7810,just_relax,0.9,0,0,0,0.0,0.0016708237920683,88,92
7811,just_relax,0.9,380,332,48,-1.681066658089314,0.0270328691740772,59,122
7812,just_relax,0.9,4,4,0,2.0677824380754828e-05,-0.000363330475558,26,31
7813,just_relax,0.9,0,0,0,0.0,4.418930553695688e-06,28,27
7814,just_relax,0.9,6,6,0,0.0013890930604816,7.243956427815945e-06,18,26
7815,just_relax,0.9,1,1,0,-0.0014241348598034,0.001861633846505,23,26
7816,just_relax,0.9,0,0,0,0.0,0.0001814651838247,43,43
7817,just_relax,0.9,2,2,0,0.0004949068667485,0.0012137972461528,22,26
7818,just_relax,0.9,0,0,0,0.0,8.316094011640018e-06,15,14
7819,just_relax,0.9,10,17,-7,3.5874123628873704,0.0856058777554238,36,48
7820,just_relax,0.9,6,6,0,2.8016025522275783,-0.3535412006642752,30,37
7821,just_relax,0.9,1,1,0,5.455328151526828e-05,-4.433967369288361e-05,10,13
7822,just_relax,0.9,0,0,0,0.0,-0.0049855760382295,12,11
7823,just_relax,0.9,168,182,-14,1.1771250480206064,-0.0267800915114647,55,105
7824,just_relax,0.9,1,1,0,17.12164821735773,0.0578261695456346,13,17
7825,just_relax,0.9,0,0,0,0.0,0.0003329515887838,30,29
7826,just_relax,0.9,3,3,0,0.000583815366788,0.0008768881680062,36,43
7827,just_relax,0.9,36,36,0,0.0010314806767866,-5.393936385500453e-05,40,60
7828,just_relax,0.9,0,0,0,0.0,0.0017894746066188,13,17
7829,just_relax,0.9,6,7,-1,-5.27235869178908,0.0082826452568239,23,30
7830,just_relax,0.9,0,0,0,0.0,-2.940409977925107e-05,12,16
7831,just_relax,0.9,0,0,0,0.0,3.901708024223183e-06,26,26
7832,just_relax,0.9,0,0,0,0.0,-0.0031688166024113,22,31
7833,just_relax,0.9,0,0,0,0.0,0.0008768193667615,68,68
7834,just_relax,0.9,0,0,0,0.0,-7.938175057398134e-06,23,22
7835,just_relax,0.9,0,0,0,0.0,-0.065399188004364,43,42
7836,just_relax,0.9,0,0,0,0.0,-0.002899723134464,18,17
7837,just_relax,0.9,3,3,0,-0.003194586812441,0.0012605153222713,28,42
7838,just_relax,0.9,45,58,-13,0.9231299892006462,0.088218433779717,21,44
7839,just_relax,0.9,0,0,0,0.0,-0.0112811671875761,36,37
7840,just_relax,0.9,0,0,0,0.0,-3.4878924121017896e-05,15,14
7841,just_relax,0.9,1,1,0,-0.0014549239964907,-0.00058525619921,14,16
7842,just_relax,0.9,197,237,-40,1.3477492998050025,0.0885093784332623,61,119
7843,just_relax,0.9,0,0,0,0.0,-0.0038599581671643,19,20
7844,just_relax,0.9,0,0,0,0.0,-0.0006472841631984,22,22
7845,just_relax,0.9,0,0,0,0.0,-0.0011415137972972,54,58
7846,just_relax,0.9,651,651,0,-0.0003954210755097,0.0002252638081207,65,135
7847,just_relax,0.9,1,1,0,-0.0029471577812358,0.0001749400264638,16,18
7848,just_relax,0.9,7,7,0,0.0002013814076775,0.0006636994664107,17,27
7849,just_relax,0.9,22,7,15,-12.985895473169307,0.1330374466905183,54,71
7850,just_relax,0.9,0,2,-2,-59.99819093035041,-0.0131455917893484,23,22
7851,just_relax,0.9,1,0,1,76.88395716132196,-0.1491322016956315,13,16
7852,just_relax,0.9,155,185,-30,2.3843149677438973,-0.02495720013905,85,131
7853,just_relax,0.9,44,44,0,0.0003032918935019,0.0025857794052007,28,55
7854,just_relax,0.9,4,4,0,-0.0007096785766407,-5.4537984728875166e-05,18,24
7855,just_relax,0.9,0,0,0,0.0,-0.003226028074061,19,22
7856,just_relax,0.9,0,0,0,0.0,0.0048197166778652,47,46
7857,just_relax,0.9,21,27,-6,0.0602947270368474,-0.3310372682946312,39,64
7858,just_relax,0.9,0,0,0,0.0,-0.0037052423868473,17,18
7859,just_relax,0.9,1,1,0,0.0005119856857191,0.0004745196477359,23,24
7860,just_relax,0.9,2,2,0,0.0010275548569325,-0.004970471779609,13,16
7861,just_relax,0.9,22,22,0,0.0038770082111057,0.0004285387996507,40,56
7862,just_relax,0.9,1,1,0,-0.0002865966515059,-0.0003325971221349,10,15
7863,just_relax,0.9,0,0,0,0.0,0.0003384089422906,21,20
7864,just_relax,0.9,4,4,0,-0.0001029723687508,-0.0013906355929786,30,35
7865,just_relax,0.9,1,1,0,0.0051043410712594,-0.0056156512673798,71,77
7866,relax_and_recompute,0.95,0,0,0,0.0,0.0,17,18
7867,relax_and_recompute,0.95,1,1,0,0.0,0.0,43,48
7868,relax_and_recompute,0.95,3,3,0,0.0,0.0,38,45
7869,relax_and_recompute,0.95,0,0,0,0.0,0.0,12,12
7870,relax_and_recompute,0.95,20,20,0,0.0,0.0,23,38
7871,relax_and_recompute,0.95,0,0,0,0.0,0.0,19,22
7872,relax_and_recompute,0.95,976,976,0,0.0,0.0,35,143
7873,relax_and_recompute,0.95,0,0,0,0.0,0.0,92,91
7874,relax_and_recompute,0.95,2,2,0,0.0,0.0,43,51
7875,relax_and_recompute,0.95,1,1,0,0.0,0.0,35,36
7876,relax_and_recompute,0.95,1,1,0,0.0,0.0,11,13
7877,relax_and_recompute,0.95,22,22,0,0.0,0.0,10,25
7878,relax_and_recompute,0.95,16,16,0,0.0,0.0,86,136
7879,relax_and_recompute,0.95,0,0,0,0.0,0.0,10,12
7880,relax_and_recompute,0.95,0,0,0,0.0,0.0,32,31
7881,relax_and_recompute,0.95,2,2,0,0.0,0.0,20,26
7882,relax_and_recompute,0.95,0,0,0,0.0,0.0,11,11
7883,relax_and_recompute,0.95,2,2,0,0.0,0.0,34,42
7884,relax_and_recompute,0.95,11,11,0,0.0,0.0,14,25
7885,relax_and_recompute,0.95,8,8,0,0.0,0.0,31,46
7886,relax_and_recompute,0.95,0,0,0,0.0,0.0,42,45
7887,relax_and_recompute,0.95,1265,1265,0,0.0,0.0,39,173
7888,relax_and_recompute,0.95,11,11,0,0.0,0.0,14,24
7889,relax_and_recompute,0.95,0,0,0,0.0,0.0,24,25
7890,relax_and_recompute,0.95,2,2,0,0.0,0.0,12,19
7891,relax_and_recompute,0.95,59,59,0,0.0,0.0,41,72
7892,relax_and_recompute,0.95,182,182,0,0.0,0.0,59,115
7893,relax_and_recompute,0.95,6,6,0,0.0,0.0,32,37
7894,relax_and_recompute,0.95,1,1,0,0.0,0.0,20,20
7895,relax_and_recompute,0.95,41,41,0,0.0,0.0,12,31
7896,relax_and_recompute,0.95,0,0,0,0.0,0.0,10,10
7897,relax_and_recompute,0.95,0,0,0,0.0,0.0,20,21
7898,relax_and_recompute,0.95,18,18,0,0.0,0.0,39,52
7899,relax_and_recompute,0.95,378,378,0,0.0,0.0,42,109
7900,relax_and_recompute,0.95,1,1,0,0.0,0.0,25,28
7901,relax_and_recompute,0.95,170,170,0,0.0,0.0,56,106
7902,relax_and_recompute,0.95,567,567,0,0.0,0.0,87,189
7903,relax_and_recompute,0.95,41,41,0,0.0,0.0,56,82
7904,relax_and_recompute,0.95,2,2,0,0.0,0.0,13,15
7905,relax_and_recompute,0.95,104,104,0,0.0,0.0,36,63
7906,relax_and_recompute,0.95,0,0,0,0.0,0.0,16,15
7907,relax_and_recompute,0.95,0,0,0,0.0,0.0,67,66
7908,relax_and_recompute,0.95,13,13,0,0.0,0.0,42,60
7909,relax_and_recompute,0.95,0,0,0,0.0,0.0,39,38
7910,relax_and_recompute,0.95,8,8,0,0.0,0.0,20,36
7911,relax_and_recompute,0.95,0,0,0,0.0,0.0,10,9
7912,relax_and_recompute,0.95,1,1,0,0.0,0.0,13,15
7913,relax_and_recompute,0.95,6,6,0,0.0,0.0,34,41
7914,relax_and_recompute,0.95,3,3,0,0.0,0.0,37,42
7915,relax_and_recompute,0.95,36,36,0,0.0,0.0,18,29
7916,relax_and_recompute,0.95,0,0,0,0.0,0.0,23,22
7917,relax_and_recompute,0.95,0,0,0,0.0,0.0,13,12
7918,relax_and_recompute,0.95,0,0,0,0.0,0.0,15,14
7919,relax_and_recompute,0.95,0,0,0,0.0,0.0,69,68
7920,relax_and_recompute,0.95,0,0,0,0.0,0.0,40,39
7921,relax_and_recompute,0.95,0,0,0,0.0,0.0,89,93
7922,relax_and_recompute,0.95,13,13,0,0.0,0.0,20,32
7923,relax_and_recompute,0.95,2,2,0,0.0,0.0,69,83
7924,relax_and_recompute,0.95,2,2,0,0.0,0.0,12,15
7925,relax_and_recompute,0.95,0,0,0,0.0,0.0,15,14
7926,relax_and_recompute,0.95,0,0,0,0.0,0.0,23,26
7927,relax_and_recompute,0.95,2,2,0,0.0,0.0,12,20
7928,relax_and_recompute,0.95,201,201,0,0.0,0.0,64,122
7929,relax_and_recompute,0.95,7,7,0,0.0,0.0,58,71
7930,relax_and_recompute,0.95,0,0,0,0.0,0.0,20,19
7931,relax_and_recompute,0.95,510,510,0,0.0,0.0,100,191
7932,relax_and_recompute,0.95,34,34,0,0.0,0.0,41,61
7933,relax_and_recompute,0.95,33,33,0,0.0,0.0,13,31
7934,relax_and_recompute,0.95,5,5,0,0.0,0.0,10,15
7935,relax_and_recompute,0.95,6,6,0,0.0,0.0,37,47
7936,relax_and_recompute,0.95,0,0,0,0.0,0.0,21,21
7937,relax_and_recompute,0.95,0,0,0,0.0,0.0,11,10
7938,relax_and_recompute,0.95,57,57,0,0.0,0.0,44,80
7939,relax_and_recompute,0.95,6,6,0,0.0,0.0,12,21
7940,relax_and_recompute,0.95,2,2,0,0.0,0.0,37,43
7941,relax_and_recompute,0.95,6,6,0,0.0,0.0,41,52
7942,relax_and_recompute,0.95,0,0,0,0.0,0.0,90,89
7943,relax_and_recompute,0.95,0,0,0,0.0,0.0,22,21
7944,relax_and_recompute,0.95,1,1,0,0.0,0.0,37,43
7945,relax_and_recompute,0.95,0,0,0,0.0,0.0,47,47
7946,relax_and_recompute,0.95,4,4,0,0.0,0.0,12,20
7947,relax_and_recompute,0.95,114,114,0,0.0,0.0,84,124
7948,relax_and_recompute,0.95,0,0,0,0.0,0.0,88,92
7949,relax_and_recompute,0.95,380,380,0,0.0,0.0,59,122
7950,relax_and_recompute,0.95,4,4,0,0.0,0.0,26,31
7951,relax_and_recompute,0.95,0,0,0,0.0,0.0,28,27
7952,relax_and_recompute,0.95,6,6,0,0.0,0.0,18,26
7953,relax_and_recompute,0.95,1,1,0,0.0,0.0,23,26
7954,relax_and_recompute,0.95,0,0,0,0.0,0.0,43,43
7955,relax_and_recompute,0.95,2,2,0,0.0,0.0,22,26
7956,relax_and_recompute,0.95,0,0,0,0.0,0.0,15,14
7957,relax_and_recompute,0.95,10,10,0,0.0,0.0,36,48
7958,relax_and_recompute,0.95,6,6,0,0.0,0.0,30,37
7959,relax_and_recompute,0.95,1,1,0,0.0,0.0,10,13
7960,relax_and_recompute,0.95,0,0,0,0.0,0.0,12,11
7961,relax_and_recompute,0.95,168,168,0,0.0,0.0,55,105
7962,relax_and_recompute,0.95,1,1,0,0.0,0.0,13,17
7963,relax_and_recompute,0.95,0,0,0,0.0,0.0,30,29
7964,relax_and_recompute,0.95,3,3,0,0.0,0.0,36,43
7965,relax_and_recompute,0.95,36,36,0,0.0,0.0,40,60
7966,relax_and_recompute,0.95,0,0,0,0.0,0.0,13,17
7967,relax_and_recompute,0.95,6,6,0,0.0,0.0,23,30
7968,relax_and_recompute,0.95,0,0,0,0.0,0.0,12,16
7969,relax_and_recompute,0.95,0,0,0,0.0,0.0,26,26
7970,relax_and_recompute,0.95,0,0,0,0.0,0.0,22,31
7971,relax_and_recompute,0.95,0,0,0,0.0,0.0,68,68
7972,relax_and_recompute,0.95,0,0,0,0.0,0.0,23,22
7973,relax_and_recompute,0.95,0,0,0,0.0,0.0,43,42
7974,relax_and_recompute,0.95,0,0,0,0.0,0.0,18,17
7975,relax_and_recompute,0.95,3,3,0,0.0,0.0,28,42
7976,relax_and_recompute,0.95,45,45,0,0.0,0.0,21,44
7977,relax_and_recompute,0.95,0,0,0,0.0,0.0,36,37
7978,relax_and_recompute,0.95,0,0,0,0.0,0.0,15,14
7979,relax_and_recompute,0.95,1,1,0,0.0,0.0,14,16
7980,relax_and_recompute,0.95,197,197,0,0.0,0.0,61,119
7981,relax_and_recompute,0.95,0,0,0,0.0,0.0,19,20
7982,relax_and_recompute,0.95,0,0,0,0.0,0.0,22,22
7983,relax_and_recompute,0.95,0,0,0,0.0,0.0,54,58
7984,relax_and_recompute,0.95,651,651,0,0.0,0.0,65,135
7985,relax_and_recompute,0.95,1,1,0,0.0,0.0,16,18
7986,relax_and_recompute,0.95,7,7,0,0.0,0.0,17,27
7987,relax_and_recompute,0.95,22,22,0,0.0,0.0,54,71
7988,relax_and_recompute,0.95,0,0,0,0.0,0.0,23,22
7989,relax_and_recompute,0.95,1,1,0,0.0,0.0,13,16
7990,relax_and_recompute,0.95,155,155,0,0.0,0.0,85,131
7991,relax_and_recompute,0.95,44,44,0,0.0,0.0,28,55
7992,relax_and_recompute,0.95,4,4,0,0.0,0.0,18,24
7993,relax_and_recompute,0.95,0,0,0,0.0,0.0,19,22
7994,relax_and_recompute,0.95,0,0,0,0.0,0.0,47,46
7995,relax_and_recompute,0.95,21,21,0,0.0,0.0,39,64
7996,relax_and_recompute,0.95,0,0,0,0.0,0.0,17,18
7997,relax_and_recompute,0.95,1,1,0,0.0,0.0,23,24
7998,relax_and_recompute,0.95,2,2,0,0.0,0.0,13,16
7999,relax_and_recompute,0.95,22,22,0,0.0,0.0,40,56
8000,relax_and_recompute,0.95,1,1,0,0.0,0.0,10,15
8001,relax_and_recompute,0.95,0,0,0,0.0,0.0,21,20
8002,relax_and_recompute,0.95,4,4,0,0.0,0.0,30,35
8003,relax_and_recompute,0.95,1,1,0,0.0,0.0,71,77
8004,relax_one,0.95,0,0,0,0.0,0.0,17,18
8005,relax_one,0.95,1,1,0,0.0,0.0,43,48
8006,relax_one,0.95,3,3,0,0.0,0.0,38,45
8007,relax_one,0.95,0,0,0,0.0,0.0,12,12
8008,relax_one,0.95,20,18,2,-3.2752299140735204,0.0114158034923678,23,38
8009,relax_one,0.95,0,1,-1,-78.11694026732484,-0.0295512202700576,19,22
8010,relax_one,0.95,976,978,-2,0.1423455471242221,-0.0025418055405018,35,143
8011,relax_one,0.95,0,1,-1,-50.19567681247512,-0.0041327022016595,92,91
8012,relax_one,0.95,2,2,0,0.0,0.0,43,51
8013,relax_one,0.95,1,1,0,0.0,0.0,35,36
8014,relax_one,0.95,1,1,0,0.0,0.0,11,13
8015,relax_one,0.95,22,20,2,-3.01441643358082,0.0082886474985522,10,25
8016,relax_one,0.95,16,16,0,0.0,0.0,86,136
8017,relax_one,0.95,0,0,0,0.0,0.0,10,12
8018,relax_one,0.95,0,0,0,0.0,0.0,32,31
8019,relax_one,0.95,2,2,0,4.970962038347736,-0.0904350603192869,20,26
8020,relax_one,0.95,0,0,0,0.0,0.0,11,11
8021,relax_one,0.95,2,2,0,0.0,0.0,34,42
8022,relax_one,0.95,11,11,0,0.0,0.0,14,25
8023,relax_one,0.95,8,7,1,13.99583228956454,0.1582030612456263,31,46
8024,relax_one,0.95,0,0,0,0.0,0.0,42,45
8025,relax_one,0.95,1265,1240,25,0.1009906236120983,0.0001682713719424,39,173
8026,relax_one,0.95,11,11,0,0.0,0.0,14,24
8027,relax_one,0.95,0,0,0,0.0,0.0,24,25
8028,relax_one,0.95,2,2,0,0.0,0.0,12,19
8029,relax_one,0.95,59,59,0,0.4609819410147793,0.0044552421238692,41,72
8030,relax_one,0.95,182,191,-9,1.446975953367918,0.0358261975695221,59,115
8031,relax_one,0.95,6,6,0,0.0,0.0,32,37
8032,relax_one,0.95,1,1,0,0.0,0.0,20,20
8033,relax_one,0.95,41,32,9,2.305146048931391,0.0775874222420341,12,31
8034,relax_one,0.95,0,0,0,0.0,0.0,10,10
8035,relax_one,0.95,0,0,0,0.0,0.0,20,21
8036,relax_one,0.95,18,18,0,0.0,0.0,39,52
8037,relax_one,0.95,378,395,-17,-0.4859193577000411,-0.0010324457545943,42,109
8038,relax_one,0.95,1,1,0,0.0,0.0,25,28
8039,relax_one,0.95,170,170,0,0.0,0.0,56,106
8040,relax_one,0.95,567,595,-28,0.7834114754025379,-0.002967395777259,87,189
8041,relax_one,0.95,41,41,0,-3.1762323320181167,-0.0099859384844429,56,82
8042,relax_one,0.95,2,2,0,0.0,0.0,13,15
8043,relax_one,0.95,104,88,16,-3.3995451437074067,-0.111275141568526,36,63
8044,relax_one,0.95,0,0,0,0.0,0.0,16,15
8045,relax_one,0.95,0,0,0,0.0,0.0,67,66
8046,relax_one,0.95,13,13,0,0.0,0.0,42,60
8047,relax_one,0.95,0,0,0,0.0,0.0,39,38
8048,relax_one,0.95,8,8,0,0.0,0.0,20,36
8049,relax_one,0.95,0,0,0,0.0,0.0,10,9
8050,relax_one,0.95,1,1,0,0.0,0.0,13,15
8051,relax_one,0.95,6,7,-1,12.522285729298716,0.0299062089849014,34,41
8052,relax_one,0.95,3,3,0,0.0,0.0,37,42
8053,relax_one,0.95,36,36,0,0.0,0.0,18,29
8054,relax_one,0.95,0,0,0,0.0,0.0,23,22
8055,relax_one,0.95,0,0,0,0.0,0.0,13,12
8056,relax_one,0.95,0,0,0,0.0,0.0,15,14
8057,relax_one,0.95,0,0,0,0.0,0.0,69,68
8058,relax_one,0.95,0,0,0,0.0,0.0,40,39
8059,relax_one,0.95,0,0,0,0.0,0.0,89,93
8060,relax_one,0.95,13,13,0,-2.975681235416161,-0.0847204542309565,20,32
8061,relax_one,0.95,2,2,0,0.0,0.0,69,83
8062,relax_one,0.95,2,2,0,0.0,0.0,12,15
8063,relax_one,0.95,0,0,0,0.0,0.0,15,14
8064,relax_one,0.95,0,0,0,0.0,0.0,23,26
8065,relax_one,0.95,2,2,0,0.0,0.0,12,20
8066,relax_one,0.95,201,201,0,0.0,0.0,64,122
8067,relax_one,0.95,7,7,0,0.0,0.0,58,71
8068,relax_one,0.95,0,0,0,0.0,0.0,20,19
8069,relax_one,0.95,510,510,0,0.0060639005596385,-0.0006916839131552,100,191
8070,relax_one,0.95,34,34,0,0.0,0.0,41,61
8071,relax_one,0.95,33,34,-1,-0.6264707699284884,0.0331924782664471,13,31
8072,relax_one,0.95,5,5,0,0.0,0.0,10,15
8073,relax_one,0.95,6,6,0,0.0,0.0,37,47
8074,relax_one,0.95,0,0,0,0.0,0.0,21,21
8075,relax_one,0.95,0,0,0,0.0,0.0,11,10
8076,relax_one,0.95,57,55,2,-1.1796960984034186,9.734149291917849e-05,44,80
8077,relax_one,0.95,6,6,0,0.0,0.0,12,21
8078,relax_one,0.95,2,2,0,42.15913628345388,-0.0181760816329957,37,43
8079,relax_one,0.95,6,6,0,0.0,0.0,41,52
8080,relax_one,0.95,0,0,0,0.0,0.0,90,89
8081,relax_one,0.95,0,0,0,0.0,0.0,22,21
8082,relax_one,0.95,1,1,0,-4.213527745425694,0.0417394626549948,37,43
8083,relax_one,0.95,0,0,0,0.0,0.0,47,47
8084,relax_one,0.95,4,4,0,0.0,0.0,12,20
8085,relax_one,0.95,114,114,0,0.0,0.0,84,124
8086,relax_one,0.95,0,0,0,0.0,0.0,88,92
8087,relax_one,0.95,380,377,3,-0.3714807714610657,-0.0025427242202904,59,122
8088,relax_one,0.95,4,4,0,0.0,0.0,26,31
8089,relax_one,0.95,0,0,0,0.0,0.0,28,27
8090,relax_one,0.95,6,6,0,0.0,0.0,18,26
8091,relax_one,0.95,1,1,0,0.0,0.0,23,26
8092,relax_one,0.95,0,0,0,0.0,0.0,43,43
8093,relax_one,0.95,2,2,0,0.0,0.0,22,26
8094,relax_one,0.95,0,0,0,0.0,0.0,15,14
8095,relax_one,0.95,10,17,-7,3.5874123628873704,0.0856058777554238,36,48
8096,relax_one,0.95,6,6,0,2.8016025522275783,-0.3535412006642752,30,37
8097,relax_one,0.95,1,1,0,0.0,0.0,10,13
8098,relax_one,0.95,0,0,0,0.0,0.0,12,11
8099,relax_one,0.95,168,167,1,-0.7965879277094672,0.0475430066924907,55,105
8100,relax_one,0.95,1,1,0,17.12164821735773,0.0578261695456346,13,17
8101,relax_one,0.95,0,0,0,0.0,0.0,30,29
8102,relax_one,0.95,3,3,0,0.0,0.0,36,43
8103,relax_one,0.95,36,36,0,0.0,0.0,40,60
8104,relax_one,0.95,0,0,0,0.0,0.0,13,17
8105,relax_one,0.95,6,7,-1,-5.27235869178908,0.0082826452568239,23,30
8106,relax_one,0.95,0,0,0,0.0,0.0,12,16
8107,relax_one,0.95,0,0,0,0.0,0.0,26,26
8108,relax_one,0.95,0,0,0,0.0,0.0,22,31
8109,relax_one,0.95,0,0,0,0.0,0.0,68,68
8110,relax_one,0.95,0,0,0,0.0,0.0,23,22
8111,relax_one,0.95,0,0,0,0.0,-0.0348129737608335,43,42
8112,relax_one,0.95,0,0,0,0.0,0.0,18,17
8113,relax_one,0.95,3,3,0,0.0,0.0,28,42
8114,relax_one,0.95,45,45,0,0.1036479088850654,-0.0041754562964496,21,44
8115,relax_one,0.95,0,0,0,0.0,0.0,36,37
8116,relax_one,0.95,0,0,0,0.0,0.0,15,14
8117,relax_one,0.95,1,1,0,0.0,0.0,14,16
8118,relax_one,0.95,197,204,-7,3.484436282689749,0.1757315340586914,61,119
8119,relax_one,0.95,0,0,0,0.0,0.0,19,20
8120,relax_one,0.95,0,0,0,0.0,0.0,22,22
8121,relax_one,0.95,0,0,0,0.0,0.0,54,58
8122,relax_one,0.95,651,651,0,0.0,0.0,65,135
8123,relax_one,0.95,1,1,0,0.0,0.0,16,18
8124,relax_one,0.95,7,7,0,0.0,0.0,17,27
8125,relax_one,0.95,22,4,18,-19.069106714342052,0.1469333863626725,54,71
8126,relax_one,0.95,0,2,-2,-59.99819093035041,-0.0131455917893484,23,22
8127,relax_one,0.95,1,0,1,76.88395716132196,-0.1491322016956315,13,16
8128,relax_one,0.95,155,146,9,-2.3741667241416664,-0.001397205031107,85,131
8129,relax_one,0.95,44,44,0,0.0,0.0,28,55
8130,relax_one,0.95,4,4,0,0.0,0.0,18,24
8131,relax_one,0.95,0,0,0,0.0,0.0,19,22
8132,relax_one,0.95,0,0,0,0.0,0.0,47,46
8133,relax_one,0.95,21,19,2,-6.356920988253222,0.0143956759658575,39,64
8134,relax_one,0.95,0,0,0,0.0,0.0,17,18
8135,relax_one,0.95,1,1,0,0.0,0.0,23,24
8136,relax_one,0.95,2,2,0,0.0,0.0,13,16
8137,relax_one,0.95,22,22,0,0.0,0.0,40,56
8138,relax_one,0.95,1,1,0,0.0,0.0,10,15
8139,relax_one,0.95,0,0,0,0.0,0.0,21,20
8140,relax_one,0.95,4,4,0,0.0,0.0,30,35
8141,relax_one,0.95,1,1,0,0.0,0.0,71,77
8142,just_relax,0.9500000000000001,0,0,0,0.0,-0.009169281511008154,17,18
8143,just_relax,0.9500000000000001,1,1,0,0.0009607869158827498,0.0014628518031132298,43,48
8144,just_relax,0.9500000000000001,3,3,0,-0.0019521681741139219,-7.679999619569777e-05,38,45
8145,just_relax,0.9500000000000001,0,0,0,0.0,-0.003760056641999965,12,12
8146,just_relax,0.9500000000000001,20,14,6,1.9891400956483096,0.1544148745043621,23,38
8147,just_relax,0.9500000000000001,0,1,-1,-78.11694026732484,-0.029551220270057688,19,22
8148,just_relax,0.9500000000000001,976,1188,-212,1.3106081233515638,0.025794812735083883,35,143
8149,just_relax,0.9500000000000001,0,4,-4,-39.1818408082167,-0.015661841482397132,92,91
8150,just_relax,0.9500000000000001,2,2,0,-0.0004177554001500994,-0.0002552385505018018,43,51
8151,just_relax,0.9500000000000001,1,1,0,-0.001687008092517317,6.40249009676297e-05,35,36
8152,just_relax,0.9500000000000001,1,1,0,-0.0001564394100910249,0.00025089821846446814,11,13
8153,just_relax,0.9500000000000001,22,24,-2,-3.4941589182738397,0.10001136878969363,10,25
8154,just_relax,0.9500000000000001,16,13,3,0.20887851802145718,-2.2771107622610032e-05,86,136
8155,just_relax,0.9500000000000001,0,0,0,0.0,-1.765503840900351e-06,10,12
8156,just_relax,0.9500000000000001,0,0,0,0.0,-1.014518260578079e-05,32,31
8157,just_relax,0.9500000000000001,2,2,0,4.970962038347736,-0.09043506031928694,20,26
8158,just_relax,0.9500000000000001,0,0,0,0.0,0.00026909202110503294,11,11
8159,just_relax,0.9500000000000001,2,2,0,0.0009292844165713632,-0.0008610890242942704,34,42
8160,just_relax,0.9500000000000001,11,11,0,-0.0003616788843885388,0.0005035529702898112,14,25
8161,just_relax,0.9500000000000001,8,7,1,13.99583228956454,0.15820306124562633,31,46
8162,just_relax,0.9500000000000001,0,0,0,0.0,0.0042083907430441325,42,45
8163,just_relax,0.9500000000000001,1265,1285,-20,2.6849459664833404,-0.12928712498745287,39,173
8164,just_relax,0.9500000000000001,11,11,0,0.00016277005271092548,0.0015600944076981094,14,24
8165,just_relax,0.9500000000000001,0,0,0,0.0,-0.0006080530124850103,24,25
8166,just_relax,0.9500000000000001,2,2,0,-2.9813246385401726e-05,0.00014406467145811064,12,19
8167,just_relax,0.9500000000000001,59,59,0,0.4609819410147793,0.004455242123869274,41,72
8168,just_relax,0.9500000000000001,182,178,4,0.0313317398119608,0.09700807135641476,59,115
8169,just_relax,0.9500000000000001,6,6,0,-0.002040409692085632,0.0011964290694836954,32,37
8170,just_relax,0.9500000000000001,1,0,1,64.5674534074053,-0.0013228453280204056,20,20
8171,just_relax,0.9500000000000001,41,33,8,8.182357833947279,-0.009895766072516077,12,31
8172,just_relax,0.9500000000000001,0,0,0,0.0,-1.5942199658169898e-06,10,10
8173,just_relax,0.9500000000000001,0,0,0,0.0,0.0018153466622625736,20,21
8174,just_relax,0.9500000000000001,18,18,0,0.0003589278580733435,-0.000586503904336233,39,52
8175,just_relax,0.9500000000000001,378,369,9,2.9795282534828615,0.08358178697718299,42,109
8176,just_relax,0.9500000000000001,1,1,0,-0.0010366044558338672,-5.5463212290551844e-05,25,28
8177,just_relax,0.9500000000000001,170,170,0,-0.00027697627068334896,-0.0005002245004087635,56,106
8178,just_relax,0.9500000000000001,567,521,46,-0.26573921203785744,0.12390709970489577,87,189
8179,just_relax,0.9500000000000001,41,43,-2,2.499128887843675,-0.033528056765164016,56,82
8180,just_relax,0.9500000000000001,2,2,0,0.00048617749014567835,1.2071037781558047e-06,13,15
8181,just_relax,0.9500000000000001,104,86,18,5.26724471872344,-0.2840091449765524,36,63
8182,just_relax,0.9500000000000001,0,0,0,0.0,4.3915154694929015e-06,16,15
8183,just_relax,0.9500000000000001,0,0,0,0.0,-5.223096419815221e-07,67,66
8184,just_relax,0.9500000000000001,13,13,0,0.0024384647237383206,0.004260897920215001,42,60
8185,just_relax,0.9500000000000001,0,0,0,0.0,0.0005903979895692801,39,38
8186,just_relax,0.9500000000000001,8,8,0,-3.330899971842882e-05,0.0005334774465118874,20,36
8187,just_relax,0.9500000000000001,0,0,0,0.0,-0.0010596071395927442,10,9
8188,just_relax,0.9500000000000001,1,1,0,0.0009644178095271627,-1.805181839154013e-05,13,15
8189,just_relax,0.9500000000000001,6,7,-1,12.522285729298716,0.029906208984901483,34,41
8190,just_relax,0.9500000000000001,3,3,0,-0.00141856672461671,0.0006213779664755448,37,42
8191,just_relax,0.9500000000000001,36,36,0,7.196136941445275e-06,5.025038399830706e-06,18,29
8192,just_relax,0.9500000000000001,0,0,0,0.0,-0.003140583799323249,23,22
8193,just_relax,0.9500000000000001,0,0,0,0.0,1.0504657718901633e-05,13,12
8194,just_relax,0.9500000000000001,0,0,0,0.0,-0.0007613272869088084,15,14
8195,just_relax,0.9500000000000001,0,0,0,0.0,-0.0017207203528439852,69,68
8196,just_relax,0.9500000000000001,0,0,0,0.0,0.0019341632752030158,40,39
8197,just_relax,0.9500000000000001,0,0,0,0.0,0.0016954512903432084,89,93
8198,just_relax,0.9500000000000001,13,13,0,1.511050374969713,-0.08785706129788085,20,32
8199,just_relax,0.9500000000000001,2,3,-1,-4.120223819609976,0.009664451210877223,69,83
8200,just_relax,0.9500000000000001,2,2,0,0.0006766545457281836,-0.0007958153584334271,12,15
8201,just_relax,0.9500000000000001,0,0,0,0.0,-0.0009758471183408668,15,14
8202,just_relax,0.9500000000000001,0,0,0,0.0,-0.0007570529942456661,23,26
8203,just_relax,0.9500000000000001,2,2,0,-0.00046708375194270957,-0.0005528997513540856,12,20
8204,just_relax,0.9500000000000001,201,201,0,-5.927609844036397e-05,0.00010735719013854617,64,122
8205,just_relax,0.9500000000000001,7,7,0,-0.009905515038695967,0.0003544031231826894,58,71
8206,just_relax,0.9500000000000001,0,0,0,0.0,-0.001308677297268912,20,19
8207,just_relax,0.9500000000000001,510,505,5,-0.10960586950084661,0.00015623322302815712,100,191
8208,just_relax,0.9500000000000001,34,34,0,0.00464985022513531,3.462795885833536e-05,41,61
8209,just_relax,0.9500000000000001,33,21,12,-0.32237277289311805,0.048702577831681415,13,31
8210,just_relax,0.9500000000000001,5,5,0,0.000347640612375244,0.00028263330439870504,10,15
8211,just_relax,0.9500000000000001,6,6,0,-0.00042543589462695763,0.0003115870201488846,37,47
8212,just_relax,0.9500000000000001,0,0,0,0.0,0.0007350584472026744,21,21
8213,just_relax,0.9500000000000001,0,0,0,0.0,9.621758975453254e-06,11,10
8214,just_relax,0.9500000000000001,57,55,2,-1.1796960984034186,9.734149291917849e-05,44,80
8215,just_relax,0.9500000000000001,6,6,0,0.00019297259052564186,-1.6711583069151104e-05,12,21
8216,just_relax,0.9500000000000001,2,5,-3,10.477360070400792,-0.016767287323249724,37,43
8217,just_relax,0.9500000000000001,6,6,0,-9.27967616917158e-05,0.0005867078171852835,41,52
8218,just_relax,0.9500000000000001,0,0,0,0.0,0.0258238191424075,90,89
8219,just_relax,0.9500000000000001,0,0,0,0.0,-0.00017620412206831304,22,21
8220,just_relax,0.9500000000000001,1,5,-4,-25.99394547658536,0.03439747801698301,37,43
8221,just_relax,0.9500000000000001,0,0,0,0.0,0.009279908390236014,47,47
8222,just_relax,0.9500000000000001,4,4,0,-0.00033728932187671035,-9.212772776878708e-07,12,20
8223,just_relax,0.9500000000000001,114,95,19,0.8287298242191525,-0.006531385777559073,84,124
8224,just_relax,0.9500000000000001,0,0,0,0.0,0.0016708237920683988,88,92
8225,just_relax,0.9500000000000001,380,332,48,-1.681066658089314,0.027032869174077212,59,122
8226,just_relax,0.9500000000000001,4,4,0,2.0677824380754828e-05,-0.00036333047555803244,26,31
8227,just_relax,0.9500000000000001,0,0,0,0.0,4.418930553695688e-06,28,27
8228,just_relax,0.9500000000000001,6,6,0,0.0013890930604816276,7.243956427815945e-06,18,26
8229,just_relax,0.9500000000000001,1,1,0,-0.0014241348598034165,0.001861633846505062,23,26
8230,just_relax,0.9500000000000001,0,0,0,0.0,0.00018146518382472498,43,43
8231,just_relax,0.9500000000000001,2,2,0,0.000494906866748579,0.0012137972461528923,22,26
8232,just_relax,0.9500000000000001,0,0,0,0.0,8.316094011640018e-06,15,14
8233,just_relax,0.9500000000000001,10,17,-7,3.5874123628873704,0.08560587775542383,36,48
8234,just_relax,0.9500000000000001,6,6,0,2.8016025522275783,-0.3535412006642752,30,37
8235,just_relax,0.9500000000000001,1,1,0,5.455328151526828e-05,-4.433967369288361e-05,10,13
8236,just_relax,0.9500000000000001,0,0,0,0.0,-0.00498557603822955,12,11
8237,just_relax,0.9500000000000001,168,182,-14,1.1771250480206064,-0.026780091511464765,55,105
8238,just_relax,0.9500000000000001,1,1,0,17.12164821735773,0.05782616954563469,13,17
8239,just_relax,0.9500000000000001,0,0,0,0.0,0.00033295158878388076,30,29
8240,just_relax,0.9500000000000001,3,3,0,0.0005838153667880874,0.0008768881680062401,36,43
8241,just_relax,0.9500000000000001,36,36,0,0.0010314806767866003,-5.393936385500453e-05,40,60
8242,just_relax,0.9500000000000001,0,0,0,0.0,0.0017894746066188238,13,17
8243,just_relax,0.9500000000000001,6,7,-1,-5.27235869178908,0.008282645256823984,23,30
8244,just_relax,0.9500000000000001,0,0,0,0.0,-2.940409977925107e-05,12,16
8245,just_relax,0.9500000000000001,0,0,0,0.0,3.901708024223183e-06,26,26
8246,just_relax,0.9500000000000001,0,0,0,0.0,-0.0031688166024113062,22,31
8247,just_relax,0.9500000000000001,0,0,0,0.0,0.0008768193667615387,68,68
8248,just_relax,0.9500000000000001,0,0,0,0.0,-7.938175057398134e-06,23,22
8249,just_relax,0.9500000000000001,0,0,0,0.0,-0.06539918800436406,43,42
8250,just_relax,0.9500000000000001,0,0,0,0.0,-0.0028997231344640717,18,17
8251,just_relax,0.9500000000000001,3,3,0,-0.0031945868124410026,0.0012605153222713383,28,42
8252,just_relax,0.9500000000000001,45,58,-13,0.9231299892006462,0.08821843377971705,21,44
8253,just_relax,0.9500000000000001,0,0,0,0.0,-0.011281167187576102,36,37
8254,just_relax,0.9500000000000001,0,0,0,0.0,-3.4878924121017896e-05,15,14
8255,just_relax,0.9500000000000001,1,1,0,-0.0014549239964907201,-0.0005852561992100713,14,16
8256,just_relax,0.9500000000000001,197,237,-40,1.3477492998050025,0.08850937843326234,61,119
8257,just_relax,0.9500000000000001,0,0,0,0.0,-0.0038599581671643346,19,20
8258,just_relax,0.9500000000000001,0,0,0,0.0,-0.0006472841631984805,22,22
8259,just_relax,0.9500000000000001,0,0,0,0.0,-0.0011415137972972111,54,58
8260,just_relax,0.9500000000000001,651,651,0,-0.0003954210755097165,0.00022526380812071256,65,135
8261,just_relax,0.9500000000000001,1,1,0,-0.0029471577812358873,0.00017494002646389895,16,18
8262,just_relax,0.9500000000000001,7,7,0,0.00020138140767755885,0.0006636994664107609,17,27
8263,just_relax,0.9500000000000001,22,7,15,-12.985895473169307,0.1330374466905183,54,71
8264,just_relax,0.9500000000000001,0,2,-2,-59.99819093035041,-0.013145591789348487,23,22
8265,just_relax,0.9500000000000001,1,0,1,76.88395716132196,-0.14913220169563157,13,16
8266,just_relax,0.9500000000000001,155,185,-30,2.3843149677438973,-0.024957200139050006,85,131
8267,just_relax,0.9500000000000001,44,44,0,0.00030329189350197794,0.002585779405200772,28,55
8268,just_relax,0.9500000000000001,4,4,0,-0.0007096785766407265,-5.4537984728875166e-05,18,24
8269,just_relax,0.9500000000000001,0,0,0,0.0,-0.003226028074061027,19,22
8270,just_relax,0.9500000000000001,0,0,0,0.0,0.004819716677865293,47,46
8271,just_relax,0.9500000000000001,21,27,-6,0.06029472703684746,-0.3310372682946312,39,64
8272,just_relax,0.9500000000000001,0,0,0,0.0,-0.0037052423868473294,17,18
8273,just_relax,0.9500000000000001,1,1,0,0.0005119856857191962,0.00047451964773592703,23,24
8274,just_relax,0.9500000000000001,2,2,0,0.001027554856932511,-0.004970471779609076,13,16
8275,just_relax,0.9500000000000001,22,22,0,0.0038770082111057036,0.00042853879965076835,40,56
8276,just_relax,0.9500000000000001,1,1,0,-0.0002865966515059881,-0.00033259712213495884,10,15
8277,just_relax,0.9500000000000001,0,0,0,0.0,0.00033840894229064666,21,20
8278,just_relax,0.9500000000000001,4,4,0,-0.00010297236875089766,-0.001390635592978695,30,35
8279,just_relax,0.9500000000000001,1,1,0,0.005104341071259455,-0.00561565126737984,71,77
